ID, start, start-shifted, finish, finish-shifted, elapsed, succeeded
1, 1566722140136, 0, 1566722140492, 356, 356, true
2, 1566722140136, 0, 1566722140503, 367, 367, true
3, 1566722140136, 0, 1566722140500, 364, 364, true
4, 1566722140136, 0, 1566722140502, 366, 366, true
5, 1566722140136, 0, 1566722140503, 367, 367, true
6, 1566722140136, 0, 1566722140503, 367, 367, true
7, 1566722140264, 128, 1566722140489, 353, 225, true
8, 1566722140269, 133, 1566722140490, 354, 221, true
9, 1566722140276, 140, 1566722140489, 353, 213, true
10, 1566722140279, 143, 1566722140490, 354, 211, true
11, 1566722140281, 145, 1566722140491, 355, 210, true
12, 1566722140283, 147, 1566722140493, 357, 210, true
13, 1566722140286, 150, 1566722140494, 358, 208, true
14, 1566722140288, 152, 1566722140494, 358, 206, true
15, 1566722140291, 155, 1566722140495, 359, 204, true
16, 1566722140294, 158, 1566722140499, 363, 205, true
17, 1566722140296, 160, 1566722140501, 365, 205, true
18, 1566722140301, 165, 1566722140510, 374, 209, true
19, 1566722140321, 185, 1566722140531, 395, 210, true
20, 1566722140324, 188, 1566722140529, 393, 205, true
21, 1566722140330, 194, 1566722140534, 398, 204, true
22, 1566722140332, 196, 1566722140538, 402, 206, true
23, 1566722140334, 198, 1566722140539, 403, 205, true
24, 1566722140336, 200, 1566722140543, 407, 207, true
25, 1566722140336, 200, 1566722140543, 407, 207, true
26, 1566722140338, 202, 1566722140563, 427, 225, true
27, 1566722140340, 204, 1566722140563, 427, 223, true
28, 1566722140340, 204, 1566722140563, 427, 223, true
29, 1566722140342, 206, 1566722140570, 434, 228, true
30, 1566722140343, 207, 1566722140571, 435, 228, true
31, 1566722140344, 208, 1566722140569, 433, 225, true
32, 1566722140345, 209, 1566722140567, 431, 222, true
33, 1566722140347, 211, 1566722140568, 432, 221, true
34, 1566722140347, 211, 1566722140567, 431, 220, true
35, 1566722140349, 213, 1566722140565, 429, 216, true
36, 1566722140350, 214, 1566722140564, 428, 214, true
37, 1566722140352, 216, 1566722140565, 429, 213, true
38, 1566722140354, 218, 1566722140564, 428, 210, true
39, 1566722140357, 221, 1566722140564, 428, 207, true
40, 1566722140358, 222, 1566722140571, 435, 213, true
41, 1566722140359, 223, 1566722140572, 436, 213, true
42, 1566722140361, 225, 1566722140571, 435, 210, true
43, 1566722140365, 229, 1566722140578, 442, 213, true
44, 1566722140367, 231, 1566722140581, 445, 214, true
45, 1566722140367, 231, 1566722140579, 443, 212, true
46, 1566722140369, 233, 1566722140579, 443, 210, true
47, 1566722140370, 234, 1566722140580, 444, 210, true
48, 1566722140371, 235, 1566722140581, 445, 210, true
49, 1566722140372, 236, 1566722140586, 450, 214, true
50, 1566722140374, 238, 1566722140586, 450, 212, true
51, 1566722140374, 238, 1566722140586, 450, 212, true
52, 1566722140376, 240, 1566722140589, 453, 213, true
53, 1566722140377, 241, 1566722140589, 453, 212, true
54, 1566722140379, 243, 1566722140589, 453, 210, true
55, 1566722140380, 244, 1566722140593, 457, 213, true
56, 1566722140381, 245, 1566722140597, 461, 216, true
57, 1566722140383, 247, 1566722140596, 460, 213, true
58, 1566722140383, 247, 1566722140597, 461, 214, true
59, 1566722140385, 249, 1566722140600, 464, 215, true
60, 1566722140386, 250, 1566722140596, 460, 210, true
61, 1566722140388, 252, 1566722140599, 463, 211, true
62, 1566722140388, 252, 1566722140599, 463, 211, true
63, 1566722140389, 253, 1566722140597, 461, 208, true
64, 1566722140391, 255, 1566722140599, 463, 208, true
65, 1566722140392, 256, 1566722140604, 468, 212, true
66, 1566722140394, 258, 1566722140602, 466, 208, true
67, 1566722140394, 258, 1566722140603, 467, 209, true
68, 1566722140396, 260, 1566722140605, 469, 209, true
69, 1566722140397, 261, 1566722140604, 468, 207, true
70, 1566722140399, 263, 1566722140606, 470, 207, true
71, 1566722140399, 263, 1566722140606, 470, 207, true
72, 1566722140401, 265, 1566722140613, 477, 212, true
73, 1566722140402, 266, 1566722140623, 487, 221, true
74, 1566722140403, 267, 1566722140621, 485, 218, true
75, 1566722140403, 267, 1566722140625, 489, 222, true
76, 1566722140404, 268, 1566722140624, 488, 220, true
77, 1566722140405, 269, 1566722140625, 489, 220, true
78, 1566722140406, 270, 1566722140622, 486, 216, true
79, 1566722140406, 270, 1566722140622, 486, 216, true
80, 1566722140408, 272, 1566722140624, 488, 216, true
81, 1566722140409, 273, 1566722140623, 487, 214, true
82, 1566722140411, 275, 1566722140621, 485, 210, true
83, 1566722140412, 276, 1566722140620, 484, 208, true
84, 1566722140414, 278, 1566722140626, 490, 212, true
85, 1566722140420, 284, 1566722140629, 493, 209, true
86, 1566722140424, 288, 1566722140630, 494, 206, true
87, 1566722140424, 288, 1566722140629, 493, 205, true
88, 1566722140425, 289, 1566722140630, 494, 205, true
89, 1566722140428, 292, 1566722140642, 506, 214, true
90, 1566722140430, 294, 1566722140641, 505, 211, true
91, 1566722140432, 296, 1566722140642, 506, 210, true
92, 1566722140433, 297, 1566722140643, 507, 210, true
93, 1566722140436, 300, 1566722140643, 507, 207, true
94, 1566722140436, 300, 1566722140644, 508, 208, true
95, 1566722140438, 302, 1566722140645, 509, 207, true
96, 1566722140438, 302, 1566722140648, 512, 210, true
97, 1566722140441, 305, 1566722140646, 510, 205, true
98, 1566722140441, 305, 1566722140646, 510, 205, true
99, 1566722140444, 308, 1566722140656, 520, 212, true
100, 1566722140445, 309, 1566722140655, 519, 210, true
101, 1566722140447, 311, 1566722140655, 519, 208, true
102, 1566722140447, 311, 1566722140656, 520, 209, true
103, 1566722140449, 313, 1566722140656, 520, 207, true
104, 1566722140452, 316, 1566722140665, 529, 213, true
105, 1566722140452, 316, 1566722140665, 529, 213, true
106, 1566722140455, 319, 1566722140665, 529, 210, true
107, 1566722140455, 319, 1566722140662, 526, 207, true
108, 1566722140457, 321, 1566722140666, 530, 209, true
109, 1566722140458, 322, 1566722140666, 530, 208, true
110, 1566722140460, 324, 1566722140677, 541, 217, true
111, 1566722140460, 324, 1566722140672, 536, 212, true
112, 1566722140461, 325, 1566722140676, 540, 215, true
113, 1566722140464, 328, 1566722140672, 536, 208, true
114, 1566722140464, 328, 1566722140677, 541, 213, true
115, 1566722140466, 330, 1566722140734, 598, 268, true
116, 1566722140467, 331, 1566722140723, 587, 256, true
117, 1566722140470, 334, 1566722140724, 588, 254, true
118, 1566722140472, 336, 1566722140722, 586, 250, true
119, 1566722140474, 338, 1566722140732, 596, 258, true
120, 1566722140474, 338, 1566722140731, 595, 257, true
121, 1566722140504, 368, 1566722140727, 591, 223, true
122, 1566722140506, 370, 1566722140728, 592, 222, true
123, 1566722140507, 371, 1566722140726, 590, 219, true
124, 1566722140508, 372, 1566722140724, 588, 216, true
125, 1566722140510, 374, 1566722140726, 590, 216, true
126, 1566722140511, 375, 1566722140723, 587, 212, true
127, 1566722140512, 376, 1566722140722, 586, 210, true
128, 1566722140512, 376, 1566722140724, 588, 212, true
129, 1566722140515, 379, 1566722140729, 593, 214, true
130, 1566722140518, 382, 1566722140730, 594, 212, true
131, 1566722140519, 383, 1566722140730, 594, 211, true
132, 1566722140523, 387, 1566722140731, 595, 208, true
133, 1566722140526, 390, 1566722140732, 596, 206, true
134, 1566722140540, 404, 1566722140748, 612, 208, true
135, 1566722140540, 404, 1566722140752, 616, 212, true
136, 1566722140541, 405, 1566722140751, 615, 210, true
137, 1566722140546, 410, 1566722140750, 614, 204, true
138, 1566722140548, 412, 1566722140841, 705, 293, true
139, 1566722140548, 412, 1566722140843, 707, 295, true
140, 1566722140548, 412, 1566722140842, 706, 294, true
141, 1566722140552, 416, 1566722140831, 695, 279, true
142, 1566722140553, 417, 1566722140843, 707, 290, true
143, 1566722140555, 419, 1566722140841, 705, 286, true
144, 1566722140555, 419, 1566722140781, 645, 226, true
145, 1566722140556, 420, 1566722140780, 644, 224, true
146, 1566722140557, 421, 1566722140780, 644, 223, true
147, 1566722140557, 421, 1566722140781, 645, 224, true
148, 1566722140560, 424, 1566722140840, 704, 280, true
149, 1566722140561, 425, 1566722140832, 696, 271, true
150, 1566722140573, 437, 1566722140842, 706, 269, true
151, 1566722140591, 455, 1566722140834, 698, 243, true
152, 1566722140608, 472, 1566722140829, 693, 221, true
153, 1566722140611, 475, 1566722140829, 693, 218, true
154, 1566722140614, 478, 1566722140823, 687, 209, true
155, 1566722140615, 479, 1566722140843, 707, 228, true
156, 1566722140615, 479, 1566722140823, 687, 208, true
157, 1566722140631, 495, 1566722140844, 708, 213, true
158, 1566722140633, 497, 1566722140847, 711, 214, true
159, 1566722140652, 516, 1566722140861, 725, 209, true
160, 1566722140657, 521, 1566722140872, 736, 215, true
161, 1566722140658, 522, 1566722140872, 736, 214, true
162, 1566722140658, 522, 1566722140868, 732, 210, true
163, 1566722140659, 523, 1566722140873, 737, 214, true
164, 1566722140659, 523, 1566722140873, 737, 214, true
165, 1566722140660, 524, 1566722140874, 738, 214, true
166, 1566722140660, 524, 1566722140876, 740, 216, true
167, 1566722140661, 525, 1566722140874, 738, 213, true
168, 1566722140668, 532, 1566722140876, 740, 208, true
169, 1566722140668, 532, 1566722140876, 740, 208, true
170, 1566722140669, 533, 1566722140878, 742, 209, true
171, 1566722140670, 534, 1566722140882, 746, 212, true
172, 1566722140673, 537, 1566722140889, 753, 216, true
173, 1566722140673, 537, 1566722140883, 747, 210, true
174, 1566722140674, 538, 1566722140883, 747, 209, true
175, 1566722140679, 543, 1566722140947, 811, 268, true
176, 1566722140738, 602, 1566722140948, 812, 210, true
177, 1566722140740, 604, 1566722140948, 812, 208, true
178, 1566722140741, 605, 1566722140957, 821, 216, true
179, 1566722140743, 607, 1566722140957, 821, 214, true
180, 1566722140744, 608, 1566722140957, 821, 213, true
181, 1566722140746, 610, 1566722140957, 821, 211, true
182, 1566722140749, 613, 1566722140958, 822, 209, true
183, 1566722140755, 619, 1566722140960, 824, 205, true
184, 1566722140756, 620, 1566722140964, 828, 208, true
185, 1566722140758, 622, 1566722140974, 838, 216, true
186, 1566722140759, 623, 1566722140969, 833, 210, true
187, 1566722140760, 624, 1566722140975, 839, 215, true
188, 1566722140760, 624, 1566722140975, 839, 215, true
189, 1566722140763, 627, 1566722140976, 840, 213, true
190, 1566722140763, 627, 1566722140975, 839, 212, true
191, 1566722140766, 630, 1566722140987, 851, 221, true
192, 1566722140769, 633, 1566722140978, 842, 209, true
193, 1566722140771, 635, 1566722140993, 857, 222, true
194, 1566722140771, 635, 1566722140992, 856, 221, true
195, 1566722140773, 637, 1566722140988, 852, 215, true
196, 1566722140773, 637, 1566722140988, 852, 215, true
197, 1566722140774, 638, 1566722140987, 851, 213, true
198, 1566722140776, 640, 1566722141004, 868, 228, true
199, 1566722140777, 641, 1566722140993, 857, 216, true
200, 1566722140781, 645, 1566722141004, 868, 223, true
201, 1566722140783, 647, 1566722140993, 857, 210, true
202, 1566722140784, 648, 1566722141004, 868, 220, true
203, 1566722140786, 650, 1566722141004, 868, 218, true
204, 1566722140786, 650, 1566722141003, 867, 217, true
205, 1566722140787, 651, 1566722141004, 868, 217, true
206, 1566722140788, 652, 1566722141004, 868, 216, true
207, 1566722140790, 654, 1566722141011, 875, 221, true
208, 1566722140790, 654, 1566722141011, 875, 221, true
209, 1566722140792, 656, 1566722141010, 874, 218, true
210, 1566722140794, 658, 1566722141011, 875, 217, true
211, 1566722140795, 659, 1566722141012, 876, 217, true
212, 1566722140796, 660, 1566722141012, 876, 216, true
213, 1566722140797, 661, 1566722141012, 876, 215, true
214, 1566722140798, 662, 1566722141014, 878, 216, true
215, 1566722140801, 665, 1566722141012, 876, 211, true
216, 1566722140804, 668, 1566722141012, 876, 208, true
217, 1566722140807, 671, 1566722141024, 888, 217, true
218, 1566722140807, 671, 1566722141023, 887, 216, true
219, 1566722140808, 672, 1566722141024, 888, 216, true
220, 1566722140808, 672, 1566722141023, 887, 215, true
221, 1566722140810, 674, 1566722141025, 889, 215, true
222, 1566722140811, 675, 1566722141024, 888, 213, true
223, 1566722140814, 678, 1566722141026, 890, 212, true
224, 1566722140814, 678, 1566722141025, 889, 211, true
225, 1566722140818, 682, 1566722141026, 890, 208, true
226, 1566722140821, 685, 1566722141034, 898, 213, true
227, 1566722140824, 688, 1566722141042, 906, 218, true
228, 1566722140825, 689, 1566722141034, 898, 209, true
229, 1566722140825, 689, 1566722141042, 906, 217, true
230, 1566722140825, 689, 1566722141043, 907, 218, true
231, 1566722140826, 690, 1566722141042, 906, 216, true
232, 1566722140836, 700, 1566722141054, 918, 218, true
233, 1566722140846, 710, 1566722141058, 922, 212, true
234, 1566722140849, 713, 1566722141075, 939, 226, true
235, 1566722140851, 715, 1566722141066, 930, 215, true
236, 1566722140852, 716, 1566722141066, 930, 214, true
237, 1566722140852, 716, 1566722141075, 939, 223, true
238, 1566722140853, 717, 1566722141076, 940, 223, true
239, 1566722140856, 720, 1566722141076, 940, 220, true
240, 1566722140861, 725, 1566722141070, 934, 209, true
241, 1566722140863, 727, 1566722141076, 940, 213, true
242, 1566722140884, 748, 1566722141103, 967, 219, true
243, 1566722140886, 750, 1566722141103, 967, 217, true
244, 1566722140892, 756, 1566722141104, 968, 212, true
245, 1566722140893, 757, 1566722141104, 968, 211, true
246, 1566722140894, 758, 1566722141109, 973, 215, true
247, 1566722140894, 758, 1566722141109, 973, 215, true
248, 1566722140896, 760, 1566722141110, 974, 214, true
249, 1566722140907, 771, 1566722141118, 982, 211, true
250, 1566722140910, 774, 1566722141118, 982, 208, true
251, 1566722140912, 776, 1566722141126, 990, 214, true
252, 1566722140924, 788, 1566722141138, 1002, 214, true
253, 1566722140925, 789, 1566722141137, 1001, 212, true
254, 1566722140926, 790, 1566722141138, 1002, 212, true
255, 1566722140929, 793, 1566722141146, 1010, 217, true
256, 1566722140929, 793, 1566722141143, 1007, 214, true
257, 1566722140933, 797, 1566722141145, 1009, 212, true
258, 1566722140936, 800, 1566722141145, 1009, 209, true
259, 1566722140942, 806, 1566722141151, 1015, 209, true
260, 1566722140944, 808, 1566722141158, 1022, 214, true
261, 1566722140950, 814, 1566722141167, 1031, 217, true
262, 1566722140960, 824, 1566722141168, 1032, 208, true
263, 1566722140962, 826, 1566722141175, 1039, 213, true
264, 1566722140964, 828, 1566722141176, 1040, 212, true
265, 1566722140970, 834, 1566722141185, 1049, 215, true
266, 1566722141006, 870, 1566722141238, 1102, 232, true
267, 1566722141047, 911, 1566722141262, 1126, 215, true
268, 1566722141055, 919, 1566722141260, 1124, 205, true
269, 1566722141059, 923, 1566722141273, 1137, 214, true
270, 1566722141061, 925, 1566722141273, 1137, 212, true
271, 1566722141078, 942, 1566722141290, 1154, 212, true
272, 1566722141090, 954, 1566722141299, 1163, 209, true
273, 1566722141090, 954, 1566722141304, 1168, 214, true
274, 1566722141093, 957, 1566722141356, 1220, 263, true
275, 1566722141093, 957, 1566722141304, 1168, 211, true
276, 1566722141094, 958, 1566722141329, 1193, 235, true
277, 1566722141096, 960, 1566722141352, 1216, 256, true
278, 1566722141111, 975, 1566722141352, 1216, 241, true
279, 1566722141112, 976, 1566722141334, 1198, 222, true
280, 1566722141113, 977, 1566722141335, 1199, 222, true
281, 1566722141114, 978, 1566722141335, 1199, 221, true
282, 1566722141126, 990, 1566722141335, 1199, 209, true
283, 1566722141129, 993, 1566722141344, 1208, 215, true
284, 1566722141129, 993, 1566722141344, 1208, 215, true
285, 1566722141132, 996, 1566722141358, 1222, 226, true
286, 1566722141133, 997, 1566722141358, 1222, 225, true
287, 1566722141153, 1017, 1566722141369, 1233, 216, true
288, 1566722141154, 1018, 1566722141369, 1233, 215, true
289, 1566722141159, 1023, 1566722141375, 1239, 216, true
290, 1566722141160, 1024, 1566722141369, 1233, 209, true
291, 1566722141161, 1025, 1566722141376, 1240, 215, true
292, 1566722141162, 1026, 1566722141376, 1240, 214, true
293, 1566722141176, 1040, 1566722141383, 1247, 207, true
294, 1566722141176, 1040, 1566722141383, 1247, 207, true
295, 1566722141177, 1041, 1566722141388, 1252, 211, true
296, 1566722141178, 1042, 1566722141388, 1252, 210, true
297, 1566722141179, 1043, 1566722141393, 1257, 214, true
298, 1566722141180, 1044, 1566722141393, 1257, 213, true
299, 1566722141188, 1052, 1566722141406, 1270, 218, true
300, 1566722141192, 1056, 1566722141407, 1271, 215, true
301, 1566722141192, 1056, 1566722141407, 1271, 215, true
302, 1566722141194, 1058, 1566722141407, 1271, 213, true
303, 1566722141196, 1060, 1566722141414, 1278, 218, true
304, 1566722141200, 1064, 1566722141415, 1279, 215, true
305, 1566722141204, 1068, 1566722141423, 1287, 219, true
306, 1566722141208, 1072, 1566722141424, 1288, 216, true
307, 1566722141210, 1074, 1566722141424, 1288, 214, true
308, 1566722141211, 1075, 1566722141425, 1289, 214, true
309, 1566722141213, 1077, 1566722141425, 1289, 212, true
310, 1566722141216, 1080, 1566722141440, 1304, 224, true
311, 1566722141220, 1084, 1566722141440, 1304, 220, true
312, 1566722141224, 1088, 1566722141437, 1301, 213, true
313, 1566722141225, 1089, 1566722141439, 1303, 214, true
314, 1566722141226, 1090, 1566722141440, 1304, 214, true
315, 1566722141230, 1094, 1566722141447, 1311, 217, true
316, 1566722141233, 1097, 1566722141447, 1311, 214, true
317, 1566722141240, 1104, 1566722141459, 1323, 219, true
318, 1566722141240, 1104, 1566722141448, 1312, 208, true
319, 1566722141241, 1105, 1566722141465, 1329, 224, true
320, 1566722141242, 1106, 1566722141466, 1330, 224, true
321, 1566722141245, 1109, 1566722141465, 1329, 220, true
322, 1566722141248, 1112, 1566722141465, 1329, 217, true
323, 1566722141252, 1116, 1566722141462, 1326, 210, true
324, 1566722141256, 1120, 1566722141470, 1334, 214, true
325, 1566722141257, 1121, 1566722141471, 1335, 214, true
326, 1566722141261, 1125, 1566722141477, 1341, 216, true
327, 1566722141262, 1126, 1566722141477, 1341, 215, true
328, 1566722141262, 1126, 1566722141488, 1352, 226, true
329, 1566722141266, 1130, 1566722141487, 1351, 221, true
330, 1566722141278, 1142, 1566722141488, 1352, 210, true
331, 1566722141291, 1155, 1566722141504, 1368, 213, true
332, 1566722141293, 1157, 1566722141504, 1368, 211, true
333, 1566722141295, 1159, 1566722141623, 1487, 328, true
334, 1566722141307, 1171, 1566722141577, 1441, 270, true
335, 1566722141310, 1174, 1566722141577, 1441, 267, true
336, 1566722141311, 1175, 1566722141578, 1442, 267, true
337, 1566722141312, 1176, 1566722141592, 1456, 280, true
338, 1566722141312, 1176, 1566722141592, 1456, 280, true
339, 1566722141319, 1183, 1566722141586, 1450, 267, true
340, 1566722141320, 1184, 1566722141591, 1455, 271, true
341, 1566722141321, 1185, 1566722141587, 1451, 266, true
342, 1566722141323, 1187, 1566722141577, 1441, 254, true
343, 1566722141324, 1188, 1566722141589, 1453, 265, true
344, 1566722141324, 1188, 1566722141576, 1440, 252, true
345, 1566722141325, 1189, 1566722141593, 1457, 268, true
346, 1566722141325, 1189, 1566722141574, 1438, 249, true
347, 1566722141325, 1189, 1566722141588, 1452, 263, true
348, 1566722141325, 1189, 1566722141591, 1455, 266, true
349, 1566722141325, 1189, 1566722141593, 1457, 268, true
350, 1566722141326, 1190, 1566722141572, 1436, 246, true
351, 1566722141326, 1190, 1566722141576, 1440, 250, true
352, 1566722141326, 1190, 1566722141593, 1457, 267, true
353, 1566722141326, 1190, 1566722141571, 1435, 245, true
354, 1566722141327, 1191, 1566722141575, 1439, 248, true
355, 1566722141327, 1191, 1566722141587, 1451, 260, true
356, 1566722141327, 1191, 1566722141589, 1453, 262, true
357, 1566722141327, 1191, 1566722141592, 1456, 265, true
358, 1566722141327, 1191, 1566722141588, 1452, 261, true
359, 1566722141328, 1192, 1566722141594, 1458, 266, true
360, 1566722141328, 1192, 1566722141575, 1439, 247, true
361, 1566722141328, 1192, 1566722141550, 1414, 222, true
362, 1566722141395, 1259, 1566722141609, 1473, 214, true
363, 1566722141403, 1267, 1566722141615, 1479, 212, true
364, 1566722141409, 1273, 1566722141619, 1483, 210, true
365, 1566722141411, 1275, 1566722141635, 1499, 224, true
366, 1566722141426, 1290, 1566722141638, 1502, 212, true
367, 1566722141428, 1292, 1566722141653, 1517, 225, true
368, 1566722141442, 1306, 1566722141653, 1517, 211, true
369, 1566722141454, 1318, 1566722141660, 1524, 206, true
370, 1566722141457, 1321, 1566722141664, 1528, 207, true
371, 1566722141460, 1324, 1566722141682, 1546, 222, true
372, 1566722141475, 1339, 1566722141699, 1563, 224, true
373, 1566722141475, 1339, 1566722141692, 1556, 217, true
374, 1566722141478, 1342, 1566722141692, 1556, 214, true
375, 1566722141482, 1346, 1566722141772, 1636, 290, true
376, 1566722141484, 1348, 1566722141699, 1563, 215, true
377, 1566722141489, 1353, 1566722141702, 1566, 213, true
378, 1566722141490, 1354, 1566722141702, 1566, 212, true
379, 1566722141493, 1357, 1566722141711, 1575, 218, true
380, 1566722141494, 1358, 1566722141702, 1566, 208, true
381, 1566722141495, 1359, 1566722141716, 1580, 221, true
382, 1566722141496, 1360, 1566722141717, 1581, 221, true
383, 1566722141499, 1363, 1566722141717, 1581, 218, true
384, 1566722141505, 1369, 1566722141717, 1581, 212, true
385, 1566722141505, 1369, 1566722141716, 1580, 211, true
386, 1566722141622, 1486, 1566722141844, 1708, 222, true
387, 1566722141511, 1375, 1566722141721, 1585, 210, true
388, 1566722141511, 1375, 1566722141718, 1582, 207, true
389, 1566722141515, 1379, 1566722141724, 1588, 209, true
390, 1566722141519, 1383, 1566722141727, 1591, 208, true
391, 1566722141522, 1386, 1566722141733, 1597, 211, true
392, 1566722141522, 1386, 1566722141772, 1636, 250, true
393, 1566722141526, 1390, 1566722141739, 1603, 213, true
394, 1566722141527, 1391, 1566722141739, 1603, 212, true
395, 1566722141528, 1392, 1566722141739, 1603, 211, true
396, 1566722141532, 1396, 1566722141739, 1603, 207, true
397, 1566722141535, 1399, 1566722141754, 1618, 219, true
398, 1566722141537, 1401, 1566722141755, 1619, 218, true
399, 1566722141542, 1406, 1566722141755, 1619, 213, true
400, 1566722141551, 1415, 1566722141762, 1626, 211, true
401, 1566722141553, 1417, 1566722141762, 1626, 209, true
402, 1566722141555, 1419, 1566722141762, 1626, 207, true
403, 1566722141559, 1423, 1566722141767, 1631, 208, true
404, 1566722141559, 1423, 1566722141764, 1628, 205, true
405, 1566722141560, 1424, 1566722141783, 1647, 223, true
406, 1566722141562, 1426, 1566722141825, 1689, 263, true
407, 1566722141565, 1429, 1566722141818, 1682, 253, true
408, 1566722141595, 1459, 1566722141825, 1689, 230, true
409, 1566722141598, 1462, 1566722141845, 1709, 247, true
410, 1566722141599, 1463, 1566722141844, 1708, 245, true
411, 1566722141601, 1465, 1566722141844, 1708, 243, true
412, 1566722141603, 1467, 1566722141844, 1708, 241, true
413, 1566722141603, 1467, 1566722141844, 1708, 241, true
414, 1566722141605, 1469, 1566722141845, 1709, 240, true
415, 1566722141605, 1469, 1566722141834, 1698, 229, true
416, 1566722141609, 1473, 1566722141844, 1708, 235, true
417, 1566722141610, 1474, 1566722141833, 1697, 223, true
418, 1566722141616, 1480, 1566722141845, 1709, 229, true
419, 1566722141620, 1484, 1566722141831, 1695, 211, true
420, 1566722141636, 1500, 1566722141860, 1724, 224, true
421, 1566722141642, 1506, 1566722141847, 1711, 205, true
422, 1566722141642, 1506, 1566722141857, 1721, 215, true
423, 1566722141643, 1507, 1566722141858, 1722, 215, true
424, 1566722141644, 1508, 1566722141858, 1722, 214, true
425, 1566722141662, 1526, 1566722141868, 1732, 206, true
426, 1566722141664, 1528, 1566722141882, 1746, 218, true
427, 1566722141665, 1529, 1566722141873, 1737, 208, true
428, 1566722141665, 1529, 1566722141885, 1749, 220, true
429, 1566722141680, 1544, 1566722141891, 1755, 211, true
430, 1566722141683, 1547, 1566722141893, 1757, 210, true
431, 1566722141685, 1549, 1566722141894, 1758, 209, true
432, 1566722141686, 1550, 1566722141892, 1756, 206, true
433, 1566722141686, 1550, 1566722141891, 1755, 205, true
434, 1566722141687, 1551, 1566722141899, 1763, 212, true
435, 1566722141689, 1553, 1566722141899, 1763, 210, true
436, 1566722141692, 1556, 1566722141899, 1763, 207, true
437, 1566722141692, 1556, 1566722141899, 1763, 207, true
438, 1566722141694, 1558, 1566722141903, 1767, 209, true
439, 1566722141694, 1558, 1566722141905, 1769, 211, true
440, 1566722141695, 1559, 1566722141910, 1774, 215, true
441, 1566722141695, 1559, 1566722141910, 1774, 215, true
442, 1566722141696, 1560, 1566722141905, 1769, 209, true
443, 1566722141703, 1567, 1566722141909, 1773, 206, true
444, 1566722141705, 1569, 1566722141911, 1775, 206, true
445, 1566722141707, 1571, 1566722141911, 1775, 204, true
446, 1566722141708, 1572, 1566722141913, 1777, 205, true
447, 1566722141712, 1576, 1566722141919, 1783, 207, true
448, 1566722141713, 1577, 1566722141919, 1783, 206, true
449, 1566722141719, 1583, 1566722141925, 1789, 206, true
450, 1566722141722, 1586, 1566722141927, 1791, 205, true
451, 1566722141725, 1589, 1566722141932, 1796, 207, true
452, 1566722141728, 1592, 1566722141934, 1798, 206, true
453, 1566722141729, 1593, 1566722141934, 1798, 205, true
454, 1566722141731, 1595, 1566722141935, 1799, 204, true
455, 1566722141734, 1598, 1566722141938, 1802, 204, true
456, 1566722141736, 1600, 1566722141940, 1804, 204, true
457, 1566722141740, 1604, 1566722141944, 1808, 204, true
458, 1566722141742, 1606, 1566722141946, 1810, 204, true
459, 1566722141744, 1608, 1566722141950, 1814, 206, true
460, 1566722141745, 1609, 1566722141950, 1814, 205, true
461, 1566722141747, 1611, 1566722141950, 1814, 203, true
462, 1566722141749, 1613, 1566722141953, 1817, 204, true
463, 1566722141752, 1616, 1566722141959, 1823, 207, true
464, 1566722141755, 1619, 1566722141959, 1823, 204, true
465, 1566722141756, 1620, 1566722141970, 1834, 214, true
466, 1566722141757, 1621, 1566722141968, 1832, 211, true
467, 1566722141757, 1621, 1566722141971, 1835, 214, true
468, 1566722141759, 1623, 1566722141971, 1835, 212, true
469, 1566722141763, 1627, 1566722141970, 1834, 207, true
470, 1566722141764, 1628, 1566722141971, 1835, 207, true
471, 1566722141769, 1633, 1566722141975, 1839, 206, true
472, 1566722141770, 1634, 1566722141975, 1839, 205, true
473, 1566722141772, 1636, 1566722141980, 1844, 208, true
474, 1566722141775, 1639, 1566722141980, 1844, 205, true
475, 1566722141776, 1640, 1566722141981, 1845, 205, true
476, 1566722141778, 1642, 1566722141983, 1847, 205, true
477, 1566722141780, 1644, 1566722141988, 1852, 208, true
478, 1566722141783, 1647, 1566722141988, 1852, 205, true
479, 1566722141785, 1649, 1566722141989, 1853, 204, true
480, 1566722141787, 1651, 1566722141999, 1863, 212, true
481, 1566722141789, 1653, 1566722141999, 1863, 210, true
482, 1566722141791, 1655, 1566722141999, 1863, 208, true
483, 1566722141793, 1657, 1566722142002, 1866, 209, true
484, 1566722141796, 1660, 1566722142001, 1865, 205, true
485, 1566722141799, 1663, 1566722142002, 1866, 203, true
486, 1566722141801, 1665, 1566722142007, 1871, 206, true
487, 1566722141802, 1666, 1566722142007, 1871, 205, true
488, 1566722141804, 1668, 1566722142015, 1879, 211, true
489, 1566722141805, 1669, 1566722142012, 1876, 207, true
490, 1566722141806, 1670, 1566722142013, 1877, 207, true
491, 1566722141808, 1672, 1566722142012, 1876, 204, true
492, 1566722141809, 1673, 1566722142016, 1880, 207, true
493, 1566722141811, 1675, 1566722142016, 1880, 205, true
494, 1566722141814, 1678, 1566722142071, 1935, 257, true
495, 1566722141816, 1680, 1566722142070, 1934, 254, true
496, 1566722141819, 1683, 1566722142073, 1937, 254, true
497, 1566722141820, 1684, 1566722142086, 1950, 266, true
498, 1566722141823, 1687, 1566722142086, 1950, 263, true
499, 1566722141825, 1689, 1566722142087, 1951, 262, true
500, 1566722141826, 1690, 1566722142087, 1951, 261, true
501, 1566722141827, 1691, 1566722142087, 1951, 260, true
502, 1566722141828, 1692, 1566722142089, 1953, 261, true
503, 1566722141829, 1693, 1566722142087, 1951, 258, true
504, 1566722141834, 1698, 1566722142088, 1952, 254, true
505, 1566722141835, 1699, 1566722142088, 1952, 253, true
506, 1566722141836, 1700, 1566722142089, 1953, 253, true
507, 1566722141836, 1700, 1566722142088, 1952, 252, true
508, 1566722141837, 1701, 1566722142090, 1954, 253, true
509, 1566722141838, 1702, 1566722142089, 1953, 251, true
510, 1566722141839, 1703, 1566722142089, 1953, 250, true
511, 1566722141845, 1709, 1566722142090, 1954, 245, true
512, 1566722141850, 1714, 1566722142090, 1954, 240, true
513, 1566722141852, 1716, 1566722142090, 1954, 238, true
514, 1566722141854, 1718, 1566722142091, 1955, 237, true
515, 1566722141858, 1722, 1566722142091, 1955, 233, true
516, 1566722141860, 1724, 1566722142091, 1955, 231, true
517, 1566722141861, 1725, 1566722142100, 1964, 239, true
518, 1566722141862, 1726, 1566722142103, 1967, 241, true
519, 1566722141863, 1727, 1566722142103, 1967, 240, true
520, 1566722141864, 1728, 1566722142103, 1967, 239, true
521, 1566722141865, 1729, 1566722142104, 1968, 239, true
522, 1566722141869, 1733, 1566722142104, 1968, 235, true
523, 1566722141870, 1734, 1566722142104, 1968, 234, true
524, 1566722141874, 1738, 1566722142104, 1968, 230, true
525, 1566722141874, 1738, 1566722142104, 1968, 230, true
526, 1566722141875, 1739, 1566722142105, 1969, 230, true
527, 1566722141876, 1740, 1566722142114, 1978, 238, true
528, 1566722141877, 1741, 1566722142105, 1969, 228, true
529, 1566722141879, 1743, 1566722142105, 1969, 226, true
530, 1566722141886, 1750, 1566722142105, 1969, 219, true
531, 1566722141888, 1752, 1566722142105, 1969, 217, true
532, 1566722141894, 1758, 1566722142105, 1969, 211, true
533, 1566722141896, 1760, 1566722142109, 1973, 213, true
534, 1566722141901, 1765, 1566722142109, 1973, 208, true
535, 1566722141902, 1766, 1566722142109, 1973, 207, true
536, 1566722141914, 1778, 1566722142220, 2084, 306, true
537, 1566722141915, 1779, 1566722142196, 2060, 281, true
538, 1566722141916, 1780, 1566722142220, 2084, 304, true
539, 1566722141920, 1784, 1566722142221, 2085, 301, true
540, 1566722141922, 1786, 1566722142220, 2084, 298, true
541, 1566722141923, 1787, 1566722142220, 2084, 297, true
542, 1566722141925, 1789, 1566722142217, 2081, 292, true
543, 1566722141928, 1792, 1566722142219, 2083, 291, true
544, 1566722141930, 1794, 1566722142223, 2087, 293, true
545, 1566722141932, 1796, 1566722142224, 2088, 292, true
546, 1566722141936, 1800, 1566722142224, 2088, 288, true
547, 1566722141940, 1804, 1566722142220, 2084, 280, true
548, 1566722141942, 1806, 1566722142224, 2088, 282, true
549, 1566722141946, 1810, 1566722142223, 2087, 277, true
550, 1566722141947, 1811, 1566722142224, 2088, 277, true
551, 1566722141948, 1812, 1566722142222, 2086, 274, true
552, 1566722141953, 1817, 1566722142224, 2088, 271, true
553, 1566722141956, 1820, 1566722142224, 2088, 268, true
554, 1566722141957, 1821, 1566722142223, 2087, 266, true
555, 1566722141961, 1825, 1566722142211, 2075, 250, true
556, 1566722141961, 1825, 1566722142207, 2071, 246, true
557, 1566722141962, 1826, 1566722142224, 2088, 262, true
558, 1566722141963, 1827, 1566722142224, 2088, 261, true
559, 1566722141964, 1828, 1566722142223, 2087, 259, true
560, 1566722141978, 1842, 1566722142223, 2087, 245, true
561, 1566722141983, 1847, 1566722142222, 2086, 239, true
562, 1566722141984, 1848, 1566722142223, 2087, 239, true
563, 1566722141985, 1849, 1566722142222, 2086, 237, true
564, 1566722141986, 1850, 1566722142222, 2086, 236, true
565, 1566722141991, 1855, 1566722142222, 2086, 231, true
566, 1566722141992, 1856, 1566722142221, 2085, 229, true
567, 1566722141993, 1857, 1566722142222, 2086, 229, true
568, 1566722141995, 1859, 1566722142211, 2075, 216, true
569, 1566722141996, 1860, 1566722142221, 2085, 225, true
570, 1566722142003, 1867, 1566722142211, 2075, 208, true
571, 1566722142005, 1869, 1566722142223, 2087, 218, true
572, 1566722142008, 1872, 1566722142226, 2090, 218, true
573, 1566722142009, 1873, 1566722142225, 2089, 216, true
574, 1566722142010, 1874, 1566722142224, 2088, 214, true
575, 1566722142010, 1874, 1566722142226, 2090, 216, true
576, 1566722142018, 1882, 1566722142330, 2194, 312, true
577, 1566722142019, 1883, 1566722142325, 2189, 306, true
578, 1566722142020, 1884, 1566722142330, 2194, 310, true
579, 1566722142119, 1983, 1566722142337, 2201, 218, true
580, 1566722142120, 1984, 1566722142337, 2201, 217, true
581, 1566722142121, 1985, 1566722142337, 2201, 216, true
582, 1566722142132, 1996, 1566722142342, 2206, 210, true
583, 1566722142133, 1997, 1566722142342, 2206, 209, true
584, 1566722142134, 1998, 1566722142344, 2208, 210, true
585, 1566722142137, 2001, 1566722142356, 2220, 219, true
586, 1566722142137, 2001, 1566722142355, 2219, 218, true
587, 1566722142138, 2002, 1566722142356, 2220, 218, true
588, 1566722142138, 2002, 1566722142350, 2214, 212, true
589, 1566722142139, 2003, 1566722142355, 2219, 216, true
590, 1566722142140, 2004, 1566722142351, 2215, 211, true
591, 1566722142141, 2005, 1566722142355, 2219, 214, true
592, 1566722142141, 2005, 1566722142355, 2219, 214, true
593, 1566722142142, 2006, 1566722142351, 2215, 209, true
594, 1566722142142, 2006, 1566722142355, 2219, 213, true
595, 1566722142151, 2015, 1566722142358, 2222, 207, true
596, 1566722142154, 2018, 1566722142369, 2233, 215, true
597, 1566722142157, 2021, 1566722142370, 2234, 213, true
598, 1566722142158, 2022, 1566722142369, 2233, 211, true
599, 1566722142160, 2024, 1566722142370, 2234, 210, true
600, 1566722142161, 2025, 1566722142372, 2236, 211, true
601, 1566722142162, 2026, 1566722142372, 2236, 210, true
602, 1566722142163, 2027, 1566722142373, 2237, 210, true
603, 1566722142164, 2028, 1566722142372, 2236, 208, true
604, 1566722142165, 2029, 1566722142378, 2242, 213, true
605, 1566722142166, 2030, 1566722142386, 2250, 220, true
606, 1566722142168, 2032, 1566722142396, 2260, 228, true
607, 1566722142168, 2032, 1566722142396, 2260, 228, true
608, 1566722142169, 2033, 1566722142396, 2260, 227, true
609, 1566722142171, 2035, 1566722142405, 2269, 234, true
610, 1566722142173, 2037, 1566722142401, 2265, 228, true
611, 1566722142174, 2038, 1566722142405, 2269, 231, true
612, 1566722142176, 2040, 1566722142395, 2259, 219, true
613, 1566722142178, 2042, 1566722142405, 2269, 227, true
614, 1566722142179, 2043, 1566722142411, 2275, 232, true
615, 1566722142179, 2043, 1566722142406, 2270, 227, true
616, 1566722142180, 2044, 1566722142411, 2275, 231, true
617, 1566722142181, 2045, 1566722142409, 2273, 228, true
618, 1566722142181, 2045, 1566722142405, 2269, 224, true
619, 1566722142182, 2046, 1566722142407, 2271, 225, true
620, 1566722142183, 2047, 1566722142406, 2270, 223, true
621, 1566722142183, 2047, 1566722142406, 2270, 223, true
622, 1566722142184, 2048, 1566722142405, 2269, 221, true
623, 1566722142184, 2048, 1566722142406, 2270, 222, true
624, 1566722142185, 2049, 1566722142406, 2270, 221, true
625, 1566722142186, 2050, 1566722142410, 2274, 224, true
626, 1566722142187, 2051, 1566722142407, 2271, 220, true
627, 1566722142188, 2052, 1566722142404, 2268, 216, true
628, 1566722142190, 2054, 1566722142407, 2271, 217, true
629, 1566722142191, 2055, 1566722142407, 2271, 216, true
630, 1566722142193, 2057, 1566722142411, 2275, 218, true
631, 1566722142194, 2058, 1566722142411, 2275, 217, true
632, 1566722142201, 2065, 1566722142411, 2275, 210, true
633, 1566722142202, 2066, 1566722142438, 2302, 236, true
634, 1566722142203, 2067, 1566722142418, 2282, 215, true
635, 1566722142203, 2067, 1566722142438, 2302, 235, true
636, 1566722142205, 2069, 1566722142437, 2301, 232, true
637, 1566722142207, 2071, 1566722142451, 2315, 244, true
638, 1566722142232, 2096, 1566722142455, 2319, 223, true
639, 1566722142233, 2097, 1566722142451, 2315, 218, true
640, 1566722142233, 2097, 1566722142454, 2318, 221, true
641, 1566722142238, 2102, 1566722142457, 2321, 219, true
642, 1566722142240, 2104, 1566722142457, 2321, 217, true
643, 1566722142241, 2105, 1566722142456, 2320, 215, true
644, 1566722142241, 2105, 1566722142456, 2320, 215, true
645, 1566722142242, 2106, 1566722142456, 2320, 214, true
646, 1566722142244, 2108, 1566722142456, 2320, 212, true
647, 1566722142246, 2110, 1566722142458, 2322, 212, true
648, 1566722142247, 2111, 1566722142457, 2321, 210, true
649, 1566722142249, 2113, 1566722142462, 2326, 213, true
650, 1566722142249, 2113, 1566722142458, 2322, 209, true
651, 1566722142250, 2114, 1566722142461, 2325, 211, true
652, 1566722142254, 2118, 1566722142462, 2326, 208, true
653, 1566722142254, 2118, 1566722142462, 2326, 208, true
654, 1566722142255, 2119, 1566722142462, 2326, 207, true
655, 1566722142257, 2121, 1566722142470, 2334, 213, true
656, 1566722142258, 2122, 1566722142470, 2334, 212, true
657, 1566722142259, 2123, 1566722142479, 2343, 220, true
658, 1566722142261, 2125, 1566722142479, 2343, 218, true
659, 1566722142263, 2127, 1566722142479, 2343, 216, true
660, 1566722142265, 2129, 1566722142480, 2344, 215, true
661, 1566722142267, 2131, 1566722142484, 2348, 217, true
662, 1566722142267, 2131, 1566722142484, 2348, 217, true
663, 1566722142269, 2133, 1566722142480, 2344, 211, true
664, 1566722142270, 2134, 1566722142486, 2350, 216, true
665, 1566722142321, 2185, 1566722142538, 2402, 217, true
666, 1566722142338, 2202, 1566722142559, 2423, 221, true
667, 1566722142339, 2203, 1566722142558, 2422, 219, true
668, 1566722142339, 2203, 1566722142561, 2425, 222, true
669, 1566722142387, 2251, 1566722142606, 2470, 219, true
670, 1566722142388, 2252, 1566722142617, 2481, 229, true
671, 1566722142419, 2283, 1566722142643, 2507, 224, true
672, 1566722142419, 2283, 1566722142643, 2507, 224, true
673, 1566722142420, 2284, 1566722142643, 2507, 223, true
674, 1566722142420, 2284, 1566722142644, 2508, 224, true
675, 1566722142420, 2284, 1566722142644, 2508, 224, true
676, 1566722142421, 2285, 1566722142644, 2508, 223, true
677, 1566722142422, 2286, 1566722142646, 2510, 224, true
678, 1566722142424, 2288, 1566722142649, 2513, 225, true
679, 1566722142427, 2291, 1566722142647, 2511, 220, true
680, 1566722142430, 2294, 1566722142647, 2511, 217, true
681, 1566722142438, 2302, 1566722142649, 2513, 211, true
682, 1566722142441, 2305, 1566722142649, 2513, 208, true
683, 1566722142444, 2308, 1566722142666, 2530, 222, true
684, 1566722142445, 2309, 1566722142665, 2529, 220, true
685, 1566722142446, 2310, 1566722142666, 2530, 220, true
686, 1566722142465, 2329, 1566722142671, 2535, 206, true
687, 1566722142467, 2331, 1566722142679, 2543, 212, true
688, 1566722142468, 2332, 1566722142677, 2541, 209, true
689, 1566722142471, 2335, 1566722142675, 2539, 204, true
690, 1566722142471, 2335, 1566722142679, 2543, 208, true
691, 1566722142472, 2336, 1566722142677, 2541, 205, true
692, 1566722142474, 2338, 1566722142902, 2766, 428, true
693, 1566722142487, 2351, 1566722142701, 2565, 214, true
694, 1566722142488, 2352, 1566722142701, 2565, 213, true
695, 1566722142489, 2353, 1566722142701, 2565, 212, true
696, 1566722142490, 2354, 1566722142708, 2572, 218, true
697, 1566722142492, 2356, 1566722142708, 2572, 216, true
698, 1566722142495, 2359, 1566722142708, 2572, 213, true
699, 1566722142498, 2362, 1566722142707, 2571, 209, true
700, 1566722142501, 2365, 1566722142708, 2572, 207, true
701, 1566722142503, 2367, 1566722142710, 2574, 207, true
702, 1566722142504, 2368, 1566722142710, 2574, 206, true
703, 1566722142506, 2370, 1566722142711, 2575, 205, true
704, 1566722142508, 2372, 1566722142719, 2583, 211, true
705, 1566722142509, 2373, 1566722142719, 2583, 210, true
706, 1566722142510, 2374, 1566722142719, 2583, 209, true
707, 1566722142512, 2376, 1566722142719, 2583, 207, true
708, 1566722142514, 2378, 1566722142723, 2587, 209, true
709, 1566722142515, 2379, 1566722142725, 2589, 210, true
710, 1566722142516, 2380, 1566722142725, 2589, 209, true
711, 1566722142517, 2381, 1566722142725, 2589, 208, true
712, 1566722142519, 2383, 1566722142725, 2589, 206, true
713, 1566722142520, 2384, 1566722142725, 2589, 205, true
714, 1566722142521, 2385, 1566722142727, 2591, 206, true
715, 1566722142522, 2386, 1566722142748, 2612, 226, true
716, 1566722142574, 2438, 1566722142784, 2648, 210, true
717, 1566722142574, 2438, 1566722142781, 2645, 207, true
718, 1566722142578, 2442, 1566722142813, 2677, 235, true
719, 1566722142578, 2442, 1566722142783, 2647, 205, true
720, 1566722142578, 2442, 1566722142783, 2647, 205, true
721, 1566722142580, 2444, 1566722142790, 2654, 210, true
722, 1566722142582, 2446, 1566722142792, 2656, 210, true
723, 1566722142584, 2448, 1566722142791, 2655, 207, true
724, 1566722142587, 2451, 1566722142797, 2661, 210, true
725, 1566722142590, 2454, 1566722142797, 2661, 207, true
726, 1566722142592, 2456, 1566722142806, 2670, 214, true
727, 1566722142593, 2457, 1566722142806, 2670, 213, true
728, 1566722142595, 2459, 1566722142807, 2671, 212, true
729, 1566722142597, 2461, 1566722142806, 2670, 209, true
730, 1566722142599, 2463, 1566722142813, 2677, 214, true
731, 1566722142601, 2465, 1566722142812, 2676, 211, true
732, 1566722142603, 2467, 1566722142812, 2676, 209, true
733, 1566722142609, 2473, 1566722142822, 2686, 213, true
734, 1566722142611, 2475, 1566722142822, 2686, 211, true
735, 1566722142612, 2476, 1566722142822, 2686, 210, true
736, 1566722142620, 2484, 1566722142827, 2691, 207, true
737, 1566722142622, 2486, 1566722142831, 2695, 209, true
738, 1566722142622, 2486, 1566722142831, 2695, 209, true
739, 1566722142624, 2488, 1566722142832, 2696, 208, true
740, 1566722142626, 2490, 1566722142843, 2707, 217, true
741, 1566722142626, 2490, 1566722142839, 2703, 213, true
742, 1566722142628, 2492, 1566722142844, 2708, 216, true
743, 1566722142628, 2492, 1566722142839, 2703, 211, true
744, 1566722142629, 2493, 1566722142840, 2704, 211, true
745, 1566722142629, 2493, 1566722142839, 2703, 210, true
746, 1566722142631, 2495, 1566722142843, 2707, 212, true
747, 1566722142634, 2498, 1566722142856, 2720, 222, true
748, 1566722142634, 2498, 1566722142854, 2718, 220, true
749, 1566722142635, 2499, 1566722142856, 2720, 221, true
750, 1566722142636, 2500, 1566722142856, 2720, 220, true
751, 1566722142638, 2502, 1566722142856, 2720, 218, true
752, 1566722142639, 2503, 1566722142856, 2720, 217, true
753, 1566722142653, 2517, 1566722142862, 2726, 209, true
754, 1566722142653, 2517, 1566722142862, 2726, 209, true
755, 1566722142654, 2518, 1566722142862, 2726, 208, true
756, 1566722142655, 2519, 1566722142862, 2726, 207, true
757, 1566722142655, 2519, 1566722142862, 2726, 207, true
758, 1566722142657, 2521, 1566722142865, 2729, 208, true
759, 1566722142657, 2521, 1566722142864, 2728, 207, true
760, 1566722142659, 2523, 1566722142876, 2740, 217, true
761, 1566722142659, 2523, 1566722142868, 2732, 209, true
762, 1566722142660, 2524, 1566722142876, 2740, 216, true
763, 1566722142661, 2525, 1566722142871, 2735, 210, true
764, 1566722142662, 2526, 1566722142871, 2735, 209, true
765, 1566722142668, 2532, 1566722142876, 2740, 208, true
766, 1566722142668, 2532, 1566722142876, 2740, 208, true
767, 1566722142669, 2533, 1566722142874, 2738, 205, true
768, 1566722142671, 2535, 1566722142880, 2744, 209, true
769, 1566722142672, 2536, 1566722142883, 2747, 211, true
770, 1566722142673, 2537, 1566722142889, 2753, 216, true
771, 1566722142673, 2537, 1566722142883, 2747, 210, true
772, 1566722142675, 2539, 1566722142884, 2748, 209, true
773, 1566722142680, 2544, 1566722142889, 2753, 209, true
774, 1566722142693, 2557, 1566722142901, 2765, 208, true
775, 1566722142693, 2557, 1566722142900, 2764, 207, true
776, 1566722142695, 2559, 1566722142900, 2764, 205, true
777, 1566722142697, 2561, 1566722142908, 2772, 211, true
778, 1566722142697, 2561, 1566722142912, 2776, 215, true
779, 1566722142703, 2567, 1566722142913, 2777, 210, true
780, 1566722142704, 2568, 1566722142908, 2772, 204, true
781, 1566722142711, 2575, 1566722142918, 2782, 207, true
782, 1566722142714, 2578, 1566722142923, 2787, 209, true
783, 1566722142714, 2578, 1566722142924, 2788, 210, true
784, 1566722142716, 2580, 1566722142923, 2787, 207, true
785, 1566722142717, 2581, 1566722142924, 2788, 207, true
786, 1566722142721, 2585, 1566722142930, 2794, 209, true
787, 1566722142721, 2585, 1566722142930, 2794, 209, true
788, 1566722142722, 2586, 1566722142931, 2795, 209, true
789, 1566722142727, 2591, 1566722142933, 2797, 206, true
790, 1566722142728, 2592, 1566722142933, 2797, 205, true
791, 1566722142731, 2595, 1566722142944, 2808, 213, true
792, 1566722142732, 2596, 1566722142944, 2808, 212, true
793, 1566722142734, 2598, 1566722142944, 2808, 210, true
794, 1566722142734, 2598, 1566722142947, 2811, 213, true
795, 1566722142735, 2599, 1566722142944, 2808, 209, true
796, 1566722142735, 2599, 1566722142950, 2814, 215, true
797, 1566722142737, 2601, 1566722142950, 2814, 213, true
798, 1566722142739, 2603, 1566722142948, 2812, 209, true
799, 1566722142740, 2604, 1566722142947, 2811, 207, true
800, 1566722142741, 2605, 1566722142951, 2815, 210, true
801, 1566722142742, 2606, 1566722142950, 2814, 208, true
802, 1566722142744, 2608, 1566722142952, 2816, 208, true
803, 1566722142746, 2610, 1566722142956, 2820, 210, true
804, 1566722142746, 2610, 1566722142952, 2816, 206, true
805, 1566722142749, 2613, 1566722142963, 2827, 214, true
806, 1566722142749, 2613, 1566722142965, 2829, 216, true
807, 1566722142750, 2614, 1566722142966, 2830, 216, true
808, 1566722142751, 2615, 1566722142966, 2830, 215, true
809, 1566722142752, 2616, 1566722142961, 2825, 209, true
810, 1566722142753, 2617, 1566722142963, 2827, 210, true
811, 1566722142755, 2619, 1566722142965, 2829, 210, true
812, 1566722142757, 2621, 1566722142963, 2827, 206, true
813, 1566722142761, 2625, 1566722142974, 2838, 213, true
814, 1566722142761, 2625, 1566722142969, 2833, 208, true
815, 1566722142763, 2627, 1566722142974, 2838, 211, true
816, 1566722142764, 2628, 1566722142971, 2835, 207, true
817, 1566722142765, 2629, 1566722142973, 2837, 208, true
818, 1566722142766, 2630, 1566722142971, 2835, 205, true
819, 1566722142769, 2633, 1566722142980, 2844, 211, true
820, 1566722142770, 2634, 1566722142978, 2842, 208, true
821, 1566722142771, 2635, 1566722142978, 2842, 207, true
822, 1566722142773, 2637, 1566722142980, 2844, 207, true
823, 1566722142774, 2638, 1566722142980, 2844, 206, true
824, 1566722142776, 2640, 1566722142985, 2849, 209, true
825, 1566722142776, 2640, 1566722142984, 2848, 208, true
826, 1566722142778, 2642, 1566722142990, 2854, 212, true
827, 1566722142784, 2648, 1566722142992, 2856, 208, true
828, 1566722142786, 2650, 1566722142992, 2856, 206, true
829, 1566722142788, 2652, 1566722142993, 2857, 205, true
830, 1566722142790, 2654, 1566722142995, 2859, 205, true
831, 1566722142792, 2656, 1566722143000, 2864, 208, true
832, 1566722142793, 2657, 1566722142996, 2860, 203, true
833, 1566722142794, 2658, 1566722143004, 2868, 210, true
834, 1566722142795, 2659, 1566722143003, 2867, 208, true
835, 1566722142798, 2662, 1566722143008, 2872, 210, true
836, 1566722142798, 2662, 1566722143003, 2867, 205, true
837, 1566722142799, 2663, 1566722143009, 2873, 210, true
838, 1566722142799, 2663, 1566722143008, 2872, 209, true
839, 1566722142800, 2664, 1566722143008, 2872, 208, true
840, 1566722142802, 2666, 1566722143013, 2877, 211, true
841, 1566722142807, 2671, 1566722143013, 2877, 206, true
842, 1566722142809, 2673, 1566722143014, 2878, 205, true
843, 1566722142816, 2680, 1566722143024, 2888, 208, true
844, 1566722142818, 2682, 1566722143028, 2892, 210, true
845, 1566722142823, 2687, 1566722143028, 2892, 205, true
846, 1566722142825, 2689, 1566722143028, 2892, 203, true
847, 1566722142827, 2691, 1566722143032, 2896, 205, true
848, 1566722142829, 2693, 1566722143034, 2898, 205, true
849, 1566722142832, 2696, 1566722143039, 2903, 207, true
850, 1566722142834, 2698, 1566722143039, 2903, 205, true
851, 1566722142836, 2700, 1566722143046, 2910, 210, true
852, 1566722142845, 2709, 1566722143054, 2918, 209, true
853, 1566722142847, 2711, 1566722143054, 2918, 207, true
854, 1566722142849, 2713, 1566722143058, 2922, 209, true
855, 1566722142851, 2715, 1566722143058, 2922, 207, true
856, 1566722142857, 2721, 1566722143066, 2930, 209, true
857, 1566722142866, 2730, 1566722143074, 2938, 208, true
858, 1566722142872, 2736, 1566722143080, 2944, 208, true
859, 1566722142878, 2742, 1566722143082, 2946, 204, true
860, 1566722142880, 2744, 1566722143089, 2953, 209, true
861, 1566722142884, 2748, 1566722143093, 2957, 209, true
862, 1566722142886, 2750, 1566722143093, 2957, 207, true
863, 1566722142891, 2755, 1566722143095, 2959, 204, true
864, 1566722142893, 2757, 1566722143096, 2960, 203, true
865, 1566722142895, 2759, 1566722143101, 2965, 206, true
866, 1566722142896, 2760, 1566722143105, 2969, 209, true
867, 1566722142903, 2767, 1566722143110, 2974, 207, true
868, 1566722142906, 2770, 1566722143114, 2978, 208, true
869, 1566722142910, 2774, 1566722143115, 2979, 205, true
870, 1566722142914, 2778, 1566722143123, 2987, 209, true
871, 1566722142919, 2783, 1566722143128, 2992, 209, true
872, 1566722142926, 2790, 1566722143132, 2996, 206, true
873, 1566722142934, 2798, 1566722143138, 3002, 204, true
874, 1566722142936, 2800, 1566722143142, 3006, 206, true
875, 1566722142939, 2803, 1566722143149, 3013, 210, true
876, 1566722142940, 2804, 1566722143148, 3012, 208, true
877, 1566722142940, 2804, 1566722143147, 3011, 207, true
878, 1566722142945, 2809, 1566722143155, 3019, 210, true
879, 1566722142953, 2817, 1566722143163, 3027, 210, true
880, 1566722142954, 2818, 1566722143169, 3033, 215, true
881, 1566722142958, 2822, 1566722143179, 3043, 221, true
882, 1566722142960, 2824, 1566722143178, 3042, 218, true
883, 1566722142967, 2831, 1566722143179, 3043, 212, true
884, 1566722142976, 2840, 1566722143185, 3049, 209, true
885, 1566722142982, 2846, 1566722143189, 3053, 207, true
886, 1566722142986, 2850, 1566722143199, 3063, 213, true
887, 1566722142987, 2851, 1566722143199, 3063, 212, true
888, 1566722142988, 2852, 1566722143198, 3062, 210, true
889, 1566722142997, 2861, 1566722143202, 3066, 205, true
890, 1566722143001, 2865, 1566722143209, 3073, 208, true
891, 1566722143005, 2869, 1566722143215, 3079, 210, true
892, 1566722143011, 2875, 1566722143220, 3084, 209, true
893, 1566722143015, 2879, 1566722143225, 3089, 210, true
894, 1566722143016, 2880, 1566722143220, 3084, 204, true
895, 1566722143022, 2886, 1566722143228, 3092, 206, true
896, 1566722143025, 2889, 1566722143235, 3099, 210, true
897, 1566722143029, 2893, 1566722143235, 3099, 206, true
898, 1566722143032, 2896, 1566722143240, 3104, 208, true
899, 1566722143035, 2899, 1566722143241, 3105, 206, true
900, 1566722143037, 2901, 1566722143241, 3105, 204, true
901, 1566722143040, 2904, 1566722143244, 3108, 204, true
902, 1566722143042, 2906, 1566722143251, 3115, 209, true
903, 1566722143044, 2908, 1566722143251, 3115, 207, true
904, 1566722143046, 2910, 1566722143252, 3116, 206, true
905, 1566722143048, 2912, 1566722143253, 3117, 205, true
906, 1566722143051, 2915, 1566722143258, 3122, 207, true
907, 1566722143052, 2916, 1566722143258, 3122, 206, true
908, 1566722143056, 2920, 1566722143264, 3128, 208, true
909, 1566722143059, 2923, 1566722143264, 3128, 205, true
910, 1566722143060, 2924, 1566722143264, 3128, 204, true
911, 1566722143062, 2926, 1566722143269, 3133, 207, true
912, 1566722143063, 2927, 1566722143270, 3134, 207, true
913, 1566722143067, 2931, 1566722143272, 3136, 205, true
914, 1566722143068, 2932, 1566722143272, 3136, 204, true
915, 1566722143070, 2934, 1566722143277, 3141, 207, true
916, 1566722143071, 2935, 1566722143277, 3141, 206, true
917, 1566722143075, 2939, 1566722143279, 3143, 204, true
918, 1566722143076, 2940, 1566722143281, 3145, 205, true
919, 1566722143081, 2945, 1566722143289, 3153, 208, true
920, 1566722143083, 2947, 1566722143289, 3153, 206, true
921, 1566722143086, 2950, 1566722143292, 3156, 206, true
922, 1566722143090, 2954, 1566722143297, 3161, 207, true
923, 1566722143091, 2955, 1566722143301, 3165, 210, true
924, 1566722143097, 2961, 1566722143304, 3168, 207, true
925, 1566722143099, 2963, 1566722143304, 3168, 205, true
926, 1566722143101, 2965, 1566722143312, 3176, 211, true
927, 1566722143102, 2966, 1566722143312, 3176, 210, true
928, 1566722143103, 2967, 1566722143312, 3176, 209, true
929, 1566722143105, 2969, 1566722143310, 3174, 205, true
930, 1566722143107, 2971, 1566722143316, 3180, 209, true
931, 1566722143111, 2975, 1566722143316, 3180, 205, true
932, 1566722143112, 2976, 1566722143322, 3186, 210, true
933, 1566722143112, 2976, 1566722143318, 3182, 206, true
934, 1566722143114, 2978, 1566722143322, 3186, 208, true
935, 1566722143116, 2980, 1566722143322, 3186, 206, true
936, 1566722143117, 2981, 1566722143322, 3186, 205, true
937, 1566722143119, 2983, 1566722143325, 3189, 206, true
938, 1566722143119, 2983, 1566722143334, 3198, 215, true
939, 1566722143120, 2984, 1566722143330, 3194, 210, true
940, 1566722143126, 2990, 1566722143330, 3194, 204, true
941, 1566722143128, 2992, 1566722143339, 3203, 211, true
942, 1566722143129, 2993, 1566722143339, 3203, 210, true
943, 1566722143129, 2993, 1566722143339, 3203, 210, true
944, 1566722143130, 2994, 1566722143339, 3203, 209, true
945, 1566722143134, 2998, 1566722143341, 3205, 207, true
946, 1566722143135, 2999, 1566722143343, 3207, 208, true
947, 1566722143135, 2999, 1566722143344, 3208, 209, true
948, 1566722143139, 3003, 1566722143345, 3209, 206, true
949, 1566722143140, 3004, 1566722143349, 3213, 209, true
950, 1566722143149, 3013, 1566722143355, 3219, 206, true
951, 1566722143150, 3014, 1566722143359, 3223, 209, true
952, 1566722143151, 3015, 1566722143357, 3221, 206, true
953, 1566722143152, 3016, 1566722143360, 3224, 208, true
954, 1566722143153, 3017, 1566722143359, 3223, 206, true
955, 1566722143155, 3019, 1566722143367, 3231, 212, true
956, 1566722143156, 3020, 1566722143369, 3233, 213, true
957, 1566722143157, 3021, 1566722143368, 3232, 211, true
958, 1566722143159, 3023, 1566722143367, 3231, 208, true
959, 1566722143160, 3024, 1566722143370, 3234, 210, true
960, 1566722143160, 3024, 1566722143370, 3234, 210, true
961, 1566722143162, 3026, 1566722143370, 3234, 208, true
962, 1566722143163, 3027, 1566722143372, 3236, 209, true
963, 1566722143165, 3029, 1566722143373, 3237, 208, true
964, 1566722143167, 3031, 1566722143376, 3240, 209, true
965, 1566722143170, 3034, 1566722143379, 3243, 209, true
966, 1566722143172, 3036, 1566722143379, 3243, 207, true
967, 1566722143174, 3038, 1566722143379, 3243, 205, true
968, 1566722143176, 3040, 1566722143381, 3245, 205, true
969, 1566722143180, 3044, 1566722143399, 3263, 219, true
970, 1566722143182, 3046, 1566722143395, 3259, 213, true
971, 1566722143183, 3047, 1566722143395, 3259, 212, true
972, 1566722143185, 3049, 1566722143395, 3259, 210, true
973, 1566722143187, 3051, 1566722143395, 3259, 208, true
974, 1566722143190, 3054, 1566722143395, 3259, 205, true
975, 1566722143191, 3055, 1566722143397, 3261, 206, true
976, 1566722143193, 3057, 1566722143398, 3262, 205, true
977, 1566722143196, 3060, 1566722143419, 3283, 223, true
978, 1566722143200, 3064, 1566722143419, 3283, 219, true
979, 1566722143202, 3066, 1566722143419, 3283, 217, true
980, 1566722143204, 3068, 1566722143419, 3283, 215, true
981, 1566722143207, 3071, 1566722143418, 3282, 211, true
982, 1566722143210, 3074, 1566722143418, 3282, 208, true
983, 1566722143211, 3075, 1566722143475, 3339, 264, true
984, 1566722143212, 3076, 1566722143418, 3282, 206, true
985, 1566722143215, 3079, 1566722143423, 3287, 208, true
986, 1566722143216, 3080, 1566722143434, 3298, 218, true
987, 1566722143216, 3080, 1566722143423, 3287, 207, true
988, 1566722143217, 3081, 1566722143433, 3297, 216, true
989, 1566722143221, 3085, 1566722143432, 3296, 211, true
990, 1566722143221, 3085, 1566722143432, 3296, 211, true
991, 1566722143222, 3086, 1566722143433, 3297, 211, true
992, 1566722143222, 3086, 1566722143433, 3297, 211, true
993, 1566722143224, 3088, 1566722143432, 3296, 208, true
994, 1566722143226, 3090, 1566722143436, 3300, 210, true
995, 1566722143228, 3092, 1566722143436, 3300, 208, true
996, 1566722143230, 3094, 1566722143470, 3334, 240, true
997, 1566722143231, 3095, 1566722143470, 3334, 239, true
998, 1566722143236, 3100, 1566722143469, 3333, 233, true
999, 1566722143237, 3101, 1566722143470, 3334, 233, true
1000, 1566722143237, 3101, 1566722143454, 3318, 217, true
1001, 1566722143237, 3101, 1566722143454, 3318, 217, true
1002, 1566722143239, 3103, 1566722143469, 3333, 230, true
1003, 1566722143244, 3108, 1566722143454, 3318, 210, true
1004, 1566722143244, 3108, 1566722143454, 3318, 210, true
1005, 1566722143246, 3110, 1566722143454, 3318, 208, true
1006, 1566722143246, 3110, 1566722143460, 3324, 214, true
1007, 1566722143246, 3110, 1566722143460, 3324, 214, true
1008, 1566722143247, 3111, 1566722143461, 3325, 214, true
1009, 1566722143248, 3112, 1566722143460, 3324, 212, true
1010, 1566722143249, 3113, 1566722143460, 3324, 211, true
1011, 1566722143253, 3117, 1566722143461, 3325, 208, true
1012, 1566722143256, 3120, 1566722143467, 3331, 211, true
1013, 1566722143256, 3120, 1566722143467, 3331, 211, true
1014, 1566722143258, 3122, 1566722143467, 3331, 209, true
1015, 1566722143260, 3124, 1566722143475, 3339, 215, true
1016, 1566722143261, 3125, 1566722143482, 3346, 221, true
1017, 1566722143261, 3125, 1566722143475, 3339, 214, true
1018, 1566722143266, 3130, 1566722143474, 3338, 208, true
1019, 1566722143268, 3132, 1566722143476, 3340, 208, true
1020, 1566722143270, 3134, 1566722143476, 3340, 206, true
1021, 1566722143273, 3137, 1566722143481, 3345, 208, true
1022, 1566722143273, 3137, 1566722143481, 3345, 208, true
1023, 1566722143274, 3138, 1566722143481, 3345, 207, true
1024, 1566722143274, 3138, 1566722143481, 3345, 207, true
1025, 1566722143277, 3141, 1566722143486, 3350, 209, true
1026, 1566722143279, 3143, 1566722143485, 3349, 206, true
1027, 1566722143280, 3144, 1566722143485, 3349, 205, true
1028, 1566722143282, 3146, 1566722143492, 3356, 210, true
1029, 1566722143283, 3147, 1566722143487, 3351, 204, true
1030, 1566722143284, 3148, 1566722143499, 3363, 215, true
1031, 1566722143287, 3151, 1566722143499, 3363, 212, true
1032, 1566722143290, 3154, 1566722143499, 3363, 209, true
1033, 1566722143293, 3157, 1566722143502, 3366, 209, true
1034, 1566722143293, 3157, 1566722143502, 3366, 209, true
1035, 1566722143294, 3158, 1566722143510, 3374, 216, true
1036, 1566722143294, 3158, 1566722143507, 3371, 213, true
1037, 1566722143295, 3159, 1566722143501, 3365, 206, true
1038, 1566722143297, 3161, 1566722143510, 3374, 213, true
1039, 1566722143298, 3162, 1566722143508, 3372, 210, true
1040, 1566722143301, 3165, 1566722143510, 3374, 209, true
1041, 1566722143304, 3168, 1566722143512, 3376, 208, true
1042, 1566722143306, 3170, 1566722143526, 3390, 220, true
1043, 1566722143306, 3170, 1566722143515, 3379, 209, true
1044, 1566722143307, 3171, 1566722143526, 3390, 219, true
1045, 1566722143308, 3172, 1566722143526, 3390, 218, true
1046, 1566722143311, 3175, 1566722143526, 3390, 215, true
1047, 1566722143312, 3176, 1566722143527, 3391, 215, true
1048, 1566722143313, 3177, 1566722143527, 3391, 214, true
1049, 1566722143319, 3183, 1566722143530, 3394, 211, true
1050, 1566722143322, 3186, 1566722143530, 3394, 208, true
1051, 1566722143325, 3189, 1566722143530, 3394, 205, true
1052, 1566722143327, 3191, 1566722143534, 3398, 207, true
1053, 1566722143327, 3191, 1566722143533, 3397, 206, true
1054, 1566722143328, 3192, 1566722143531, 3395, 203, true
1055, 1566722143328, 3192, 1566722143541, 3405, 213, true
1056, 1566722143331, 3195, 1566722143545, 3409, 214, true
1057, 1566722143333, 3197, 1566722143541, 3405, 208, true
1058, 1566722143334, 3198, 1566722143545, 3409, 211, true
1059, 1566722143335, 3199, 1566722143554, 3418, 219, true
1060, 1566722143345, 3209, 1566722143562, 3426, 217, true
1061, 1566722143346, 3210, 1566722143562, 3426, 216, true
1062, 1566722143347, 3211, 1566722143563, 3427, 216, true
1063, 1566722143347, 3211, 1566722143563, 3427, 216, true
1064, 1566722143349, 3213, 1566722143565, 3429, 216, true
1065, 1566722143351, 3215, 1566722143566, 3430, 215, true
1066, 1566722143352, 3216, 1566722143566, 3430, 214, true
1067, 1566722143361, 3225, 1566722143581, 3445, 220, true
1068, 1566722143362, 3226, 1566722143574, 3438, 212, true
1069, 1566722143362, 3226, 1566722143581, 3445, 219, true
1070, 1566722143363, 3227, 1566722143582, 3446, 219, true
1071, 1566722143365, 3229, 1566722143584, 3448, 219, true
1072, 1566722143374, 3238, 1566722143581, 3445, 207, true
1073, 1566722143376, 3240, 1566722143633, 3497, 257, true
1074, 1566722143382, 3246, 1566722143591, 3455, 209, true
1075, 1566722143382, 3246, 1566722143632, 3496, 250, true
1076, 1566722143383, 3247, 1566722143634, 3498, 251, true
1077, 1566722143384, 3248, 1566722143615, 3479, 231, true
1078, 1566722143384, 3248, 1566722143616, 3480, 232, true
1079, 1566722143390, 3254, 1566722143634, 3498, 244, true
1080, 1566722143390, 3254, 1566722143632, 3496, 242, true
1081, 1566722143390, 3254, 1566722143637, 3501, 247, true
1082, 1566722143391, 3255, 1566722143634, 3498, 243, true
1083, 1566722143391, 3255, 1566722143632, 3496, 241, true
1084, 1566722143391, 3255, 1566722143602, 3466, 211, true
1085, 1566722143391, 3255, 1566722143602, 3466, 211, true
1086, 1566722143395, 3259, 1566722143614, 3478, 219, true
1087, 1566722143397, 3261, 1566722143614, 3478, 217, true
1088, 1566722143431, 3295, 1566722143650, 3514, 219, true
1089, 1566722143467, 3331, 1566722143672, 3536, 205, true
1090, 1566722143492, 3356, 1566722143698, 3562, 206, true
1091, 1566722143493, 3357, 1566722143697, 3561, 204, true
1092, 1566722143494, 3358, 1566722143715, 3579, 221, true
1093, 1566722143494, 3358, 1566722143732, 3596, 238, true
1094, 1566722143495, 3359, 1566722143700, 3564, 205, true
1095, 1566722143495, 3359, 1566722143732, 3596, 237, true
1096, 1566722143495, 3359, 1566722143732, 3596, 237, true
1097, 1566722143496, 3360, 1566722143732, 3596, 236, true
1098, 1566722143499, 3363, 1566722143724, 3588, 225, true
1099, 1566722143502, 3366, 1566722143732, 3596, 230, true
1100, 1566722143510, 3374, 1566722143727, 3591, 217, true
1101, 1566722143512, 3376, 1566722143759, 3623, 247, true
1102, 1566722143513, 3377, 1566722143760, 3624, 247, true
1103, 1566722143513, 3377, 1566722143732, 3596, 219, true
1104, 1566722143513, 3377, 1566722143751, 3615, 238, true
1105, 1566722143514, 3378, 1566722143733, 3597, 219, true
1106, 1566722143514, 3378, 1566722143751, 3615, 237, true
1107, 1566722143516, 3380, 1566722143759, 3623, 243, true
1108, 1566722143517, 3381, 1566722143764, 3628, 247, true
1109, 1566722143518, 3382, 1566722143764, 3628, 246, true
1110, 1566722143518, 3382, 1566722143765, 3629, 247, true
1111, 1566722143519, 3383, 1566722143764, 3628, 245, true
1112, 1566722143520, 3384, 1566722143759, 3623, 239, true
1113, 1566722143520, 3384, 1566722143759, 3623, 239, true
1114, 1566722143532, 3396, 1566722143764, 3628, 232, true
1115, 1566722143535, 3399, 1566722143763, 3627, 228, true
1116, 1566722143536, 3400, 1566722143758, 3622, 222, true
1117, 1566722143537, 3401, 1566722143764, 3628, 227, true
1118, 1566722143546, 3410, 1566722143758, 3622, 212, true
1119, 1566722143547, 3411, 1566722143765, 3629, 218, true
1120, 1566722143549, 3413, 1566722143766, 3630, 217, true
1121, 1566722143550, 3414, 1566722143766, 3630, 216, true
1122, 1566722143551, 3415, 1566722143766, 3630, 215, true
1123, 1566722143552, 3416, 1566722143766, 3630, 214, true
1124, 1566722143553, 3417, 1566722143766, 3630, 213, true
1125, 1566722143566, 3430, 1566722143777, 3641, 211, true
1126, 1566722143566, 3430, 1566722143776, 3640, 210, true
1127, 1566722143567, 3431, 1566722143781, 3645, 214, true
1128, 1566722143568, 3432, 1566722143794, 3658, 226, true
1129, 1566722143569, 3433, 1566722143782, 3646, 213, true
1130, 1566722143570, 3434, 1566722143779, 3643, 209, true
1131, 1566722143571, 3435, 1566722143790, 3654, 219, true
1132, 1566722143578, 3442, 1566722143794, 3658, 216, true
1133, 1566722143581, 3445, 1566722143794, 3658, 213, true
1134, 1566722143585, 3449, 1566722143800, 3664, 215, true
1135, 1566722143585, 3449, 1566722143800, 3664, 215, true
1136, 1566722143586, 3450, 1566722143800, 3664, 214, true
1137, 1566722143586, 3450, 1566722143800, 3664, 214, true
1138, 1566722143587, 3451, 1566722143805, 3669, 218, true
1139, 1566722143587, 3451, 1566722143828, 3692, 241, true
1140, 1566722143592, 3456, 1566722143809, 3673, 217, true
1141, 1566722143595, 3459, 1566722143811, 3675, 216, true
1142, 1566722143597, 3461, 1566722143810, 3674, 213, true
1143, 1566722143599, 3463, 1566722143811, 3675, 212, true
1144, 1566722143600, 3464, 1566722143834, 3698, 234, true
1145, 1566722143602, 3466, 1566722143834, 3698, 232, true
1146, 1566722143603, 3467, 1566722143834, 3698, 231, true
1147, 1566722143604, 3468, 1566722143830, 3694, 226, true
1148, 1566722143606, 3470, 1566722143826, 3690, 220, true
1149, 1566722143608, 3472, 1566722143828, 3692, 220, true
1150, 1566722143609, 3473, 1566722143830, 3694, 221, true
1151, 1566722143615, 3479, 1566722143828, 3692, 213, true
1152, 1566722143616, 3480, 1566722143827, 3691, 211, true
1153, 1566722143617, 3481, 1566722143834, 3698, 217, true
1154, 1566722143618, 3482, 1566722143830, 3694, 212, true
1155, 1566722143619, 3483, 1566722143830, 3694, 211, true
1156, 1566722143620, 3484, 1566722143836, 3700, 216, true
1157, 1566722143629, 3493, 1566722143842, 3706, 213, true
1158, 1566722143632, 3496, 1566722143845, 3709, 213, true
1159, 1566722143634, 3498, 1566722143867, 3731, 233, true
1160, 1566722143637, 3501, 1566722143869, 3733, 232, true
1161, 1566722143638, 3502, 1566722143871, 3735, 233, true
1162, 1566722143639, 3503, 1566722143870, 3734, 231, true
1163, 1566722143640, 3504, 1566722143852, 3716, 212, true
1164, 1566722143641, 3505, 1566722143852, 3716, 211, true
1165, 1566722143642, 3506, 1566722143867, 3731, 225, true
1166, 1566722143644, 3508, 1566722143868, 3732, 224, true
1167, 1566722143646, 3510, 1566722143868, 3732, 222, true
1168, 1566722143648, 3512, 1566722143867, 3731, 219, true
1169, 1566722143692, 3556, 1566722143899, 3763, 207, true
1170, 1566722143695, 3559, 1566722143901, 3765, 206, true
1171, 1566722143700, 3564, 1566722143906, 3770, 206, true
1172, 1566722143702, 3566, 1566722143912, 3776, 210, true
1173, 1566722143711, 3575, 1566722143959, 3823, 248, true
1174, 1566722143712, 3576, 1566722143923, 3787, 211, true
1175, 1566722143712, 3576, 1566722143923, 3787, 211, true
1176, 1566722143713, 3577, 1566722143923, 3787, 210, true
1177, 1566722143713, 3577, 1566722143923, 3787, 210, true
1178, 1566722143714, 3578, 1566722143923, 3787, 209, true
1179, 1566722143715, 3579, 1566722143923, 3787, 208, true
1180, 1566722143719, 3583, 1566722143932, 3796, 213, true
1181, 1566722143719, 3583, 1566722143930, 3794, 211, true
1182, 1566722143726, 3590, 1566722143936, 3800, 210, true
1183, 1566722143728, 3592, 1566722143938, 3802, 210, true
1184, 1566722143733, 3597, 1566722143938, 3802, 205, true
1185, 1566722143733, 3597, 1566722143957, 3821, 224, true
1186, 1566722143734, 3598, 1566722143957, 3821, 223, true
1187, 1566722143735, 3599, 1566722143957, 3821, 222, true
1188, 1566722143735, 3599, 1566722143953, 3817, 218, true
1189, 1566722143736, 3600, 1566722143993, 3857, 257, true
1190, 1566722143736, 3600, 1566722143957, 3821, 221, true
1191, 1566722143743, 3607, 1566722143957, 3821, 214, true
1192, 1566722143744, 3608, 1566722143957, 3821, 213, true
1193, 1566722143745, 3609, 1566722143993, 3857, 248, true
1194, 1566722143745, 3609, 1566722143983, 3847, 238, true
1195, 1566722143770, 3634, 1566722143981, 3845, 211, true
1196, 1566722143783, 3647, 1566722143993, 3857, 210, true
1197, 1566722143784, 3648, 1566722143993, 3857, 209, true
1198, 1566722143801, 3665, 1566722144006, 3870, 205, true
1199, 1566722143802, 3666, 1566722144013, 3877, 211, true
1200, 1566722143812, 3676, 1566722144017, 3881, 205, true
1201, 1566722143812, 3676, 1566722144019, 3883, 207, true
1202, 1566722143815, 3679, 1566722144025, 3889, 210, true
1203, 1566722143817, 3681, 1566722144024, 3888, 207, true
1204, 1566722143818, 3682, 1566722144025, 3889, 207, true
1205, 1566722143831, 3695, 1566722144035, 3899, 204, true
1206, 1566722143842, 3706, 1566722144049, 3913, 207, true
1207, 1566722143846, 3710, 1566722144051, 3915, 205, true
1208, 1566722143848, 3712, 1566722144054, 3918, 206, true
1209, 1566722143849, 3713, 1566722144062, 3926, 213, true
1210, 1566722143853, 3717, 1566722144064, 3928, 211, true
1211, 1566722143860, 3724, 1566722144064, 3928, 204, true
1212, 1566722143861, 3725, 1566722144067, 3931, 206, true
1213, 1566722143863, 3727, 1566722144068, 3932, 205, true
1214, 1566722143864, 3728, 1566722144075, 3939, 211, true
1215, 1566722143874, 3738, 1566722144084, 3948, 210, true
1216, 1566722143875, 3739, 1566722144081, 3945, 206, true
1217, 1566722143878, 3742, 1566722144082, 3946, 204, true
1218, 1566722143880, 3744, 1566722144084, 3948, 204, true
1219, 1566722143881, 3745, 1566722144095, 3959, 214, true
1220, 1566722143883, 3747, 1566722144087, 3951, 204, true
1221, 1566722143885, 3749, 1566722144098, 3962, 213, true
1222, 1566722143891, 3755, 1566722144095, 3959, 204, true
1223, 1566722143892, 3756, 1566722144143, 4007, 251, true
1224, 1566722143892, 3756, 1566722144143, 4007, 251, true
1225, 1566722143893, 3757, 1566722144144, 4008, 251, true
1226, 1566722143893, 3757, 1566722144139, 4003, 246, true
1227, 1566722143894, 3758, 1566722144142, 4006, 248, true
1228, 1566722143894, 3758, 1566722144143, 4007, 249, true
1229, 1566722143894, 3758, 1566722144145, 4009, 251, true
1230, 1566722143895, 3759, 1566722144148, 4012, 253, true
1231, 1566722143895, 3759, 1566722144142, 4006, 247, true
1232, 1566722143896, 3760, 1566722144139, 4003, 243, true
1233, 1566722143896, 3760, 1566722144151, 4015, 255, true
1234, 1566722143897, 3761, 1566722144152, 4016, 255, true
1235, 1566722143897, 3761, 1566722144148, 4012, 251, true
1236, 1566722143898, 3762, 1566722144147, 4011, 249, true
1237, 1566722143899, 3763, 1566722144113, 3977, 214, true
1238, 1566722143900, 3764, 1566722144151, 4015, 251, true
1239, 1566722143902, 3766, 1566722144113, 3977, 211, true
1240, 1566722143906, 3770, 1566722144113, 3977, 207, true
1241, 1566722143907, 3771, 1566722144152, 4016, 245, true
1242, 1566722143908, 3772, 1566722144151, 4015, 243, true
1243, 1566722143908, 3772, 1566722144150, 4014, 242, true
1244, 1566722143909, 3773, 1566722144150, 4014, 241, true
1245, 1566722143910, 3774, 1566722144153, 4017, 243, true
1246, 1566722143911, 3775, 1566722144151, 4015, 240, true
1247, 1566722143912, 3776, 1566722144145, 4009, 233, true
1248, 1566722143912, 3776, 1566722144117, 3981, 205, true
1249, 1566722143913, 3777, 1566722144152, 4016, 239, true
1250, 1566722143914, 3778, 1566722144151, 4015, 237, true
1251, 1566722143914, 3778, 1566722144148, 4012, 234, true
1252, 1566722143914, 3778, 1566722144148, 4012, 234, true
1253, 1566722143915, 3779, 1566722144128, 3992, 213, true
1254, 1566722143915, 3779, 1566722144120, 3984, 205, true
1255, 1566722143916, 3780, 1566722144127, 3991, 211, true
1256, 1566722143918, 3782, 1566722144129, 3993, 211, true
1257, 1566722143923, 3787, 1566722144129, 3993, 206, true
1258, 1566722143945, 3809, 1566722144197, 4061, 252, true
1259, 1566722143945, 3809, 1566722144195, 4059, 250, true
1260, 1566722143946, 3810, 1566722144200, 4064, 254, true
1261, 1566722143946, 3810, 1566722144155, 4019, 209, true
1262, 1566722143946, 3810, 1566722144200, 4064, 254, true
1263, 1566722143946, 3810, 1566722144155, 4019, 209, true
1264, 1566722143948, 3812, 1566722144155, 4019, 207, true
1265, 1566722143949, 3813, 1566722144210, 4074, 261, true
1266, 1566722143949, 3813, 1566722144160, 4024, 211, true
1267, 1566722143949, 3813, 1566722144162, 4026, 213, true
1268, 1566722143950, 3814, 1566722144161, 4025, 211, true
1269, 1566722143952, 3816, 1566722144161, 4025, 209, true
1270, 1566722143959, 3823, 1566722144167, 4031, 208, true
1271, 1566722143960, 3824, 1566722144164, 4028, 204, true
1272, 1566722143961, 3825, 1566722144170, 4034, 209, true
1273, 1566722143961, 3825, 1566722144170, 4034, 209, true
1274, 1566722143962, 3826, 1566722144170, 4034, 208, true
1275, 1566722143963, 3827, 1566722144170, 4034, 207, true
1276, 1566722143963, 3827, 1566722144170, 4034, 207, true
1277, 1566722143965, 3829, 1566722144171, 4035, 206, true
1278, 1566722143967, 3831, 1566722144176, 4040, 209, true
1279, 1566722143968, 3832, 1566722144179, 4043, 211, true
1280, 1566722143969, 3833, 1566722144179, 4043, 210, true
1281, 1566722143969, 3833, 1566722144179, 4043, 210, true
1282, 1566722143970, 3834, 1566722144178, 4042, 208, true
1283, 1566722143973, 3837, 1566722144179, 4043, 206, true
1284, 1566722143974, 3838, 1566722144179, 4043, 205, true
1285, 1566722143975, 3839, 1566722144182, 4046, 207, true
1286, 1566722143976, 3840, 1566722144180, 4044, 204, true
1287, 1566722143977, 3841, 1566722144184, 4048, 207, true
1288, 1566722143978, 3842, 1566722144190, 4054, 212, true
1289, 1566722143979, 3843, 1566722144186, 4050, 207, true
1290, 1566722143981, 3845, 1566722144185, 4049, 204, true
1291, 1566722143983, 3847, 1566722144194, 4058, 211, true
1292, 1566722143984, 3848, 1566722144195, 4059, 211, true
1293, 1566722143985, 3849, 1566722144197, 4061, 212, true
1294, 1566722143986, 3850, 1566722144196, 4060, 210, true
1295, 1566722143994, 3858, 1566722144197, 4061, 203, true
1296, 1566722143995, 3859, 1566722144209, 4073, 214, true
1297, 1566722143995, 3859, 1566722144200, 4064, 205, true
1298, 1566722143996, 3860, 1566722144210, 4074, 214, true
1299, 1566722143998, 3862, 1566722144210, 4074, 212, true
1300, 1566722143998, 3862, 1566722144210, 4074, 212, true
1301, 1566722143999, 3863, 1566722144210, 4074, 211, true
1302, 1566722144001, 3865, 1566722144212, 4076, 211, true
1303, 1566722144001, 3865, 1566722144211, 4075, 210, true
1304, 1566722144004, 3868, 1566722144219, 4083, 215, true
1305, 1566722144009, 3873, 1566722144219, 4083, 210, true
1306, 1566722144010, 3874, 1566722144220, 4084, 210, true
1307, 1566722144013, 3877, 1566722144220, 4084, 207, true
1308, 1566722144014, 3878, 1566722144222, 4086, 208, true
1309, 1566722144015, 3879, 1566722144222, 4086, 207, true
1310, 1566722144017, 3881, 1566722144228, 4092, 211, true
1311, 1566722144017, 3881, 1566722144226, 4090, 209, true
1312, 1566722144019, 3883, 1566722144225, 4089, 206, true
1313, 1566722144020, 3884, 1566722144230, 4094, 210, true
1314, 1566722144021, 3885, 1566722144230, 4094, 209, true
1315, 1566722144027, 3891, 1566722144230, 4094, 203, true
1316, 1566722144028, 3892, 1566722144232, 4096, 204, true
1317, 1566722144030, 3894, 1566722144239, 4103, 209, true
1318, 1566722144032, 3896, 1566722144239, 4103, 207, true
1319, 1566722144034, 3898, 1566722144249, 4113, 215, true
1320, 1566722144038, 3902, 1566722144249, 4113, 211, true
1321, 1566722144041, 3905, 1566722144251, 4115, 210, true
1322, 1566722144044, 3908, 1566722144255, 4119, 211, true
1323, 1566722144049, 3913, 1566722144262, 4126, 213, true
1324, 1566722144052, 3916, 1566722144263, 4127, 211, true
1325, 1566722144055, 3919, 1566722144264, 4128, 209, true
1326, 1566722144057, 3921, 1566722144264, 4128, 207, true
1327, 1566722144059, 3923, 1566722144268, 4132, 209, true
1328, 1566722144065, 3929, 1566722144272, 4136, 207, true
1329, 1566722144068, 3932, 1566722144280, 4144, 212, true
1330, 1566722144070, 3934, 1566722144281, 4145, 211, true
1331, 1566722144072, 3936, 1566722144290, 4154, 218, true
1332, 1566722144076, 3940, 1566722144281, 4145, 205, true
1333, 1566722144078, 3942, 1566722144290, 4154, 212, true
1334, 1566722144078, 3942, 1566722144296, 4160, 218, true
1335, 1566722144079, 3943, 1566722144290, 4154, 211, true
1336, 1566722144085, 3949, 1566722144294, 4158, 209, true
1337, 1566722144088, 3952, 1566722144296, 4160, 208, true
1338, 1566722144090, 3954, 1566722144300, 4164, 210, true
1339, 1566722144092, 3956, 1566722144304, 4168, 212, true
1340, 1566722144096, 3960, 1566722144300, 4164, 204, true
1341, 1566722144099, 3963, 1566722144312, 4176, 213, true
1342, 1566722144100, 3964, 1566722144313, 4177, 213, true
1343, 1566722144103, 3967, 1566722144317, 4181, 214, true
1344, 1566722144104, 3968, 1566722144313, 4177, 209, true
1345, 1566722144107, 3971, 1566722144314, 4178, 207, true
1346, 1566722144110, 3974, 1566722144322, 4186, 212, true
1347, 1566722144118, 3982, 1566722144327, 4191, 209, true
1348, 1566722144121, 3985, 1566722144327, 4191, 206, true
1349, 1566722144124, 3988, 1566722144329, 4193, 205, true
1350, 1566722144129, 3993, 1566722144340, 4204, 211, true
1351, 1566722144131, 3995, 1566722144340, 4204, 209, true
1352, 1566722144133, 3997, 1566722144345, 4209, 212, true
1353, 1566722144135, 3999, 1566722144345, 4209, 210, true
1354, 1566722144137, 4001, 1566722144344, 4208, 207, true
1355, 1566722144164, 4028, 1566722144394, 4258, 230, true
1356, 1566722144166, 4030, 1566722144399, 4263, 233, true
1357, 1566722144180, 4044, 1566722144426, 4290, 246, true
1358, 1566722144201, 4065, 1566722144426, 4290, 225, true
1359, 1566722144213, 4077, 1566722144427, 4291, 214, true
1360, 1566722144215, 4079, 1566722144441, 4305, 226, true
1361, 1566722144231, 4095, 1566722144444, 4308, 213, true
1362, 1566722144235, 4099, 1566722144448, 4312, 213, true
1363, 1566722144236, 4100, 1566722144448, 4312, 212, true
1364, 1566722144244, 4108, 1566722144452, 4316, 208, true
1365, 1566722144247, 4111, 1566722144452, 4316, 205, true
1366, 1566722144247, 4111, 1566722144452, 4316, 205, true
1367, 1566722144249, 4113, 1566722144455, 4319, 206, true
1368, 1566722144252, 4116, 1566722144460, 4324, 208, true
1369, 1566722144265, 4129, 1566722144478, 4342, 213, true
1370, 1566722144266, 4130, 1566722144475, 4339, 209, true
1371, 1566722144266, 4130, 1566722144478, 4342, 212, true
1372, 1566722144268, 4132, 1566722144482, 4346, 214, true
1373, 1566722144270, 4134, 1566722144478, 4342, 208, true
1374, 1566722144274, 4138, 1566722144491, 4355, 217, true
1375, 1566722144275, 4139, 1566722144486, 4350, 211, true
1376, 1566722144276, 4140, 1566722144486, 4350, 210, true
1377, 1566722144282, 4146, 1566722144493, 4357, 211, true
1378, 1566722144282, 4146, 1566722144493, 4357, 211, true
1379, 1566722144284, 4148, 1566722144496, 4360, 212, true
1380, 1566722144285, 4149, 1566722144497, 4361, 212, true
1381, 1566722144296, 4160, 1566722144522, 4386, 226, true
1382, 1566722144296, 4160, 1566722144514, 4378, 218, true
1383, 1566722144297, 4161, 1566722144522, 4386, 225, true
1384, 1566722144297, 4161, 1566722144514, 4378, 217, true
1385, 1566722144297, 4161, 1566722144514, 4378, 217, true
1386, 1566722144298, 4162, 1566722144514, 4378, 216, true
1387, 1566722144298, 4162, 1566722144522, 4386, 224, true
1388, 1566722144298, 4162, 1566722144522, 4386, 224, true
1389, 1566722144300, 4164, 1566722144523, 4387, 223, true
1390, 1566722144300, 4164, 1566722144523, 4387, 223, true
1391, 1566722144315, 4179, 1566722144529, 4393, 214, true
1392, 1566722144315, 4179, 1566722144528, 4392, 213, true
1393, 1566722144316, 4180, 1566722144530, 4394, 214, true
1394, 1566722144317, 4181, 1566722144530, 4394, 213, true
1395, 1566722144324, 4188, 1566722144534, 4398, 210, true
1396, 1566722144325, 4189, 1566722144536, 4400, 211, true
1397, 1566722144330, 4194, 1566722144541, 4405, 211, true
1398, 1566722144331, 4195, 1566722144543, 4407, 212, true
1399, 1566722144331, 4195, 1566722144550, 4414, 219, true
1400, 1566722144332, 4196, 1566722144546, 4410, 214, true
1401, 1566722144332, 4196, 1566722144550, 4414, 218, true
1402, 1566722144332, 4196, 1566722144550, 4414, 218, true
1403, 1566722144333, 4197, 1566722144550, 4414, 217, true
1404, 1566722144345, 4209, 1566722144550, 4414, 205, true
1405, 1566722144347, 4211, 1566722144552, 4416, 205, true
1406, 1566722144348, 4212, 1566722144557, 4421, 209, true
1407, 1566722144349, 4213, 1566722144554, 4418, 205, true
1408, 1566722144349, 4213, 1566722144557, 4421, 208, true
1409, 1566722144353, 4217, 1566722144557, 4421, 204, true
1410, 1566722144355, 4219, 1566722144561, 4425, 206, true
1411, 1566722144358, 4222, 1566722144565, 4429, 207, true
1412, 1566722144358, 4222, 1566722144570, 4434, 212, true
1413, 1566722144360, 4224, 1566722144570, 4434, 210, true
1414, 1566722144362, 4226, 1566722144572, 4436, 210, true
1415, 1566722144365, 4229, 1566722144576, 4440, 211, true
1416, 1566722144367, 4231, 1566722144578, 4442, 211, true
1417, 1566722144372, 4236, 1566722144580, 4444, 208, true
1418, 1566722144376, 4240, 1566722144580, 4444, 204, true
1419, 1566722144378, 4242, 1566722144585, 4449, 207, true
1420, 1566722144379, 4243, 1566722144594, 4458, 215, true
1421, 1566722144379, 4243, 1566722144592, 4456, 213, true
1422, 1566722144383, 4247, 1566722144594, 4458, 211, true
1423, 1566722144387, 4251, 1566722144596, 4460, 209, true
1424, 1566722144390, 4254, 1566722144598, 4462, 208, true
1425, 1566722144394, 4258, 1566722144602, 4466, 208, true
1426, 1566722144395, 4259, 1566722144607, 4471, 212, true
1427, 1566722144395, 4259, 1566722144607, 4471, 212, true
1428, 1566722144396, 4260, 1566722144607, 4471, 211, true
1429, 1566722144409, 4273, 1566722144616, 4480, 207, true
1430, 1566722144410, 4274, 1566722144615, 4479, 205, true
1431, 1566722144413, 4277, 1566722144624, 4488, 211, true
1432, 1566722144418, 4282, 1566722144631, 4495, 213, true
1433, 1566722144429, 4293, 1566722144638, 4502, 209, true
1434, 1566722144430, 4294, 1566722144638, 4502, 208, true
1435, 1566722144433, 4297, 1566722144644, 4508, 211, true
1436, 1566722144445, 4309, 1566722144761, 4625, 316, true
1437, 1566722144449, 4313, 1566722144775, 4639, 326, true
1438, 1566722144453, 4317, 1566722144664, 4528, 211, true
1439, 1566722144456, 4320, 1566722144663, 4527, 207, true
1440, 1566722144456, 4320, 1566722144663, 4527, 207, true
1441, 1566722144459, 4323, 1566722144668, 4532, 209, true
1442, 1566722144461, 4325, 1566722144665, 4529, 204, true
1443, 1566722144461, 4325, 1566722144669, 4533, 208, true
1444, 1566722144462, 4326, 1566722144675, 4539, 213, true
1445, 1566722144464, 4328, 1566722144685, 4549, 221, true
1446, 1566722144464, 4328, 1566722144685, 4549, 221, true
1447, 1566722144466, 4330, 1566722144677, 4541, 211, true
1448, 1566722144466, 4330, 1566722144675, 4539, 209, true
1449, 1566722144467, 4331, 1566722144685, 4549, 218, true
1450, 1566722144471, 4335, 1566722144688, 4552, 217, true
1451, 1566722144487, 4351, 1566722144699, 4563, 212, true
1452, 1566722144494, 4358, 1566722144703, 4567, 209, true
1453, 1566722144499, 4363, 1566722144703, 4567, 204, true
1454, 1566722144499, 4363, 1566722144704, 4568, 205, true
1455, 1566722144500, 4364, 1566722144704, 4568, 204, true
1456, 1566722144501, 4365, 1566722144709, 4573, 208, true
1457, 1566722144502, 4366, 1566722144715, 4579, 213, true
1458, 1566722144503, 4367, 1566722144729, 4593, 226, true
1459, 1566722144507, 4371, 1566722144720, 4584, 213, true
1460, 1566722144510, 4374, 1566722144729, 4593, 219, true
1461, 1566722144515, 4379, 1566722144729, 4593, 214, true
1462, 1566722144515, 4379, 1566722144729, 4593, 214, true
1463, 1566722144516, 4380, 1566722144735, 4599, 219, true
1464, 1566722144532, 4396, 1566722144740, 4604, 208, true
1465, 1566722144533, 4397, 1566722144741, 4605, 208, true
1466, 1566722144539, 4403, 1566722144751, 4615, 212, true
1467, 1566722144540, 4404, 1566722144746, 4610, 206, true
1468, 1566722144543, 4407, 1566722144751, 4615, 208, true
1469, 1566722144544, 4408, 1566722144753, 4617, 209, true
1470, 1566722144544, 4408, 1566722144752, 4616, 208, true
1471, 1566722144546, 4410, 1566722144751, 4615, 205, true
1472, 1566722144547, 4411, 1566722144754, 4618, 207, true
1473, 1566722144554, 4418, 1566722144765, 4629, 211, true
1474, 1566722144554, 4418, 1566722144764, 4628, 210, true
1475, 1566722144555, 4419, 1566722144765, 4629, 210, true
1476, 1566722144558, 4422, 1566722144763, 4627, 205, true
1477, 1566722144559, 4423, 1566722144765, 4629, 206, true
1478, 1566722144560, 4424, 1566722144765, 4629, 205, true
1479, 1566722144561, 4425, 1566722144770, 4634, 209, true
1480, 1566722144562, 4426, 1566722144769, 4633, 207, true
1481, 1566722144563, 4427, 1566722144770, 4634, 207, true
1482, 1566722144565, 4429, 1566722144781, 4645, 216, true
1483, 1566722144566, 4430, 1566722144780, 4644, 214, true
1484, 1566722144566, 4430, 1566722144781, 4645, 215, true
1485, 1566722144570, 4434, 1566722144781, 4645, 211, true
1486, 1566722144573, 4437, 1566722144777, 4641, 204, true
1487, 1566722144574, 4438, 1566722144781, 4645, 207, true
1488, 1566722144577, 4441, 1566722144788, 4652, 211, true
1489, 1566722144581, 4445, 1566722144788, 4652, 207, true
1490, 1566722144582, 4446, 1566722144788, 4652, 206, true
1491, 1566722144584, 4448, 1566722144792, 4656, 208, true
1492, 1566722144585, 4449, 1566722144796, 4660, 211, true
1493, 1566722144586, 4450, 1566722144802, 4666, 216, true
1494, 1566722144586, 4450, 1566722144802, 4666, 216, true
1495, 1566722144586, 4450, 1566722144801, 4665, 215, true
1496, 1566722144587, 4451, 1566722144801, 4665, 214, true
1497, 1566722144588, 4452, 1566722144801, 4665, 213, true
1498, 1566722144588, 4452, 1566722144803, 4667, 215, true
1499, 1566722144589, 4453, 1566722144806, 4670, 217, true
1500, 1566722144590, 4454, 1566722144801, 4665, 211, true
1501, 1566722144591, 4455, 1566722144805, 4669, 214, true
1502, 1566722144594, 4458, 1566722144806, 4670, 212, true
1503, 1566722144597, 4461, 1566722144806, 4670, 209, true
1504, 1566722144599, 4463, 1566722144803, 4667, 204, true
1505, 1566722144602, 4466, 1566722144808, 4672, 206, true
1506, 1566722144603, 4467, 1566722144808, 4672, 205, true
1507, 1566722144604, 4468, 1566722144809, 4673, 205, true
1508, 1566722144608, 4472, 1566722144812, 4676, 204, true
1509, 1566722144608, 4472, 1566722144816, 4680, 208, true
1510, 1566722144609, 4473, 1566722144821, 4685, 212, true
1511, 1566722144609, 4473, 1566722144817, 4681, 208, true
1512, 1566722144609, 4473, 1566722144822, 4686, 213, true
1513, 1566722144610, 4474, 1566722144817, 4681, 207, true
1514, 1566722144611, 4475, 1566722144822, 4686, 211, true
1515, 1566722144613, 4477, 1566722144822, 4686, 209, true
1516, 1566722144614, 4478, 1566722144822, 4686, 208, true
1517, 1566722144616, 4480, 1566722144823, 4687, 207, true
1518, 1566722144619, 4483, 1566722144824, 4688, 205, true
1519, 1566722144620, 4484, 1566722144824, 4688, 204, true
1520, 1566722144622, 4486, 1566722144832, 4696, 210, true
1521, 1566722144625, 4489, 1566722144832, 4696, 207, true
1522, 1566722144625, 4489, 1566722144831, 4695, 206, true
1523, 1566722144627, 4491, 1566722144832, 4696, 205, true
1524, 1566722144629, 4493, 1566722144834, 4698, 205, true
1525, 1566722144632, 4496, 1566722144837, 4701, 205, true
1526, 1566722144634, 4498, 1566722144838, 4702, 204, true
1527, 1566722144636, 4500, 1566722144844, 4708, 208, true
1528, 1566722144639, 4503, 1566722144844, 4708, 205, true
1529, 1566722144639, 4503, 1566722144849, 4713, 210, true
1530, 1566722144640, 4504, 1566722144848, 4712, 208, true
1531, 1566722144641, 4505, 1566722144848, 4712, 207, true
1532, 1566722144642, 4506, 1566722144854, 4718, 212, true
1533, 1566722144643, 4507, 1566722144854, 4718, 211, true
1534, 1566722144647, 4511, 1566722144854, 4718, 207, true
1535, 1566722144647, 4511, 1566722144854, 4718, 207, true
1536, 1566722144648, 4512, 1566722144983, 4847, 335, true
1537, 1566722144664, 4528, 1566722144874, 4738, 210, true
1538, 1566722144665, 4529, 1566722144876, 4740, 211, true
1539, 1566722144666, 4530, 1566722144876, 4740, 210, true
1540, 1566722144668, 4532, 1566722144882, 4746, 214, true
1541, 1566722144669, 4533, 1566722144896, 4760, 227, true
1542, 1566722144670, 4534, 1566722144913, 4777, 243, true
1543, 1566722144670, 4534, 1566722144925, 4789, 255, true
1544, 1566722144671, 4535, 1566722144926, 4790, 255, true
1545, 1566722144671, 4535, 1566722144926, 4790, 255, true
1546, 1566722144672, 4536, 1566722144912, 4776, 240, true
1547, 1566722144672, 4536, 1566722144925, 4789, 253, true
1548, 1566722144674, 4538, 1566722144926, 4790, 252, true
1549, 1566722144676, 4540, 1566722144912, 4776, 236, true
1550, 1566722144676, 4540, 1566722144912, 4776, 236, true
1551, 1566722144678, 4542, 1566722144925, 4789, 247, true
1552, 1566722144678, 4542, 1566722144913, 4777, 235, true
1553, 1566722144679, 4543, 1566722144913, 4777, 234, true
1554, 1566722144679, 4543, 1566722144912, 4776, 233, true
1555, 1566722144679, 4543, 1566722144926, 4790, 247, true
1556, 1566722144680, 4544, 1566722144926, 4790, 246, true
1557, 1566722144681, 4545, 1566722144905, 4769, 224, true
1558, 1566722144682, 4546, 1566722144926, 4790, 244, true
1559, 1566722144685, 4549, 1566722144912, 4776, 227, true
1560, 1566722144685, 4549, 1566722144925, 4789, 240, true
1561, 1566722144686, 4550, 1566722144901, 4765, 215, true
1562, 1566722144687, 4551, 1566722144927, 4791, 240, true
1563, 1566722144688, 4552, 1566722144926, 4790, 238, true
1564, 1566722144689, 4553, 1566722144931, 4795, 242, true
1565, 1566722144689, 4553, 1566722144927, 4791, 238, true
1566, 1566722144690, 4554, 1566722144931, 4795, 241, true
1567, 1566722144691, 4555, 1566722144927, 4791, 236, true
1568, 1566722144692, 4556, 1566722144931, 4795, 239, true
1569, 1566722144692, 4556, 1566722144931, 4795, 239, true
1570, 1566722144693, 4557, 1566722144928, 4792, 235, true
1571, 1566722144694, 4558, 1566722144927, 4791, 233, true
1572, 1566722144695, 4559, 1566722144927, 4791, 232, true
1573, 1566722144696, 4560, 1566722144928, 4792, 232, true
1574, 1566722144696, 4560, 1566722144931, 4795, 235, true
1575, 1566722144697, 4561, 1566722144927, 4791, 230, true
1576, 1566722144699, 4563, 1566722144932, 4796, 233, true
1577, 1566722144705, 4569, 1566722144932, 4796, 227, true
1578, 1566722144706, 4570, 1566722144927, 4791, 221, true
1579, 1566722144709, 4573, 1566722144935, 4799, 226, true
1580, 1566722144710, 4574, 1566722144932, 4796, 222, true
1581, 1566722144711, 4575, 1566722144932, 4796, 221, true
1582, 1566722144712, 4576, 1566722144932, 4796, 220, true
1583, 1566722144713, 4577, 1566722144932, 4796, 219, true
1584, 1566722144716, 4580, 1566722144935, 4799, 219, true
1585, 1566722144717, 4581, 1566722144935, 4799, 218, true
1586, 1566722144721, 4585, 1566722144931, 4795, 210, true
1587, 1566722144722, 4586, 1566722144937, 4801, 215, true
1588, 1566722144724, 4588, 1566722144936, 4800, 212, true
1589, 1566722144725, 4589, 1566722144935, 4799, 210, true
1590, 1566722144730, 4594, 1566722144937, 4801, 207, true
1591, 1566722144733, 4597, 1566722144938, 4802, 205, true
1592, 1566722144736, 4600, 1566722144944, 4808, 208, true
1593, 1566722144737, 4601, 1566722144941, 4805, 204, true
1594, 1566722144738, 4602, 1566722144951, 4815, 213, true
1595, 1566722144738, 4602, 1566722144945, 4809, 207, true
1596, 1566722144741, 4605, 1566722144949, 4813, 208, true
1597, 1566722144742, 4606, 1566722144951, 4815, 209, true
1598, 1566722144743, 4607, 1566722144951, 4815, 208, true
1599, 1566722144744, 4608, 1566722144951, 4815, 207, true
1600, 1566722144747, 4611, 1566722144961, 4825, 214, true
1601, 1566722144747, 4611, 1566722144961, 4825, 214, true
1602, 1566722144748, 4612, 1566722144961, 4825, 213, true
1603, 1566722144752, 4616, 1566722144961, 4825, 209, true
1604, 1566722144754, 4618, 1566722144961, 4825, 207, true
1605, 1566722144756, 4620, 1566722144961, 4825, 205, true
1606, 1566722144757, 4621, 1566722144968, 4832, 211, true
1607, 1566722144757, 4621, 1566722144970, 4834, 213, true
1608, 1566722144758, 4622, 1566722144967, 4831, 209, true
1609, 1566722144759, 4623, 1566722144968, 4832, 209, true
1610, 1566722144762, 4626, 1566722144977, 4841, 215, true
1611, 1566722144765, 4629, 1566722144975, 4839, 210, true
1612, 1566722144766, 4630, 1566722144977, 4841, 211, true
1613, 1566722144767, 4631, 1566722144976, 4840, 209, true
1614, 1566722144771, 4635, 1566722144983, 4847, 212, true
1615, 1566722144771, 4635, 1566722144980, 4844, 209, true
1616, 1566722144772, 4636, 1566722144984, 4848, 212, true
1617, 1566722144773, 4637, 1566722144977, 4841, 204, true
1618, 1566722144774, 4638, 1566722144983, 4847, 209, true
1619, 1566722144778, 4642, 1566722144984, 4848, 206, true
1620, 1566722144782, 4646, 1566722144991, 4855, 209, true
1621, 1566722144784, 4648, 1566722144991, 4855, 207, true
1622, 1566722144786, 4650, 1566722144999, 4863, 213, true
1623, 1566722144789, 4653, 1566722144999, 4863, 210, true
1624, 1566722144790, 4654, 1566722144999, 4863, 209, true
1625, 1566722144793, 4657, 1566722144999, 4863, 206, true
1626, 1566722144794, 4658, 1566722145000, 4864, 206, true
1627, 1566722144797, 4661, 1566722145005, 4869, 208, true
1628, 1566722144798, 4662, 1566722145003, 4867, 205, true
1629, 1566722144813, 4677, 1566722145031, 4895, 218, true
1630, 1566722144827, 4691, 1566722145043, 4907, 216, true
1631, 1566722144829, 4693, 1566722145043, 4907, 214, true
1632, 1566722144838, 4702, 1566722145047, 4911, 209, true
1633, 1566722144840, 4704, 1566722145046, 4910, 206, true
1634, 1566722144842, 4706, 1566722145052, 4916, 210, true
1635, 1566722144845, 4709, 1566722145052, 4916, 207, true
1636, 1566722144851, 4715, 1566722145071, 4935, 220, true
1637, 1566722144857, 4721, 1566722145072, 4936, 215, true
1638, 1566722144859, 4723, 1566722145072, 4936, 213, true
1639, 1566722144860, 4724, 1566722145071, 4935, 211, true
1640, 1566722144861, 4725, 1566722145077, 4941, 216, true
1641, 1566722144865, 4729, 1566722145075, 4939, 210, true
1642, 1566722144867, 4731, 1566722145095, 4959, 228, true
1643, 1566722144882, 4746, 1566722145095, 4959, 213, true
1644, 1566722144883, 4747, 1566722145094, 4958, 211, true
1645, 1566722144884, 4748, 1566722145095, 4959, 211, true
1646, 1566722144886, 4750, 1566722145099, 4963, 213, true
1647, 1566722144887, 4751, 1566722145102, 4966, 215, true
1648, 1566722144891, 4755, 1566722145110, 4974, 219, true
1649, 1566722144961, 4825, 1566722145217, 5081, 256, true
1650, 1566722144962, 4826, 1566722145216, 5080, 254, true
1651, 1566722144966, 4830, 1566722145216, 5080, 250, true
1652, 1566722144969, 4833, 1566722145216, 5080, 247, true
1653, 1566722144971, 4835, 1566722145216, 5080, 245, true
1654, 1566722144972, 4836, 1566722145215, 5079, 243, true
1655, 1566722144974, 4838, 1566722145215, 5079, 241, true
1656, 1566722144977, 4841, 1566722145215, 5079, 238, true
1657, 1566722144978, 4842, 1566722145215, 5079, 237, true
1658, 1566722144981, 4845, 1566722145214, 5078, 233, true
1659, 1566722144985, 4849, 1566722145215, 5079, 230, true
1660, 1566722144985, 4849, 1566722145215, 5079, 230, true
1661, 1566722144987, 4851, 1566722145215, 5079, 228, true
1662, 1566722144989, 4853, 1566722145206, 5070, 217, true
1663, 1566722144992, 4856, 1566722145205, 5069, 213, true
1664, 1566722144993, 4857, 1566722145210, 5074, 217, true
1665, 1566722144994, 4858, 1566722145210, 5074, 216, true
1666, 1566722144996, 4860, 1566722145210, 5074, 214, true
1667, 1566722145001, 4865, 1566722145212, 5076, 211, true
1668, 1566722145003, 4867, 1566722145213, 5077, 210, true
1669, 1566722145006, 4870, 1566722145213, 5077, 207, true
1670, 1566722145007, 4871, 1566722145213, 5077, 206, true
1671, 1566722145008, 4872, 1566722145213, 5077, 205, true
1672, 1566722145009, 4873, 1566722145220, 5084, 211, true
1673, 1566722145011, 4875, 1566722145221, 5085, 210, true
1674, 1566722145012, 4876, 1566722145221, 5085, 209, true
1675, 1566722145013, 4877, 1566722145225, 5089, 212, true
1676, 1566722145016, 4880, 1566722145228, 5092, 212, true
1677, 1566722145017, 4881, 1566722145228, 5092, 211, true
1678, 1566722145019, 4883, 1566722145236, 5100, 217, true
1679, 1566722145021, 4885, 1566722145236, 5100, 215, true
1680, 1566722145023, 4887, 1566722145241, 5105, 218, true
1681, 1566722145024, 4888, 1566722145240, 5104, 216, true
1682, 1566722145027, 4891, 1566722145240, 5104, 213, true
1683, 1566722145033, 4897, 1566722145243, 5107, 210, true
1684, 1566722145034, 4898, 1566722145252, 5116, 218, true
1685, 1566722145036, 4900, 1566722145252, 5116, 216, true
1686, 1566722145038, 4902, 1566722145258, 5122, 220, true
1687, 1566722145047, 4911, 1566722145267, 5131, 220, true
1688, 1566722145048, 4912, 1566722145267, 5131, 219, true
1689, 1566722145048, 4912, 1566722145266, 5130, 218, true
1690, 1566722145049, 4913, 1566722145267, 5131, 218, true
1691, 1566722145052, 4916, 1566722145267, 5131, 215, true
1692, 1566722145057, 4921, 1566722145267, 5131, 210, true
1693, 1566722145058, 4922, 1566722145292, 5156, 234, true
1694, 1566722145061, 4925, 1566722145292, 5156, 231, true
1695, 1566722145064, 4928, 1566722145292, 5156, 228, true
1696, 1566722145070, 4934, 1566722145292, 5156, 222, true
1697, 1566722145084, 4948, 1566722145295, 5159, 211, true
1698, 1566722145087, 4951, 1566722145306, 5170, 219, true
1699, 1566722145094, 4958, 1566722145325, 5189, 231, true
1700, 1566722145103, 4967, 1566722145326, 5190, 223, true
1701, 1566722145104, 4968, 1566722145326, 5190, 222, true
1702, 1566722145104, 4968, 1566722145326, 5190, 222, true
1703, 1566722145105, 4969, 1566722145326, 5190, 221, true
1704, 1566722145117, 4981, 1566722145339, 5203, 222, true
1705, 1566722145119, 4983, 1566722145340, 5204, 221, true
1706, 1566722145119, 4983, 1566722145344, 5208, 225, true
1707, 1566722145124, 4988, 1566722145343, 5207, 219, true
1708, 1566722145128, 4992, 1566722145356, 5220, 228, true
1709, 1566722145136, 5000, 1566722145356, 5220, 220, true
1710, 1566722145139, 5003, 1566722145356, 5220, 217, true
1711, 1566722145142, 5006, 1566722145356, 5220, 214, true
1712, 1566722145145, 5009, 1566722145358, 5222, 213, true
1713, 1566722145149, 5013, 1566722145358, 5222, 209, true
1714, 1566722145153, 5017, 1566722145359, 5223, 206, true
1715, 1566722145156, 5020, 1566722145474, 5338, 318, true
1716, 1566722145157, 5021, 1566722145435, 5299, 278, true
1717, 1566722145221, 5085, 1566722145439, 5303, 218, true
1718, 1566722145222, 5086, 1566722145451, 5315, 229, true
1719, 1566722145223, 5087, 1566722145439, 5303, 216, true
1720, 1566722145226, 5090, 1566722145450, 5314, 224, true
1721, 1566722145228, 5092, 1566722145446, 5310, 218, true
1722, 1566722145229, 5093, 1566722145474, 5338, 245, true
1723, 1566722145246, 5110, 1566722145473, 5337, 227, true
1724, 1566722145246, 5110, 1566722145475, 5339, 229, true
1725, 1566722145247, 5111, 1566722145472, 5336, 225, true
1726, 1566722145248, 5112, 1566722145473, 5337, 225, true
1727, 1566722145249, 5113, 1566722145476, 5340, 227, true
1728, 1566722145253, 5117, 1566722145475, 5339, 222, true
1729, 1566722145255, 5119, 1566722145476, 5340, 221, true
1730, 1566722145260, 5124, 1566722145477, 5341, 217, true
1731, 1566722145261, 5125, 1566722145480, 5344, 219, true
1732, 1566722145261, 5125, 1566722145480, 5344, 219, true
1733, 1566722145262, 5126, 1566722145479, 5343, 217, true
1734, 1566722145269, 5133, 1566722145488, 5352, 219, true
1735, 1566722145272, 5136, 1566722145488, 5352, 216, true
1736, 1566722145274, 5138, 1566722145490, 5354, 216, true
1737, 1566722145276, 5140, 1566722145501, 5365, 225, true
1738, 1566722145277, 5141, 1566722145489, 5353, 212, true
1739, 1566722145278, 5142, 1566722145508, 5372, 230, true
1740, 1566722145280, 5144, 1566722145511, 5375, 231, true
1741, 1566722145295, 5159, 1566722145515, 5379, 220, true
1742, 1566722145307, 5171, 1566722145514, 5378, 207, true
1743, 1566722145310, 5174, 1566722145525, 5389, 215, true
1744, 1566722145312, 5176, 1566722145548, 5412, 236, true
1745, 1566722145328, 5192, 1566722145565, 5429, 237, true
1746, 1566722145330, 5194, 1566722145569, 5433, 239, true
1747, 1566722145334, 5198, 1566722145572, 5436, 238, true
1748, 1566722145343, 5207, 1566722145572, 5436, 229, true
1749, 1566722145359, 5223, 1566722145572, 5436, 213, true
1750, 1566722145363, 5227, 1566722145572, 5436, 209, true
1751, 1566722145364, 5228, 1566722145572, 5436, 208, true
1752, 1566722145369, 5233, 1566722145584, 5448, 215, true
1753, 1566722145370, 5234, 1566722145582, 5446, 212, true
1754, 1566722145371, 5235, 1566722145583, 5447, 212, true
1755, 1566722145372, 5236, 1566722145583, 5447, 211, true
1756, 1566722145374, 5238, 1566722145597, 5461, 223, true
1757, 1566722145375, 5239, 1566722145588, 5452, 213, true
1758, 1566722145376, 5240, 1566722145597, 5461, 221, true
1759, 1566722145376, 5240, 1566722145597, 5461, 221, true
1760, 1566722145380, 5244, 1566722145596, 5460, 216, true
1761, 1566722145380, 5244, 1566722145597, 5461, 217, true
1762, 1566722145383, 5247, 1566722145597, 5461, 214, true
1763, 1566722145387, 5251, 1566722145596, 5460, 209, true
1764, 1566722145388, 5252, 1566722145601, 5465, 213, true
1765, 1566722145389, 5253, 1566722145596, 5460, 207, true
1766, 1566722145390, 5254, 1566722145601, 5465, 211, true
1767, 1566722145391, 5255, 1566722145601, 5465, 210, true
1768, 1566722145393, 5257, 1566722145601, 5465, 208, true
1769, 1566722145395, 5259, 1566722145601, 5465, 206, true
1770, 1566722145396, 5260, 1566722145602, 5466, 206, true
1771, 1566722145396, 5260, 1566722145602, 5466, 206, true
1772, 1566722145400, 5264, 1566722145610, 5474, 210, true
1773, 1566722145401, 5265, 1566722145606, 5470, 205, true
1774, 1566722145405, 5269, 1566722145610, 5474, 205, true
1775, 1566722145408, 5272, 1566722145616, 5480, 208, true
1776, 1566722145409, 5273, 1566722145616, 5480, 207, true
1777, 1566722145410, 5274, 1566722145617, 5481, 207, true
1778, 1566722145412, 5276, 1566722145621, 5485, 209, true
1779, 1566722145413, 5277, 1566722145618, 5482, 205, true
1780, 1566722145416, 5280, 1566722145623, 5487, 207, true
1781, 1566722145417, 5281, 1566722145639, 5503, 222, true
1782, 1566722145418, 5282, 1566722145630, 5494, 212, true
1783, 1566722145419, 5283, 1566722145718, 5582, 299, true
1784, 1566722145420, 5284, 1566722145721, 5585, 301, true
1785, 1566722145420, 5284, 1566722145706, 5570, 286, true
1786, 1566722145421, 5285, 1566722145715, 5579, 294, true
1787, 1566722145421, 5285, 1566722145712, 5576, 291, true
1788, 1566722145422, 5286, 1566722145658, 5522, 236, true
1789, 1566722145423, 5287, 1566722145684, 5548, 261, true
1790, 1566722145424, 5288, 1566722145722, 5586, 298, true
1791, 1566722145425, 5289, 1566722145709, 5573, 284, true
1792, 1566722145425, 5289, 1566722145718, 5582, 293, true
1793, 1566722145426, 5290, 1566722145697, 5561, 271, true
1794, 1566722145426, 5290, 1566722145723, 5587, 297, true
1795, 1566722145427, 5291, 1566722145728, 5592, 301, true
1796, 1566722145428, 5292, 1566722145658, 5522, 230, true
1797, 1566722145430, 5294, 1566722145722, 5586, 292, true
1798, 1566722145431, 5295, 1566722145728, 5592, 297, true
1799, 1566722145433, 5297, 1566722145722, 5586, 289, true
1800, 1566722145434, 5298, 1566722145721, 5585, 287, true
1801, 1566722145436, 5300, 1566722145728, 5592, 292, true
1802, 1566722145436, 5300, 1566722145789, 5653, 353, true
1803, 1566722145437, 5301, 1566722145728, 5592, 291, true
1804, 1566722145439, 5303, 1566722145733, 5597, 294, true
1805, 1566722145439, 5303, 1566722145737, 5601, 298, true
1806, 1566722145440, 5304, 1566722145788, 5652, 348, true
1807, 1566722145440, 5304, 1566722145763, 5627, 323, true
1808, 1566722145440, 5304, 1566722145772, 5636, 332, true
1809, 1566722145441, 5305, 1566722145787, 5651, 346, true
1810, 1566722145441, 5305, 1566722145806, 5670, 365, true
1811, 1566722145442, 5306, 1566722145745, 5609, 303, true
1812, 1566722145443, 5307, 1566722145756, 5620, 313, true
1813, 1566722145443, 5307, 1566722145789, 5653, 346, true
1814, 1566722145443, 5307, 1566722145758, 5622, 315, true
1815, 1566722145445, 5309, 1566722145760, 5624, 315, true
1816, 1566722145447, 5311, 1566722145756, 5620, 309, true
1817, 1566722145447, 5311, 1566722145807, 5671, 360, true
1818, 1566722145448, 5312, 1566722145806, 5670, 358, true
1819, 1566722145449, 5313, 1566722145756, 5620, 307, true
1820, 1566722145449, 5313, 1566722145756, 5620, 307, true
1821, 1566722145451, 5315, 1566722145789, 5653, 338, true
1822, 1566722145452, 5316, 1566722145773, 5637, 321, true
1823, 1566722145452, 5316, 1566722145738, 5602, 286, true
1824, 1566722145452, 5316, 1566722145738, 5602, 286, true
1825, 1566722145453, 5317, 1566722145788, 5652, 335, true
1826, 1566722145454, 5318, 1566722145759, 5623, 305, true
1827, 1566722145455, 5319, 1566722145728, 5592, 273, true
1828, 1566722145455, 5319, 1566722145765, 5629, 310, true
1829, 1566722145455, 5319, 1566722145748, 5612, 293, true
1830, 1566722145456, 5320, 1566722145745, 5609, 289, true
1831, 1566722145456, 5320, 1566722145803, 5667, 347, true
1832, 1566722145457, 5321, 1566722145728, 5592, 271, true
1833, 1566722145457, 5321, 1566722145763, 5627, 306, true
1834, 1566722145458, 5322, 1566722145760, 5624, 302, true
1835, 1566722145458, 5322, 1566722145738, 5602, 280, true
1836, 1566722145459, 5323, 1566722145728, 5592, 269, true
1837, 1566722145460, 5324, 1566722145803, 5667, 343, true
1838, 1566722145460, 5324, 1566722145737, 5601, 277, true
1839, 1566722145461, 5325, 1566722145789, 5653, 328, true
1840, 1566722145462, 5326, 1566722145789, 5653, 327, true
1841, 1566722145462, 5326, 1566722145728, 5592, 266, true
1842, 1566722145464, 5328, 1566722145807, 5671, 343, true
1843, 1566722145464, 5328, 1566722145744, 5608, 280, true
1844, 1566722145465, 5329, 1566722145756, 5620, 291, true
1845, 1566722145465, 5329, 1566722145789, 5653, 324, true
1846, 1566722145466, 5330, 1566722145789, 5653, 323, true
1847, 1566722145466, 5330, 1566722145804, 5668, 338, true
1848, 1566722145466, 5330, 1566722145763, 5627, 297, true
1849, 1566722145467, 5331, 1566722145738, 5602, 271, true
1850, 1566722145468, 5332, 1566722145743, 5607, 275, true
1851, 1566722145469, 5333, 1566722145758, 5622, 289, true
1852, 1566722145470, 5334, 1566722145741, 5605, 271, true
1853, 1566722145471, 5335, 1566722145788, 5652, 317, true
1854, 1566722145473, 5337, 1566722145732, 5596, 259, true
1855, 1566722145474, 5338, 1566722145724, 5588, 250, true
1856, 1566722145475, 5339, 1566722145737, 5601, 262, true
1857, 1566722145477, 5341, 1566722145744, 5608, 267, true
1858, 1566722145478, 5342, 1566722145788, 5652, 310, true
1859, 1566722145479, 5343, 1566722145732, 5596, 253, true
1860, 1566722145480, 5344, 1566722145788, 5652, 308, true
1861, 1566722145481, 5345, 1566722145802, 5666, 321, true
1862, 1566722145482, 5346, 1566722145737, 5601, 255, true
1863, 1566722145482, 5346, 1566722145768, 5632, 286, true
1864, 1566722145482, 5346, 1566722145728, 5592, 246, true
1865, 1566722145482, 5346, 1566722145762, 5626, 280, true
1866, 1566722145483, 5347, 1566722145729, 5593, 246, true
1867, 1566722145484, 5348, 1566722145739, 5603, 255, true
1868, 1566722145485, 5349, 1566722145748, 5612, 263, true
1869, 1566722145486, 5350, 1566722145741, 5605, 255, true
1870, 1566722145487, 5351, 1566722145764, 5628, 277, true
1871, 1566722145489, 5353, 1566722145760, 5624, 271, true
1872, 1566722145490, 5354, 1566722145743, 5607, 253, true
1873, 1566722145491, 5355, 1566722145788, 5652, 297, true
1874, 1566722145491, 5355, 1566722145728, 5592, 237, true
1875, 1566722145492, 5356, 1566722145760, 5624, 268, true
1876, 1566722145493, 5357, 1566722145738, 5602, 245, true
1877, 1566722145493, 5357, 1566722145732, 5596, 239, true
1878, 1566722145493, 5357, 1566722145737, 5601, 244, true
1879, 1566722145494, 5358, 1566722145729, 5593, 235, true
1880, 1566722145495, 5359, 1566722145802, 5666, 307, true
1881, 1566722145495, 5359, 1566722145802, 5666, 307, true
1882, 1566722145496, 5360, 1566722145763, 5627, 267, true
1883, 1566722145497, 5361, 1566722145763, 5627, 266, true
1884, 1566722145498, 5362, 1566722145758, 5622, 260, true
1885, 1566722145500, 5364, 1566722145732, 5596, 232, true
1886, 1566722145501, 5365, 1566722145743, 5607, 242, true
1887, 1566722145501, 5365, 1566722145768, 5632, 267, true
1888, 1566722145502, 5366, 1566722145765, 5629, 263, true
1889, 1566722145503, 5367, 1566722145756, 5620, 253, true
1890, 1566722145503, 5367, 1566722145733, 5597, 230, true
1891, 1566722145503, 5367, 1566722145803, 5667, 300, true
1892, 1566722145504, 5368, 1566722145729, 5593, 225, true
1893, 1566722145504, 5368, 1566722145724, 5588, 220, true
1894, 1566722145505, 5369, 1566722145737, 5601, 232, true
1895, 1566722145505, 5369, 1566722145803, 5667, 298, true
1896, 1566722145509, 5373, 1566722145803, 5667, 294, true
1897, 1566722145589, 5453, 1566722145814, 5678, 225, true
1898, 1566722145590, 5454, 1566722145807, 5671, 217, true
1899, 1566722145591, 5455, 1566722145814, 5678, 223, true
1900, 1566722145591, 5455, 1566722145814, 5678, 223, true
1901, 1566722145592, 5456, 1566722145814, 5678, 222, true
1902, 1566722145592, 5456, 1566722145814, 5678, 222, true
1903, 1566722145608, 5472, 1566722145816, 5680, 208, true
1904, 1566722145612, 5476, 1566722145820, 5684, 208, true
1905, 1566722145614, 5478, 1566722145825, 5689, 211, true
1906, 1566722145624, 5488, 1566722145831, 5695, 207, true
1907, 1566722145626, 5490, 1566722145846, 5710, 220, true
1908, 1566722145627, 5491, 1566722145840, 5704, 213, true
1909, 1566722145628, 5492, 1566722145844, 5708, 216, true
1910, 1566722145633, 5497, 1566722145844, 5708, 211, true
1911, 1566722145635, 5499, 1566722145840, 5704, 205, true
1912, 1566722145637, 5501, 1566722145844, 5708, 207, true
1913, 1566722145640, 5504, 1566722145844, 5708, 204, true
1914, 1566722145643, 5507, 1566722145852, 5716, 209, true
1915, 1566722145647, 5511, 1566722145866, 5730, 219, true
1916, 1566722145648, 5512, 1566722145858, 5722, 210, true
1917, 1566722145650, 5514, 1566722145861, 5725, 211, true
1918, 1566722145650, 5514, 1566722145861, 5725, 211, true
1919, 1566722145651, 5515, 1566722145863, 5727, 212, true
1920, 1566722145655, 5519, 1566722145861, 5725, 206, true
1921, 1566722145660, 5524, 1566722145872, 5736, 212, true
1922, 1566722145662, 5526, 1566722145866, 5730, 204, true
1923, 1566722145664, 5528, 1566722145872, 5736, 208, true
1924, 1566722145665, 5529, 1566722145872, 5736, 207, true
1925, 1566722145669, 5533, 1566722145876, 5740, 207, true
1926, 1566722145672, 5536, 1566722145892, 5756, 220, true
1927, 1566722145673, 5537, 1566722145901, 5765, 228, true
1928, 1566722145677, 5541, 1566722145899, 5763, 222, true
1929, 1566722145681, 5545, 1566722145904, 5768, 223, true
1930, 1566722145685, 5549, 1566722145904, 5768, 219, true
1931, 1566722145687, 5551, 1566722145904, 5768, 217, true
1932, 1566722145690, 5554, 1566722145904, 5768, 214, true
1933, 1566722145692, 5556, 1566722145902, 5766, 210, true
1934, 1566722145695, 5559, 1566722145904, 5768, 209, true
1935, 1566722145698, 5562, 1566722145904, 5768, 206, true
1936, 1566722145700, 5564, 1566722145908, 5772, 208, true
1937, 1566722145702, 5566, 1566722145913, 5777, 211, true
1938, 1566722145704, 5568, 1566722145915, 5779, 211, true
1939, 1566722145709, 5573, 1566722145915, 5779, 206, true
1940, 1566722145711, 5575, 1566722145915, 5779, 204, true
1941, 1566722145713, 5577, 1566722145920, 5784, 207, true
1942, 1566722145716, 5580, 1566722145920, 5784, 204, true
1943, 1566722145719, 5583, 1566722145925, 5789, 206, true
1944, 1566722145774, 5638, 1566722145980, 5844, 206, true
1945, 1566722145807, 5671, 1566722146019, 5883, 212, true
1946, 1566722145816, 5680, 1566722146033, 5897, 217, true
1947, 1566722145816, 5680, 1566722146033, 5897, 217, true
1948, 1566722145816, 5680, 1566722146034, 5898, 218, true
1949, 1566722145817, 5681, 1566722146036, 5900, 219, true
1950, 1566722145817, 5681, 1566722146055, 5919, 238, true
1951, 1566722145820, 5684, 1566722146040, 5904, 220, true
1952, 1566722145820, 5684, 1566722146059, 5923, 239, true
1953, 1566722145821, 5685, 1566722146072, 5936, 251, true
1954, 1566722145821, 5685, 1566722146055, 5919, 234, true
1955, 1566722145822, 5686, 1566722146055, 5919, 233, true
1956, 1566722145822, 5686, 1566722146076, 5940, 254, true
1957, 1566722145822, 5686, 1566722146055, 5919, 233, true
1958, 1566722145822, 5686, 1566722146073, 5937, 251, true
1959, 1566722145823, 5687, 1566722146078, 5942, 255, true
1960, 1566722145823, 5687, 1566722146064, 5928, 241, true
1961, 1566722145824, 5688, 1566722146073, 5937, 249, true
1962, 1566722145825, 5689, 1566722146055, 5919, 230, true
1963, 1566722145826, 5690, 1566722146040, 5904, 214, true
1964, 1566722145827, 5691, 1566722146055, 5919, 228, true
1965, 1566722145828, 5692, 1566722146055, 5919, 227, true
1966, 1566722145829, 5693, 1566722146054, 5918, 225, true
1967, 1566722145829, 5693, 1566722146055, 5919, 226, true
1968, 1566722145830, 5694, 1566722146055, 5919, 225, true
1969, 1566722145831, 5695, 1566722146086, 5950, 255, true
1970, 1566722145831, 5695, 1566722146093, 5957, 262, true
1971, 1566722145832, 5696, 1566722146093, 5957, 261, true
1972, 1566722145832, 5696, 1566722146094, 5958, 262, true
1973, 1566722145833, 5697, 1566722146086, 5950, 253, true
1974, 1566722145834, 5698, 1566722146106, 5970, 272, true
1975, 1566722145837, 5701, 1566722146107, 5971, 270, true
1976, 1566722145838, 5702, 1566722146094, 5958, 256, true
1977, 1566722145841, 5705, 1566722146094, 5958, 253, true
1978, 1566722145846, 5710, 1566722146111, 5975, 265, true
1979, 1566722145847, 5711, 1566722146111, 5975, 264, true
1980, 1566722145848, 5712, 1566722146096, 5960, 248, true
1981, 1566722145848, 5712, 1566722146094, 5958, 246, true
1982, 1566722145848, 5712, 1566722146102, 5966, 254, true
1983, 1566722145849, 5713, 1566722146093, 5957, 244, true
1984, 1566722145849, 5713, 1566722146094, 5958, 245, true
1985, 1566722145850, 5714, 1566722146111, 5975, 261, true
1986, 1566722145853, 5717, 1566722146111, 5975, 258, true
1987, 1566722145854, 5718, 1566722146112, 5976, 258, true
1988, 1566722145854, 5718, 1566722146093, 5957, 239, true
1989, 1566722145855, 5719, 1566722146107, 5971, 252, true
1990, 1566722145856, 5720, 1566722146106, 5970, 250, true
1991, 1566722145857, 5721, 1566722146110, 5974, 253, true
1992, 1566722145859, 5723, 1566722146094, 5958, 235, true
1993, 1566722145861, 5725, 1566722146111, 5975, 250, true
1994, 1566722145862, 5726, 1566722146111, 5975, 249, true
1995, 1566722145862, 5726, 1566722146110, 5974, 248, true
1996, 1566722145863, 5727, 1566722146094, 5958, 231, true
1997, 1566722145864, 5728, 1566722146106, 5970, 242, true
1998, 1566722145864, 5728, 1566722146102, 5966, 238, true
1999, 1566722145865, 5729, 1566722146111, 5975, 246, true
2000, 1566722145867, 5731, 1566722146093, 5957, 226, true
2001, 1566722145869, 5733, 1566722146110, 5974, 241, true
2002, 1566722145869, 5733, 1566722146107, 5971, 238, true
2003, 1566722145869, 5733, 1566722146102, 5966, 233, true
2004, 1566722145871, 5735, 1566722146106, 5970, 235, true
2005, 1566722145872, 5736, 1566722146089, 5953, 217, true
2006, 1566722145873, 5737, 1566722146112, 5976, 239, true
2007, 1566722145874, 5738, 1566722146096, 5960, 222, true
2008, 1566722145874, 5738, 1566722146107, 5971, 233, true
2009, 1566722145876, 5740, 1566722146096, 5960, 220, true
2010, 1566722145877, 5741, 1566722146114, 5978, 237, true
2011, 1566722145878, 5742, 1566722146115, 5979, 237, true
2012, 1566722145879, 5743, 1566722146119, 5983, 240, true
2013, 1566722145879, 5743, 1566722146112, 5976, 233, true
2014, 1566722145880, 5744, 1566722146116, 5980, 236, true
2015, 1566722145881, 5745, 1566722146116, 5980, 235, true
2016, 1566722145883, 5747, 1566722146114, 5978, 231, true
2017, 1566722145885, 5749, 1566722146116, 5980, 231, true
2018, 1566722145887, 5751, 1566722146124, 5988, 237, true
2019, 1566722145889, 5753, 1566722146112, 5976, 223, true
2020, 1566722145890, 5754, 1566722146114, 5978, 224, true
2021, 1566722145891, 5755, 1566722146124, 5988, 233, true
2022, 1566722145893, 5757, 1566722146116, 5980, 223, true
2023, 1566722145894, 5758, 1566722146119, 5983, 225, true
2024, 1566722145899, 5763, 1566722146114, 5978, 215, true
2025, 1566722145921, 5785, 1566722146128, 5992, 207, true
2026, 1566722145922, 5786, 1566722146138, 6002, 216, true
2027, 1566722145923, 5787, 1566722146139, 6003, 216, true
2028, 1566722145926, 5790, 1566722146139, 6003, 213, true
2029, 1566722145927, 5791, 1566722146138, 6002, 211, true
2030, 1566722145929, 5793, 1566722146139, 6003, 210, true
2031, 1566722145930, 5794, 1566722146139, 6003, 209, true
2032, 1566722145932, 5796, 1566722146142, 6006, 210, true
2033, 1566722145934, 5798, 1566722146142, 6006, 208, true
2034, 1566722145936, 5800, 1566722146149, 6013, 213, true
2035, 1566722145938, 5802, 1566722146153, 6017, 215, true
2036, 1566722145940, 5804, 1566722146162, 6026, 222, true
2037, 1566722145944, 5808, 1566722146153, 6017, 209, true
2038, 1566722145946, 5810, 1566722146153, 6017, 207, true
2039, 1566722145948, 5812, 1566722146162, 6026, 214, true
2040, 1566722145950, 5814, 1566722146162, 6026, 212, true
2041, 1566722145952, 5816, 1566722146162, 6026, 210, true
2042, 1566722145954, 5818, 1566722146162, 6026, 208, true
2043, 1566722145956, 5820, 1566722146169, 6033, 213, true
2044, 1566722145959, 5823, 1566722146169, 6033, 210, true
2045, 1566722145961, 5825, 1566722146168, 6032, 207, true
2046, 1566722145963, 5827, 1566722146175, 6039, 212, true
2047, 1566722145966, 5830, 1566722146175, 6039, 209, true
2048, 1566722145967, 5831, 1566722146176, 6040, 209, true
2049, 1566722145969, 5833, 1566722146178, 6042, 209, true
2050, 1566722145971, 5835, 1566722146181, 6045, 210, true
2051, 1566722145973, 5837, 1566722146181, 6045, 208, true
2052, 1566722145976, 5840, 1566722146184, 6048, 208, true
2053, 1566722145977, 5841, 1566722146184, 6048, 207, true
2054, 1566722145980, 5844, 1566722146193, 6057, 213, true
2055, 1566722145981, 5845, 1566722146193, 6057, 212, true
2056, 1566722145983, 5847, 1566722146200, 6064, 217, true
2057, 1566722145984, 5848, 1566722146193, 6057, 209, true
2058, 1566722145987, 5851, 1566722146200, 6064, 213, true
2059, 1566722145991, 5855, 1566722146200, 6064, 209, true
2060, 1566722145993, 5857, 1566722146200, 6064, 207, true
2061, 1566722145995, 5859, 1566722146207, 6071, 212, true
2062, 1566722145999, 5863, 1566722146271, 6135, 272, true
2063, 1566722146001, 5865, 1566722146223, 6087, 222, true
2064, 1566722146003, 5867, 1566722146223, 6087, 220, true
2065, 1566722146005, 5869, 1566722146271, 6135, 266, true
2066, 1566722146008, 5872, 1566722146223, 6087, 215, true
2067, 1566722146011, 5875, 1566722146223, 6087, 212, true
2068, 1566722146014, 5878, 1566722146224, 6088, 210, true
2069, 1566722146015, 5879, 1566722146235, 6099, 220, true
2070, 1566722146019, 5883, 1566722146235, 6099, 216, true
2071, 1566722146020, 5884, 1566722146235, 6099, 215, true
2072, 1566722146023, 5887, 1566722146235, 6099, 212, true
2073, 1566722146023, 5887, 1566722146235, 6099, 212, true
2074, 1566722146024, 5888, 1566722146235, 6099, 211, true
2075, 1566722146088, 5952, 1566722146339, 6203, 251, true
2076, 1566722146097, 5961, 1566722146353, 6217, 256, true
2077, 1566722146098, 5962, 1566722146353, 6217, 255, true
2078, 1566722146099, 5963, 1566722146353, 6217, 254, true
2079, 1566722146099, 5963, 1566722146353, 6217, 254, true
2080, 1566722146100, 5964, 1566722146353, 6217, 253, true
2081, 1566722146102, 5966, 1566722146361, 6225, 259, true
2082, 1566722146129, 5993, 1566722146366, 6230, 237, true
2083, 1566722146129, 5993, 1566722146369, 6233, 240, true
2084, 1566722146130, 5994, 1566722146366, 6230, 236, true
2085, 1566722146130, 5994, 1566722146366, 6230, 236, true
2086, 1566722146131, 5995, 1566722146361, 6225, 230, true
2087, 1566722146131, 5995, 1566722146368, 6232, 237, true
2088, 1566722146132, 5996, 1566722146367, 6231, 235, true
2089, 1566722146132, 5996, 1566722146366, 6230, 234, true
2090, 1566722146133, 5997, 1566722146368, 6232, 235, true
2091, 1566722146134, 5998, 1566722146366, 6230, 232, true
2092, 1566722146135, 5999, 1566722146366, 6230, 231, true
2093, 1566722146139, 6003, 1566722146361, 6225, 222, true
2094, 1566722146150, 6014, 1566722146368, 6232, 218, true
2095, 1566722146151, 6015, 1566722146369, 6233, 218, true
2096, 1566722146163, 6027, 1566722146372, 6236, 209, true
2097, 1566722146164, 6028, 1566722146372, 6236, 208, true
2098, 1566722146164, 6028, 1566722146372, 6236, 208, true
2099, 1566722146165, 6029, 1566722146372, 6236, 207, true
2100, 1566722146166, 6030, 1566722146372, 6236, 206, true
2101, 1566722146166, 6030, 1566722146372, 6236, 206, true
2102, 1566722146169, 6033, 1566722146378, 6242, 209, true
2103, 1566722146170, 6034, 1566722146390, 6254, 220, true
2104, 1566722146170, 6034, 1566722146378, 6242, 208, true
2105, 1566722146172, 6036, 1566722146378, 6242, 206, true
2106, 1566722146172, 6036, 1566722146391, 6255, 219, true
2107, 1566722146174, 6038, 1566722146392, 6256, 218, true
2108, 1566722146177, 6041, 1566722146392, 6256, 215, true
2109, 1566722146185, 6049, 1566722146392, 6256, 207, true
2110, 1566722146187, 6051, 1566722146392, 6256, 205, true
2111, 1566722146192, 6056, 1566722146401, 6265, 209, true
2112, 1566722146202, 6066, 1566722146411, 6275, 209, true
2113, 1566722146204, 6068, 1566722146416, 6280, 212, true
2114, 1566722146270, 6134, 1566722146477, 6341, 207, true
2115, 1566722146224, 6088, 1566722146428, 6292, 204, true
2116, 1566722146225, 6089, 1566722146428, 6292, 203, true
2117, 1566722146226, 6090, 1566722146439, 6303, 213, true
2118, 1566722146235, 6099, 1566722146447, 6311, 212, true
2119, 1566722146237, 6101, 1566722146447, 6311, 210, true
2120, 1566722146238, 6102, 1566722146447, 6311, 209, true
2121, 1566722146238, 6102, 1566722146447, 6311, 209, true
2122, 1566722146239, 6103, 1566722146447, 6311, 208, true
2123, 1566722146240, 6104, 1566722146453, 6317, 213, true
2124, 1566722146241, 6105, 1566722146453, 6317, 212, true
2125, 1566722146241, 6105, 1566722146453, 6317, 212, true
2126, 1566722146242, 6106, 1566722146505, 6369, 263, true
2127, 1566722146242, 6106, 1566722146453, 6317, 211, true
2128, 1566722146242, 6106, 1566722146453, 6317, 211, true
2129, 1566722146243, 6107, 1566722146453, 6317, 210, true
2130, 1566722146243, 6107, 1566722146453, 6317, 210, true
2131, 1566722146244, 6108, 1566722146502, 6366, 258, true
2132, 1566722146244, 6108, 1566722146453, 6317, 209, true
2133, 1566722146249, 6113, 1566722146454, 6318, 205, true
2134, 1566722146249, 6113, 1566722146454, 6318, 205, true
2135, 1566722146251, 6115, 1566722146462, 6326, 211, true
2136, 1566722146251, 6115, 1566722146458, 6322, 207, true
2137, 1566722146252, 6116, 1566722146462, 6326, 210, true
2138, 1566722146252, 6116, 1566722146469, 6333, 217, true
2139, 1566722146253, 6117, 1566722146459, 6323, 206, true
2140, 1566722146254, 6118, 1566722146463, 6327, 209, true
2141, 1566722146257, 6121, 1566722146471, 6335, 214, true
2142, 1566722146258, 6122, 1566722146469, 6333, 211, true
2143, 1566722146259, 6123, 1566722146470, 6334, 211, true
2144, 1566722146263, 6127, 1566722146472, 6336, 209, true
2145, 1566722146263, 6127, 1566722146471, 6335, 208, true
2146, 1566722146264, 6128, 1566722146484, 6348, 220, true
2147, 1566722146264, 6128, 1566722146479, 6343, 215, true
2148, 1566722146264, 6128, 1566722146491, 6355, 227, true
2149, 1566722146265, 6129, 1566722146505, 6369, 240, true
2150, 1566722146265, 6129, 1566722146496, 6360, 231, true
2151, 1566722146265, 6129, 1566722146496, 6360, 231, true
2152, 1566722146265, 6129, 1566722146503, 6367, 238, true
2153, 1566722146265, 6129, 1566722146503, 6367, 238, true
2154, 1566722146265, 6129, 1566722146503, 6367, 238, true
2155, 1566722146266, 6130, 1566722146503, 6367, 237, true
2156, 1566722146266, 6130, 1566722146502, 6366, 236, true
2157, 1566722146266, 6130, 1566722146492, 6356, 226, true
2158, 1566722146266, 6130, 1566722146503, 6367, 237, true
2159, 1566722146266, 6130, 1566722146503, 6367, 237, true
2160, 1566722146266, 6130, 1566722146502, 6366, 236, true
2161, 1566722146266, 6130, 1566722146493, 6357, 227, true
2162, 1566722146267, 6131, 1566722146505, 6369, 238, true
2163, 1566722146267, 6131, 1566722146505, 6369, 238, true
2164, 1566722146267, 6131, 1566722146487, 6351, 220, true
2165, 1566722146268, 6132, 1566722146504, 6368, 236, true
2166, 1566722146268, 6132, 1566722146502, 6366, 234, true
2167, 1566722146269, 6133, 1566722146505, 6369, 236, true
2168, 1566722146270, 6134, 1566722146482, 6346, 212, true
2169, 1566722146280, 6144, 1566722146505, 6369, 225, true
2170, 1566722146280, 6144, 1566722146495, 6359, 215, true
2171, 1566722146290, 6154, 1566722146506, 6370, 216, true
2172, 1566722146291, 6155, 1566722146505, 6369, 214, true
2173, 1566722146292, 6156, 1566722146505, 6369, 213, true
2174, 1566722146294, 6158, 1566722146506, 6370, 212, true
2175, 1566722146295, 6159, 1566722146506, 6370, 211, true
2176, 1566722146298, 6162, 1566722146506, 6370, 208, true
2177, 1566722146299, 6163, 1566722146506, 6370, 207, true
2178, 1566722146300, 6164, 1566722146514, 6378, 214, true
2179, 1566722146302, 6166, 1566722146514, 6378, 212, true
2180, 1566722146303, 6167, 1566722146514, 6378, 211, true
2181, 1566722146304, 6168, 1566722146517, 6381, 213, true
2182, 1566722146305, 6169, 1566722146524, 6388, 219, true
2183, 1566722146306, 6170, 1566722146524, 6388, 218, true
2184, 1566722146306, 6170, 1566722146525, 6389, 219, true
2185, 1566722146308, 6172, 1566722146524, 6388, 216, true
2186, 1566722146312, 6176, 1566722146525, 6389, 213, true
2187, 1566722146313, 6177, 1566722146517, 6381, 204, true
2188, 1566722146313, 6177, 1566722146525, 6389, 212, true
2189, 1566722146314, 6178, 1566722146525, 6389, 211, true
2190, 1566722146315, 6179, 1566722146525, 6389, 210, true
2191, 1566722146316, 6180, 1566722146525, 6389, 209, true
2192, 1566722146319, 6183, 1566722146537, 6401, 218, true
2193, 1566722146321, 6185, 1566722146537, 6401, 216, true
2194, 1566722146321, 6185, 1566722146537, 6401, 216, true
2195, 1566722146322, 6186, 1566722146537, 6401, 215, true
2196, 1566722146322, 6186, 1566722146538, 6402, 216, true
2197, 1566722146324, 6188, 1566722146537, 6401, 213, true
2198, 1566722146325, 6189, 1566722146537, 6401, 212, true
2199, 1566722146326, 6190, 1566722146537, 6401, 211, true
2200, 1566722146327, 6191, 1566722146539, 6403, 212, true
2201, 1566722146328, 6192, 1566722146549, 6413, 221, true
2202, 1566722146329, 6193, 1566722146538, 6402, 209, true
2203, 1566722146331, 6195, 1566722146559, 6423, 228, true
2204, 1566722146333, 6197, 1566722146559, 6423, 226, true
2205, 1566722146350, 6214, 1566722146566, 6430, 216, true
2206, 1566722146354, 6218, 1566722146566, 6430, 212, true
2207, 1566722146354, 6218, 1566722146580, 6444, 226, true
2208, 1566722146355, 6219, 1566722146566, 6430, 211, true
2209, 1566722146356, 6220, 1566722146611, 6475, 255, true
2210, 1566722146356, 6220, 1566722146611, 6475, 255, true
2211, 1566722146357, 6221, 1566722146611, 6475, 254, true
2212, 1566722146379, 6243, 1566722146619, 6483, 240, true
2213, 1566722146380, 6244, 1566722146619, 6483, 239, true
2214, 1566722146408, 6272, 1566722146619, 6483, 211, true
2215, 1566722146421, 6285, 1566722146632, 6496, 211, true
2216, 1566722146422, 6286, 1566722146632, 6496, 210, true
2217, 1566722146424, 6288, 1566722146630, 6494, 206, true
2218, 1566722146426, 6290, 1566722146632, 6496, 206, true
2219, 1566722146428, 6292, 1566722146639, 6503, 211, true
2220, 1566722146430, 6294, 1566722146641, 6505, 211, true
2221, 1566722146432, 6296, 1566722146639, 6503, 207, true
2222, 1566722146434, 6298, 1566722146641, 6505, 207, true
2223, 1566722146434, 6298, 1566722146641, 6505, 207, true
2224, 1566722146435, 6299, 1566722146641, 6505, 206, true
2225, 1566722146438, 6302, 1566722146650, 6514, 212, true
2226, 1566722146439, 6303, 1566722146651, 6515, 212, true
2227, 1566722146441, 6305, 1566722146651, 6515, 210, true
2228, 1566722146442, 6306, 1566722146653, 6517, 211, true
2229, 1566722146442, 6306, 1566722146652, 6516, 210, true
2230, 1566722146443, 6307, 1566722146653, 6517, 210, true
2231, 1566722146444, 6308, 1566722146653, 6517, 209, true
2232, 1566722146449, 6313, 1566722146657, 6521, 208, true
2233, 1566722146450, 6314, 1566722146657, 6521, 207, true
2234, 1566722146456, 6320, 1566722146672, 6536, 216, true
2235, 1566722146457, 6321, 1566722146672, 6536, 215, true
2236, 1566722146459, 6323, 1566722146672, 6536, 213, true
2237, 1566722146464, 6328, 1566722146672, 6536, 208, true
2238, 1566722146464, 6328, 1566722146673, 6537, 209, true
2239, 1566722146465, 6329, 1566722146672, 6536, 207, true
2240, 1566722146466, 6330, 1566722146672, 6536, 206, true
2241, 1566722146466, 6330, 1566722146673, 6537, 207, true
2242, 1566722146468, 6332, 1566722146677, 6541, 209, true
2243, 1566722146473, 6337, 1566722146684, 6548, 211, true
2244, 1566722146474, 6338, 1566722146684, 6548, 210, true
2245, 1566722146475, 6339, 1566722146683, 6547, 208, true
2246, 1566722146475, 6339, 1566722146683, 6547, 208, true
2247, 1566722146477, 6341, 1566722146682, 6546, 205, true
2248, 1566722146479, 6343, 1566722146686, 6550, 207, true
2249, 1566722146479, 6343, 1566722146686, 6550, 207, true
2250, 1566722146480, 6344, 1566722146686, 6550, 206, true
2251, 1566722146481, 6345, 1566722146690, 6554, 209, true
2252, 1566722146484, 6348, 1566722146689, 6553, 205, true
2253, 1566722146484, 6348, 1566722146693, 6557, 209, true
2254, 1566722146485, 6349, 1566722146693, 6557, 208, true
2255, 1566722146487, 6351, 1566722146690, 6554, 203, true
2256, 1566722146489, 6353, 1566722146699, 6563, 210, true
2257, 1566722146489, 6353, 1566722146699, 6563, 210, true
2258, 1566722146509, 6373, 1566722146717, 6581, 208, true
2259, 1566722146509, 6373, 1566722146730, 6594, 221, true
2260, 1566722146510, 6374, 1566722146730, 6594, 220, true
2261, 1566722146514, 6378, 1566722146730, 6594, 216, true
2262, 1566722146514, 6378, 1566722146731, 6595, 217, true
2263, 1566722146515, 6379, 1566722146730, 6594, 215, true
2264, 1566722146517, 6381, 1566722146730, 6594, 213, true
2265, 1566722146517, 6381, 1566722146730, 6594, 213, true
2266, 1566722146518, 6382, 1566722146731, 6595, 213, true
2267, 1566722146519, 6383, 1566722146730, 6594, 211, true
2268, 1566722146520, 6384, 1566722146734, 6598, 214, true
2269, 1566722146520, 6384, 1566722146734, 6598, 214, true
2270, 1566722146533, 6397, 1566722146745, 6609, 212, true
2271, 1566722146542, 6406, 1566722146754, 6618, 212, true
2272, 1566722146543, 6407, 1566722146756, 6620, 213, true
2273, 1566722146543, 6407, 1566722146754, 6618, 211, true
2274, 1566722146544, 6408, 1566722146756, 6620, 212, true
2275, 1566722146545, 6409, 1566722146756, 6620, 211, true
2276, 1566722146546, 6410, 1566722146755, 6619, 209, true
2277, 1566722146547, 6411, 1566722146754, 6618, 207, true
2278, 1566722146553, 6417, 1566722146759, 6623, 206, true
2279, 1566722146555, 6419, 1566722146761, 6625, 206, true
2280, 1566722146556, 6420, 1566722146768, 6632, 212, true
2281, 1566722146560, 6424, 1566722146769, 6633, 209, true
2282, 1566722146561, 6425, 1566722146769, 6633, 208, true
2283, 1566722146563, 6427, 1566722146780, 6644, 217, true
2284, 1566722146567, 6431, 1566722146781, 6645, 214, true
2285, 1566722146569, 6433, 1566722146781, 6645, 212, true
2286, 1566722146570, 6434, 1566722146776, 6640, 206, true
2287, 1566722146572, 6436, 1566722146783, 6647, 211, true
2288, 1566722146573, 6437, 1566722146781, 6645, 208, true
2289, 1566722146577, 6441, 1566722146788, 6652, 211, true
2290, 1566722146581, 6445, 1566722146788, 6652, 207, true
2291, 1566722146582, 6446, 1566722146788, 6652, 206, true
2292, 1566722146583, 6447, 1566722146788, 6652, 205, true
2293, 1566722146586, 6450, 1566722146798, 6662, 212, true
2294, 1566722146590, 6454, 1566722146802, 6666, 212, true
2295, 1566722146591, 6455, 1566722146798, 6662, 207, true
2296, 1566722146592, 6456, 1566722146806, 6670, 214, true
2297, 1566722146594, 6458, 1566722146805, 6669, 211, true
2298, 1566722146597, 6461, 1566722146806, 6670, 209, true
2299, 1566722146599, 6463, 1566722146808, 6672, 209, true
2300, 1566722146654, 6518, 1566722146914, 6778, 260, true
2301, 1566722146654, 6518, 1566722146911, 6775, 257, true
2302, 1566722146655, 6519, 1566722146896, 6760, 241, true
2303, 1566722146658, 6522, 1566722146896, 6760, 238, true
2304, 1566722146660, 6524, 1566722146890, 6754, 230, true
2305, 1566722146661, 6525, 1566722146888, 6752, 227, true
2306, 1566722146661, 6525, 1566722146890, 6754, 229, true
2307, 1566722146662, 6526, 1566722146896, 6760, 234, true
2308, 1566722146663, 6527, 1566722146888, 6752, 225, true
2309, 1566722146668, 6532, 1566722146911, 6775, 243, true
2310, 1566722146674, 6538, 1566722146885, 6749, 211, true
2311, 1566722146675, 6539, 1566722146891, 6755, 216, true
2312, 1566722146675, 6539, 1566722146911, 6775, 236, true
2313, 1566722146678, 6542, 1566722146939, 6803, 261, true
2314, 1566722146679, 6543, 1566722146920, 6784, 241, true
2315, 1566722146690, 6554, 1566722146920, 6784, 230, true
2316, 1566722146691, 6555, 1566722146920, 6784, 229, true
2317, 1566722146692, 6556, 1566722146920, 6784, 228, true
2318, 1566722146693, 6557, 1566722146917, 6781, 224, true
2319, 1566722146694, 6558, 1566722146920, 6784, 226, true
2320, 1566722146694, 6558, 1566722146917, 6781, 223, true
2321, 1566722146695, 6559, 1566722146945, 6809, 250, true
2322, 1566722146696, 6560, 1566722146940, 6804, 244, true
2323, 1566722146698, 6562, 1566722146915, 6779, 217, true
2324, 1566722146700, 6564, 1566722146916, 6780, 216, true
2325, 1566722146700, 6564, 1566722146917, 6781, 217, true
2326, 1566722146701, 6565, 1566722146920, 6784, 219, true
2327, 1566722146702, 6566, 1566722146923, 6787, 221, true
2328, 1566722146703, 6567, 1566722146927, 6791, 224, true
2329, 1566722146704, 6568, 1566722146927, 6791, 223, true
2330, 1566722146704, 6568, 1566722146925, 6789, 221, true
2331, 1566722146705, 6569, 1566722146940, 6804, 235, true
2332, 1566722146707, 6571, 1566722146979, 6843, 272, true
2333, 1566722146708, 6572, 1566722146977, 6841, 269, true
2334, 1566722146708, 6572, 1566722146972, 6836, 264, true
2335, 1566722146709, 6573, 1566722146955, 6819, 246, true
2336, 1566722146710, 6574, 1566722146963, 6827, 253, true
2337, 1566722146717, 6581, 1566722146977, 6841, 260, true
2338, 1566722146718, 6582, 1566722146968, 6832, 250, true
2339, 1566722146719, 6583, 1566722146948, 6812, 229, true
2340, 1566722146721, 6585, 1566722146969, 6833, 248, true
2341, 1566722146722, 6586, 1566722146970, 6834, 248, true
2342, 1566722146724, 6588, 1566722146977, 6841, 253, true
2343, 1566722146735, 6599, 1566722146979, 6843, 244, true
2344, 1566722146736, 6600, 1566722146979, 6843, 243, true
2345, 1566722146737, 6601, 1566722146969, 6833, 232, true
2346, 1566722146737, 6601, 1566722146945, 6809, 208, true
2347, 1566722146738, 6602, 1566722146968, 6832, 230, true
2348, 1566722146739, 6603, 1566722146979, 6843, 240, true
2349, 1566722146739, 6603, 1566722146990, 6854, 251, true
2350, 1566722146740, 6604, 1566722146995, 6859, 255, true
2351, 1566722146740, 6604, 1566722146990, 6854, 250, true
2352, 1566722146742, 6606, 1566722146992, 6856, 250, true
2353, 1566722146743, 6607, 1566722146989, 6853, 246, true
2354, 1566722146745, 6609, 1566722146979, 6843, 234, true
2355, 1566722146746, 6610, 1566722146992, 6856, 246, true
2356, 1566722146747, 6611, 1566722146979, 6843, 232, true
2357, 1566722146747, 6611, 1566722146981, 6845, 234, true
2358, 1566722146748, 6612, 1566722146985, 6849, 237, true
2359, 1566722146749, 6613, 1566722146985, 6849, 236, true
2360, 1566722146749, 6613, 1566722146993, 6857, 244, true
2361, 1566722146750, 6614, 1566722146985, 6849, 235, true
2362, 1566722146752, 6616, 1566722146985, 6849, 233, true
2363, 1566722146756, 6620, 1566722146981, 6845, 225, true
2364, 1566722146758, 6622, 1566722146992, 6856, 234, true
2365, 1566722146759, 6623, 1566722146995, 6859, 236, true
2366, 1566722146761, 6625, 1566722146984, 6848, 223, true
2367, 1566722146762, 6626, 1566722146995, 6859, 233, true
2368, 1566722146762, 6626, 1566722146989, 6853, 227, true
2369, 1566722146762, 6626, 1566722146986, 6850, 224, true
2370, 1566722146762, 6626, 1566722146985, 6849, 223, true
2371, 1566722146763, 6627, 1566722146992, 6856, 229, true
2372, 1566722146763, 6627, 1566722146986, 6850, 223, true
2373, 1566722146764, 6628, 1566722146981, 6845, 217, true
2374, 1566722146770, 6634, 1566722146990, 6854, 220, true
2375, 1566722146771, 6635, 1566722146995, 6859, 224, true
2376, 1566722146771, 6635, 1566722146985, 6849, 214, true
2377, 1566722146832, 6696, 1566722147039, 6903, 207, true
2378, 1566722146833, 6697, 1566722147040, 6904, 207, true
2379, 1566722146835, 6699, 1566722147046, 6910, 211, true
2380, 1566722146836, 6700, 1566722147045, 6909, 209, true
2381, 1566722146836, 6700, 1566722147045, 6909, 209, true
2382, 1566722146837, 6701, 1566722147048, 6912, 211, true
2383, 1566722146840, 6704, 1566722147052, 6916, 212, true
2384, 1566722146842, 6706, 1566722147051, 6915, 209, true
2385, 1566722146844, 6708, 1566722147052, 6916, 208, true
2386, 1566722146846, 6710, 1566722147054, 6918, 208, true
2387, 1566722146849, 6713, 1566722147054, 6918, 205, true
2388, 1566722146851, 6715, 1566722147064, 6928, 213, true
2389, 1566722146853, 6717, 1566722147068, 6932, 215, true
2390, 1566722146854, 6718, 1566722147064, 6928, 210, true
2391, 1566722146857, 6721, 1566722147073, 6937, 216, true
2392, 1566722146859, 6723, 1566722147071, 6935, 212, true
2393, 1566722146862, 6726, 1566722147073, 6937, 211, true
2394, 1566722146865, 6729, 1566722147073, 6937, 208, true
2395, 1566722146866, 6730, 1566722147071, 6935, 205, true
2396, 1566722146868, 6732, 1566722147073, 6937, 205, true
2397, 1566722146871, 6735, 1566722147082, 6946, 211, true
2398, 1566722146874, 6738, 1566722147081, 6945, 207, true
2399, 1566722146876, 6740, 1566722147081, 6945, 205, true
2400, 1566722146879, 6743, 1566722147095, 6959, 216, true
2401, 1566722146883, 6747, 1566722147102, 6966, 219, true
2402, 1566722146886, 6750, 1566722147097, 6961, 211, true
2403, 1566722146891, 6755, 1566722147102, 6966, 211, true
2404, 1566722146892, 6756, 1566722147102, 6966, 210, true
2405, 1566722146893, 6757, 1566722147102, 6966, 209, true
2406, 1566722146893, 6757, 1566722147102, 6966, 209, true
2407, 1566722146894, 6758, 1566722147102, 6966, 208, true
2408, 1566722146900, 6764, 1566722147107, 6971, 207, true
2409, 1566722146904, 6768, 1566722147113, 6977, 209, true
2410, 1566722146912, 6776, 1566722147126, 6990, 214, true
2411, 1566722146913, 6777, 1566722147121, 6985, 208, true
2412, 1566722146916, 6780, 1566722147128, 6992, 212, true
2413, 1566722146921, 6785, 1566722147128, 6992, 207, true
2414, 1566722146921, 6785, 1566722147138, 7002, 217, true
2415, 1566722146924, 6788, 1566722147138, 7002, 214, true
2416, 1566722146925, 6789, 1566722147133, 6997, 208, true
2417, 1566722146928, 6792, 1566722147138, 7002, 210, true
2418, 1566722146928, 6792, 1566722147138, 7002, 210, true
2419, 1566722146929, 6793, 1566722147139, 7003, 210, true
2420, 1566722146930, 6794, 1566722147139, 7003, 209, true
2421, 1566722146931, 6795, 1566722147140, 7004, 209, true
2422, 1566722146931, 6795, 1566722147150, 7014, 219, true
2423, 1566722146938, 6802, 1566722147150, 7014, 212, true
2424, 1566722146941, 6805, 1566722147150, 7014, 209, true
2425, 1566722146945, 6809, 1566722147154, 7018, 209, true
2426, 1566722146948, 6812, 1566722147156, 7020, 208, true
2427, 1566722146948, 6812, 1566722147159, 7023, 211, true
2428, 1566722146948, 6812, 1566722147158, 7022, 210, true
2429, 1566722146949, 6813, 1566722147156, 7020, 207, true
2430, 1566722146950, 6814, 1566722147166, 7030, 216, true
2431, 1566722146951, 6815, 1566722147158, 7022, 207, true
2432, 1566722146952, 6816, 1566722147159, 7023, 207, true
2433, 1566722146953, 6817, 1566722147166, 7030, 213, true
2434, 1566722146955, 6819, 1566722147166, 7030, 211, true
2435, 1566722146957, 6821, 1566722147169, 7033, 212, true
2436, 1566722146957, 6821, 1566722147175, 7039, 218, true
2437, 1566722146958, 6822, 1566722147176, 7040, 218, true
2438, 1566722146959, 6823, 1566722147176, 7040, 217, true
2439, 1566722146970, 6834, 1566722147176, 7040, 206, true
2440, 1566722146973, 6837, 1566722147177, 7041, 204, true
2441, 1566722146973, 6837, 1566722147184, 7048, 211, true
2442, 1566722146973, 6837, 1566722147177, 7041, 204, true
2443, 1566722146975, 6839, 1566722147206, 7070, 231, true
2444, 1566722146975, 6839, 1566722147207, 7071, 232, true
2445, 1566722146984, 6848, 1566722147201, 7065, 217, true
2446, 1566722147001, 6865, 1566722147208, 7072, 207, true
2447, 1566722147002, 6866, 1566722147209, 7073, 207, true
2448, 1566722147002, 6866, 1566722147207, 7071, 205, true
2449, 1566722147003, 6867, 1566722147211, 7075, 208, true
2450, 1566722147004, 6868, 1566722147209, 7073, 205, true
2451, 1566722147006, 6870, 1566722147211, 7075, 205, true
2452, 1566722147008, 6872, 1566722147215, 7079, 207, true
2453, 1566722147009, 6873, 1566722147215, 7079, 206, true
2454, 1566722147011, 6875, 1566722147215, 7079, 204, true
2455, 1566722147012, 6876, 1566722147216, 7080, 204, true
2456, 1566722147013, 6877, 1566722147216, 7080, 203, true
2457, 1566722147014, 6878, 1566722147226, 7090, 212, true
2458, 1566722147014, 6878, 1566722147226, 7090, 212, true
2459, 1566722147016, 6880, 1566722147223, 7087, 207, true
2460, 1566722147017, 6881, 1566722147223, 7087, 206, true
2461, 1566722147018, 6882, 1566722147226, 7090, 208, true
2462, 1566722147018, 6882, 1566722147229, 7093, 211, true
2463, 1566722147020, 6884, 1566722147231, 7095, 211, true
2464, 1566722147020, 6884, 1566722147229, 7093, 209, true
2465, 1566722147021, 6885, 1566722147231, 7095, 210, true
2466, 1566722147022, 6886, 1566722147231, 7095, 209, true
2467, 1566722147024, 6888, 1566722147234, 7098, 210, true
2468, 1566722147024, 6888, 1566722147233, 7097, 209, true
2469, 1566722147025, 6889, 1566722147233, 7097, 208, true
2470, 1566722147027, 6891, 1566722147267, 7131, 240, true
2471, 1566722147029, 6893, 1566722147238, 7102, 209, true
2472, 1566722147030, 6894, 1566722147281, 7145, 251, true
2473, 1566722147031, 6895, 1566722147269, 7133, 238, true
2474, 1566722147032, 6896, 1566722147268, 7132, 236, true
2475, 1566722147033, 6897, 1566722147279, 7143, 246, true
2476, 1566722147034, 6898, 1566722147290, 7154, 256, true
2477, 1566722147034, 6898, 1566722147298, 7162, 264, true
2478, 1566722147035, 6899, 1566722147294, 7158, 259, true
2479, 1566722147035, 6899, 1566722147293, 7157, 258, true
2480, 1566722147035, 6899, 1566722147294, 7158, 259, true
2481, 1566722147036, 6900, 1566722147294, 7158, 258, true
2482, 1566722147036, 6900, 1566722147268, 7132, 232, true
2483, 1566722147037, 6901, 1566722147271, 7135, 234, true
2484, 1566722147037, 6901, 1566722147289, 7153, 252, true
2485, 1566722147040, 6904, 1566722147283, 7147, 243, true
2486, 1566722147040, 6904, 1566722147294, 7158, 254, true
2487, 1566722147040, 6904, 1566722147289, 7153, 249, true
2488, 1566722147041, 6905, 1566722147293, 7157, 252, true
2489, 1566722147041, 6905, 1566722147283, 7147, 242, true
2490, 1566722147041, 6905, 1566722147281, 7145, 240, true
2491, 1566722147042, 6906, 1566722147279, 7143, 237, true
2492, 1566722147042, 6906, 1566722147285, 7149, 243, true
2493, 1566722147044, 6908, 1566722147279, 7143, 235, true
2494, 1566722147045, 6909, 1566722147293, 7157, 248, true
2495, 1566722147046, 6910, 1566722147279, 7143, 233, true
2496, 1566722147047, 6911, 1566722147272, 7136, 225, true
2497, 1566722147048, 6912, 1566722147294, 7158, 246, true
2498, 1566722147048, 6912, 1566722147293, 7157, 245, true
2499, 1566722147048, 6912, 1566722147281, 7145, 233, true
2500, 1566722147049, 6913, 1566722147272, 7136, 223, true
2501, 1566722147049, 6913, 1566722147293, 7157, 244, true
2502, 1566722147050, 6914, 1566722147290, 7154, 240, true
2503, 1566722147051, 6915, 1566722147279, 7143, 228, true
2504, 1566722147052, 6916, 1566722147293, 7157, 241, true
2505, 1566722147053, 6917, 1566722147297, 7161, 244, true
2506, 1566722147054, 6918, 1566722147290, 7154, 236, true
2507, 1566722147055, 6919, 1566722147294, 7158, 239, true
2508, 1566722147056, 6920, 1566722147290, 7154, 234, true
2509, 1566722147056, 6920, 1566722147283, 7147, 227, true
2510, 1566722147057, 6921, 1566722147300, 7164, 243, true
2511, 1566722147057, 6921, 1566722147302, 7166, 245, true
2512, 1566722147058, 6922, 1566722147300, 7164, 242, true
2513, 1566722147058, 6922, 1566722147300, 7164, 242, true
2514, 1566722147059, 6923, 1566722147309, 7173, 250, true
2515, 1566722147060, 6924, 1566722147301, 7165, 241, true
2516, 1566722147062, 6926, 1566722147302, 7166, 240, true
2517, 1566722147069, 6933, 1566722147300, 7164, 231, true
2518, 1566722147076, 6940, 1566722147300, 7164, 224, true
2519, 1566722147076, 6940, 1566722147297, 7161, 221, true
2520, 1566722147078, 6942, 1566722147297, 7161, 219, true
2521, 1566722147079, 6943, 1566722147308, 7172, 229, true
2522, 1566722147082, 6946, 1566722147300, 7164, 218, true
2523, 1566722147083, 6947, 1566722147301, 7165, 218, true
2524, 1566722147083, 6947, 1566722147308, 7172, 225, true
2525, 1566722147084, 6948, 1566722147301, 7165, 217, true
2526, 1566722147084, 6948, 1566722147304, 7168, 220, true
2527, 1566722147094, 6958, 1566722147313, 7177, 219, true
2528, 1566722147096, 6960, 1566722147313, 7177, 217, true
2529, 1566722147097, 6961, 1566722147308, 7172, 211, true
2530, 1566722147098, 6962, 1566722147312, 7176, 214, true
2531, 1566722147104, 6968, 1566722147313, 7177, 209, true
2532, 1566722147105, 6969, 1566722147312, 7176, 207, true
2533, 1566722147109, 6973, 1566722147313, 7177, 204, true
2534, 1566722147111, 6975, 1566722147318, 7182, 207, true
2535, 1566722147114, 6978, 1566722147320, 7184, 206, true
2536, 1566722147115, 6979, 1566722147320, 7184, 205, true
2537, 1566722147116, 6980, 1566722147320, 7184, 204, true
2538, 1566722147117, 6981, 1566722147320, 7184, 203, true
2539, 1566722147118, 6982, 1566722147328, 7192, 210, true
2540, 1566722147119, 6983, 1566722147335, 7199, 216, true
2541, 1566722147120, 6984, 1566722147331, 7195, 211, true
2542, 1566722147120, 6984, 1566722147331, 7195, 211, true
2543, 1566722147122, 6986, 1566722147335, 7199, 213, true
2544, 1566722147123, 6987, 1566722147329, 7193, 206, true
2545, 1566722147124, 6988, 1566722147331, 7195, 207, true
2546, 1566722147129, 6993, 1566722147335, 7199, 206, true
2547, 1566722147130, 6994, 1566722147337, 7201, 207, true
2548, 1566722147130, 6994, 1566722147340, 7204, 210, true
2549, 1566722147130, 6994, 1566722147340, 7204, 210, true
2550, 1566722147133, 6997, 1566722147340, 7204, 207, true
2551, 1566722147134, 6998, 1566722147342, 7206, 208, true
2552, 1566722147137, 7001, 1566722147343, 7207, 206, true
2553, 1566722147139, 7003, 1566722147350, 7214, 211, true
2554, 1566722147141, 7005, 1566722147346, 7210, 205, true
2555, 1566722147142, 7006, 1566722147347, 7211, 205, true
2556, 1566722147142, 7006, 1566722147350, 7214, 208, true
2557, 1566722147145, 7009, 1566722147354, 7218, 209, true
2558, 1566722147146, 7010, 1566722147352, 7216, 206, true
2559, 1566722147147, 7011, 1566722147363, 7227, 216, true
2560, 1566722147149, 7013, 1566722147359, 7223, 210, true
2561, 1566722147151, 7015, 1566722147359, 7223, 208, true
2562, 1566722147154, 7018, 1566722147359, 7223, 205, true
2563, 1566722147159, 7023, 1566722147369, 7233, 210, true
2564, 1566722147160, 7024, 1566722147372, 7236, 212, true
2565, 1566722147162, 7026, 1566722147372, 7236, 210, true
2566, 1566722147164, 7028, 1566722147371, 7235, 207, true
2567, 1566722147167, 7031, 1566722147372, 7236, 205, true
2568, 1566722147170, 7034, 1566722147373, 7237, 203, true
2569, 1566722147172, 7036, 1566722147375, 7239, 203, true
2570, 1566722147173, 7037, 1566722147386, 7250, 213, true
2571, 1566722147179, 7043, 1566722147388, 7252, 209, true
2572, 1566722147180, 7044, 1566722147388, 7252, 208, true
2573, 1566722147181, 7045, 1566722147388, 7252, 207, true
2574, 1566722147181, 7045, 1566722147392, 7256, 211, true
2575, 1566722147182, 7046, 1566722147388, 7252, 206, true
2576, 1566722147182, 7046, 1566722147392, 7256, 210, true
2577, 1566722147187, 7051, 1566722147397, 7261, 210, true
2578, 1566722147190, 7054, 1566722147396, 7260, 206, true
2579, 1566722147192, 7056, 1566722147404, 7268, 212, true
2580, 1566722147194, 7058, 1566722147404, 7268, 210, true
2581, 1566722147198, 7062, 1566722147404, 7268, 206, true
2582, 1566722147201, 7065, 1566722147410, 7274, 209, true
2583, 1566722147204, 7068, 1566722147413, 7277, 209, true
2584, 1566722147212, 7076, 1566722147424, 7288, 212, true
2585, 1566722147213, 7077, 1566722147419, 7283, 206, true
2586, 1566722147221, 7085, 1566722147430, 7294, 209, true
2587, 1566722147227, 7091, 1566722147438, 7302, 211, true
2588, 1566722147236, 7100, 1566722147443, 7307, 207, true
2589, 1566722147239, 7103, 1566722147447, 7311, 208, true
2590, 1566722147240, 7104, 1566722147447, 7311, 207, true
2591, 1566722147242, 7106, 1566722147447, 7311, 205, true
2592, 1566722147243, 7107, 1566722147452, 7316, 209, true
2593, 1566722147245, 7109, 1566722147452, 7316, 207, true
2594, 1566722147247, 7111, 1566722147453, 7317, 206, true
2595, 1566722147249, 7113, 1566722147459, 7323, 210, true
2596, 1566722147252, 7116, 1566722147460, 7324, 208, true
2597, 1566722147254, 7118, 1566722147467, 7331, 213, true
2598, 1566722147255, 7119, 1566722147464, 7328, 209, true
2599, 1566722147256, 7120, 1566722147463, 7327, 207, true
2600, 1566722147257, 7121, 1566722147464, 7328, 207, true
2601, 1566722147261, 7125, 1566722147473, 7337, 212, true
2602, 1566722147262, 7126, 1566722147474, 7338, 212, true
2603, 1566722147264, 7128, 1566722147473, 7337, 209, true
2604, 1566722147270, 7134, 1566722147477, 7341, 207, true
2605, 1566722147273, 7137, 1566722147477, 7341, 204, true
2606, 1566722147275, 7139, 1566722147478, 7342, 203, true
2607, 1566722147317, 7181, 1566722147532, 7396, 215, true
2608, 1566722147317, 7181, 1566722147524, 7388, 207, true
2609, 1566722147318, 7182, 1566722147532, 7396, 214, true
2610, 1566722147321, 7185, 1566722147530, 7394, 209, true
2611, 1566722147322, 7186, 1566722147531, 7395, 209, true
2612, 1566722147326, 7190, 1566722147532, 7396, 206, true
2613, 1566722147329, 7193, 1566722147536, 7400, 207, true
2614, 1566722147332, 7196, 1566722147542, 7406, 210, true
2615, 1566722147333, 7197, 1566722147542, 7406, 209, true
2616, 1566722147338, 7202, 1566722147550, 7414, 212, true
2617, 1566722147344, 7208, 1566722147550, 7414, 206, true
2618, 1566722147344, 7208, 1566722147555, 7419, 211, true
2619, 1566722147347, 7211, 1566722147554, 7418, 207, true
2620, 1566722147348, 7212, 1566722147556, 7420, 208, true
2621, 1566722147348, 7212, 1566722147556, 7420, 208, true
2622, 1566722147350, 7214, 1566722147561, 7425, 211, true
2623, 1566722147352, 7216, 1566722147559, 7423, 207, true
2624, 1566722147353, 7217, 1566722147558, 7422, 205, true
2625, 1566722147355, 7219, 1566722147559, 7423, 204, true
2626, 1566722147355, 7219, 1566722147559, 7423, 204, true
2627, 1566722147356, 7220, 1566722147566, 7430, 210, true
2628, 1566722147357, 7221, 1566722147570, 7434, 213, true
2629, 1566722147359, 7223, 1566722147567, 7431, 208, true
2630, 1566722147359, 7223, 1566722147572, 7436, 213, true
2631, 1566722147360, 7224, 1566722147572, 7436, 212, true
2632, 1566722147363, 7227, 1566722147579, 7443, 216, true
2633, 1566722147376, 7240, 1566722147585, 7449, 209, true
2634, 1566722147376, 7240, 1566722147583, 7447, 207, true
2635, 1566722147376, 7240, 1566722147583, 7447, 207, true
2636, 1566722147378, 7242, 1566722147587, 7451, 209, true
2637, 1566722147379, 7243, 1566722147585, 7449, 206, true
2638, 1566722147380, 7244, 1566722147587, 7451, 207, true
2639, 1566722147380, 7244, 1566722147587, 7451, 207, true
2640, 1566722147389, 7253, 1566722147601, 7465, 212, true
2641, 1566722147394, 7258, 1566722147603, 7467, 209, true
2642, 1566722147394, 7258, 1566722147602, 7466, 208, true
2643, 1566722147398, 7262, 1566722147612, 7476, 214, true
2644, 1566722147398, 7262, 1566722147608, 7472, 210, true
2645, 1566722147399, 7263, 1566722147609, 7473, 210, true
2646, 1566722147400, 7264, 1566722147611, 7475, 211, true
2647, 1566722147400, 7264, 1566722147608, 7472, 208, true
2648, 1566722147400, 7264, 1566722147615, 7479, 215, true
2649, 1566722147406, 7270, 1566722147618, 7482, 212, true
2650, 1566722147407, 7271, 1566722147614, 7478, 207, true
2651, 1566722147407, 7271, 1566722147615, 7479, 208, true
2652, 1566722147408, 7272, 1566722147618, 7482, 210, true
2653, 1566722147411, 7275, 1566722147618, 7482, 207, true
2654, 1566722147411, 7275, 1566722147629, 7493, 218, true
2655, 1566722147411, 7275, 1566722147630, 7494, 219, true
2656, 1566722147412, 7276, 1566722147630, 7494, 218, true
2657, 1566722147412, 7276, 1566722147630, 7494, 218, true
2658, 1566722147414, 7278, 1566722147629, 7493, 215, true
2659, 1566722147414, 7278, 1566722147632, 7496, 218, true
2660, 1566722147415, 7279, 1566722147630, 7494, 215, true
2661, 1566722147416, 7280, 1566722147635, 7499, 219, true
2662, 1566722147418, 7282, 1566722147635, 7499, 217, true
2663, 1566722147420, 7284, 1566722147646, 7510, 226, true
2664, 1566722147421, 7285, 1566722147642, 7506, 221, true
2665, 1566722147422, 7286, 1566722147645, 7509, 223, true
2666, 1566722147423, 7287, 1566722147650, 7514, 227, true
2667, 1566722147426, 7290, 1566722147645, 7509, 219, true
2668, 1566722147426, 7290, 1566722147650, 7514, 224, true
2669, 1566722147428, 7292, 1566722147650, 7514, 222, true
2670, 1566722147431, 7295, 1566722147650, 7514, 219, true
2671, 1566722147431, 7295, 1566722147650, 7514, 219, true
2672, 1566722147432, 7296, 1566722147650, 7514, 218, true
2673, 1566722147432, 7296, 1566722147650, 7514, 218, true
2674, 1566722147433, 7297, 1566722147657, 7521, 224, true
2675, 1566722147434, 7298, 1566722147658, 7522, 224, true
2676, 1566722147435, 7299, 1566722147657, 7521, 222, true
2677, 1566722147437, 7301, 1566722147660, 7524, 223, true
2678, 1566722147440, 7304, 1566722147657, 7521, 217, true
2679, 1566722147440, 7304, 1566722147658, 7522, 218, true
2680, 1566722147442, 7306, 1566722147657, 7521, 215, true
2681, 1566722147444, 7308, 1566722147659, 7523, 215, true
2682, 1566722147445, 7309, 1566722147663, 7527, 218, true
2683, 1566722147445, 7309, 1566722147659, 7523, 214, true
2684, 1566722147448, 7312, 1566722147663, 7527, 215, true
2685, 1566722147448, 7312, 1566722147678, 7542, 230, true
2686, 1566722147449, 7313, 1566722147677, 7541, 228, true
2687, 1566722147449, 7313, 1566722147668, 7532, 219, true
2688, 1566722147449, 7313, 1566722147677, 7541, 228, true
2689, 1566722147450, 7314, 1566722147680, 7544, 230, true
2690, 1566722147451, 7315, 1566722147677, 7541, 226, true
2691, 1566722147452, 7316, 1566722147674, 7538, 222, true
2692, 1566722147453, 7317, 1566722147668, 7532, 215, true
2693, 1566722147454, 7318, 1566722147677, 7541, 223, true
2694, 1566722147454, 7318, 1566722147677, 7541, 223, true
2695, 1566722147455, 7319, 1566722147680, 7544, 225, true
2696, 1566722147455, 7319, 1566722147680, 7544, 225, true
2697, 1566722147456, 7320, 1566722147678, 7542, 222, true
2698, 1566722147457, 7321, 1566722147680, 7544, 223, true
2699, 1566722147458, 7322, 1566722147672, 7536, 214, true
2700, 1566722147460, 7324, 1566722147674, 7538, 214, true
2701, 1566722147461, 7325, 1566722147680, 7544, 219, true
2702, 1566722147461, 7325, 1566722147678, 7542, 217, true
2703, 1566722147461, 7325, 1566722147678, 7542, 217, true
2704, 1566722147462, 7326, 1566722147677, 7541, 215, true
2705, 1566722147465, 7329, 1566722147685, 7549, 220, true
2706, 1566722147465, 7329, 1566722147678, 7542, 213, true
2707, 1566722147468, 7332, 1566722147685, 7549, 217, true
2708, 1566722147468, 7332, 1566722147687, 7551, 219, true
2709, 1566722147470, 7334, 1566722147685, 7549, 215, true
2710, 1566722147475, 7339, 1566722147690, 7554, 215, true
2711, 1566722147476, 7340, 1566722147690, 7554, 214, true
2712, 1566722147480, 7344, 1566722147685, 7549, 205, true
2713, 1566722147480, 7344, 1566722147690, 7554, 210, true
2714, 1566722147481, 7345, 1566722147690, 7554, 209, true
2715, 1566722147482, 7346, 1566722147691, 7555, 209, true
2716, 1566722147482, 7346, 1566722147691, 7555, 209, true
2717, 1566722147485, 7349, 1566722147693, 7557, 208, true
2718, 1566722147486, 7350, 1566722147693, 7557, 207, true
2719, 1566722147487, 7351, 1566722147692, 7556, 205, true
2720, 1566722147488, 7352, 1566722147693, 7557, 205, true
2721, 1566722147488, 7352, 1566722147692, 7556, 204, true
2722, 1566722147491, 7355, 1566722147702, 7566, 211, true
2723, 1566722147491, 7355, 1566722147704, 7568, 213, true
2724, 1566722147492, 7356, 1566722147708, 7572, 216, true
2725, 1566722147494, 7358, 1566722147707, 7571, 213, true
2726, 1566722147495, 7359, 1566722147706, 7570, 211, true
2727, 1566722147496, 7360, 1566722147704, 7568, 208, true
2728, 1566722147496, 7360, 1566722147707, 7571, 211, true
2729, 1566722147497, 7361, 1566722147708, 7572, 211, true
2730, 1566722147498, 7362, 1566722147707, 7571, 209, true
2731, 1566722147499, 7363, 1566722147707, 7571, 208, true
2732, 1566722147501, 7365, 1566722147710, 7574, 209, true
2733, 1566722147501, 7365, 1566722147710, 7574, 209, true
2734, 1566722147501, 7365, 1566722147711, 7575, 210, true
2735, 1566722147502, 7366, 1566722147710, 7574, 208, true
2736, 1566722147502, 7366, 1566722147711, 7575, 209, true
2737, 1566722147503, 7367, 1566722147717, 7581, 214, true
2738, 1566722147504, 7368, 1566722147713, 7577, 209, true
2739, 1566722147507, 7371, 1566722147715, 7579, 208, true
2740, 1566722147508, 7372, 1566722147714, 7578, 206, true
2741, 1566722147510, 7374, 1566722147719, 7583, 209, true
2742, 1566722147510, 7374, 1566722147718, 7582, 208, true
2743, 1566722147511, 7375, 1566722147719, 7583, 208, true
2744, 1566722147512, 7376, 1566722147719, 7583, 207, true
2745, 1566722147513, 7377, 1566722147767, 7631, 254, true
2746, 1566722147515, 7379, 1566722147738, 7602, 223, true
2747, 1566722147516, 7380, 1566722147761, 7625, 245, true
2748, 1566722147517, 7381, 1566722147767, 7631, 250, true
2749, 1566722147519, 7383, 1566722147761, 7625, 242, true
2750, 1566722147520, 7384, 1566722147767, 7631, 247, true
2751, 1566722147521, 7385, 1566722147761, 7625, 240, true
2752, 1566722147522, 7386, 1566722147767, 7631, 245, true
2753, 1566722147525, 7389, 1566722147746, 7610, 221, true
2754, 1566722147525, 7389, 1566722147767, 7631, 242, true
2755, 1566722147526, 7390, 1566722147767, 7631, 241, true
2756, 1566722147528, 7392, 1566722147764, 7628, 236, true
2757, 1566722147534, 7398, 1566722147767, 7631, 233, true
2758, 1566722147536, 7400, 1566722147764, 7628, 228, true
2759, 1566722147538, 7402, 1566722147767, 7631, 229, true
2760, 1566722147540, 7404, 1566722147763, 7627, 223, true
2761, 1566722147545, 7409, 1566722147763, 7627, 218, true
2762, 1566722147547, 7411, 1566722147767, 7631, 220, true
2763, 1566722147548, 7412, 1566722147762, 7626, 214, true
2764, 1566722147551, 7415, 1566722147767, 7631, 216, true
2765, 1566722147552, 7416, 1566722147767, 7631, 215, true
2766, 1566722147556, 7420, 1566722147761, 7625, 205, true
2767, 1566722147562, 7426, 1566722147769, 7633, 207, true
2768, 1566722147573, 7437, 1566722147782, 7646, 209, true
2769, 1566722147575, 7439, 1566722147786, 7650, 211, true
2770, 1566722147590, 7454, 1566722147799, 7663, 209, true
2771, 1566722147665, 7529, 1566722147873, 7737, 208, true
2772, 1566722147666, 7530, 1566722147880, 7744, 214, true
2773, 1566722147672, 7536, 1566722147891, 7755, 219, true
2774, 1566722147682, 7546, 1566722147893, 7757, 211, true
2775, 1566722147687, 7551, 1566722147894, 7758, 207, true
2776, 1566722147695, 7559, 1566722147900, 7764, 205, true
2777, 1566722147696, 7560, 1566722147900, 7764, 204, true
2778, 1566722147698, 7562, 1566722147902, 7766, 204, true
2779, 1566722147699, 7563, 1566722147912, 7776, 213, true
2780, 1566722147699, 7563, 1566722147911, 7775, 212, true
2781, 1566722147700, 7564, 1566722147911, 7775, 211, true
2782, 1566722147701, 7565, 1566722147911, 7775, 210, true
2783, 1566722147703, 7567, 1566722147915, 7779, 212, true
2784, 1566722147711, 7575, 1566722147925, 7789, 214, true
2785, 1566722147713, 7577, 1566722147925, 7789, 212, true
2786, 1566722147714, 7578, 1566722147925, 7789, 211, true
2787, 1566722147715, 7579, 1566722147926, 7790, 211, true
2788, 1566722147720, 7584, 1566722147935, 7799, 215, true
2789, 1566722147720, 7584, 1566722147937, 7801, 217, true
2790, 1566722147721, 7585, 1566722147937, 7801, 216, true
2791, 1566722147721, 7585, 1566722147935, 7799, 214, true
2792, 1566722147722, 7586, 1566722147935, 7799, 213, true
2793, 1566722147723, 7587, 1566722147937, 7801, 214, true
2794, 1566722147724, 7588, 1566722147937, 7801, 213, true
2795, 1566722147724, 7588, 1566722147937, 7801, 213, true
2796, 1566722147726, 7590, 1566722147939, 7803, 213, true
2797, 1566722147726, 7590, 1566722147939, 7803, 213, true
2798, 1566722147727, 7591, 1566722147939, 7803, 212, true
2799, 1566722147728, 7592, 1566722147948, 7812, 220, true
2800, 1566722147729, 7593, 1566722147947, 7811, 218, true
2801, 1566722147730, 7594, 1566722147948, 7812, 218, true
2802, 1566722147730, 7594, 1566722147948, 7812, 218, true
2803, 1566722147732, 7596, 1566722147948, 7812, 216, true
2804, 1566722147734, 7598, 1566722147947, 7811, 213, true
2805, 1566722147734, 7598, 1566722147948, 7812, 214, true
2806, 1566722147735, 7599, 1566722147951, 7815, 216, true
2807, 1566722147735, 7599, 1566722147951, 7815, 216, true
2808, 1566722147736, 7600, 1566722147951, 7815, 215, true
2809, 1566722147736, 7600, 1566722147951, 7815, 215, true
2810, 1566722147737, 7601, 1566722147951, 7815, 214, true
2811, 1566722147740, 7604, 1566722147951, 7815, 211, true
2812, 1566722147741, 7605, 1566722147951, 7815, 210, true
2813, 1566722147741, 7605, 1566722147951, 7815, 210, true
2814, 1566722147742, 7606, 1566722147951, 7815, 209, true
2815, 1566722147742, 7606, 1566722147951, 7815, 209, true
2816, 1566722147743, 7607, 1566722147967, 7831, 224, true
2817, 1566722147744, 7608, 1566722147967, 7831, 223, true
2818, 1566722147745, 7609, 1566722147953, 7817, 208, true
2819, 1566722147747, 7611, 1566722147967, 7831, 220, true
2820, 1566722147747, 7611, 1566722147964, 7828, 217, true
2821, 1566722147748, 7612, 1566722147964, 7828, 216, true
2822, 1566722147748, 7612, 1566722147967, 7831, 219, true
2823, 1566722147749, 7613, 1566722147967, 7831, 218, true
2824, 1566722147749, 7613, 1566722147965, 7829, 216, true
2825, 1566722147750, 7614, 1566722147967, 7831, 217, true
2826, 1566722147754, 7618, 1566722147967, 7831, 213, true
2827, 1566722147754, 7618, 1566722147967, 7831, 213, true
2828, 1566722147755, 7619, 1566722147969, 7833, 214, true
2829, 1566722147756, 7620, 1566722147969, 7833, 213, true
2830, 1566722147758, 7622, 1566722147968, 7832, 210, true
2831, 1566722147759, 7623, 1566722147977, 7841, 218, true
2832, 1566722147773, 7637, 1566722147982, 7846, 209, true
2833, 1566722147774, 7638, 1566722147986, 7850, 212, true
2834, 1566722147775, 7639, 1566722147983, 7847, 208, true
2835, 1566722147775, 7639, 1566722147982, 7846, 207, true
2836, 1566722147776, 7640, 1566722147982, 7846, 206, true
2837, 1566722147777, 7641, 1566722147982, 7846, 205, true
2838, 1566722147777, 7641, 1566722147992, 7856, 215, true
2839, 1566722147777, 7641, 1566722147987, 7851, 210, true
2840, 1566722147778, 7642, 1566722147999, 7863, 221, true
2841, 1566722147778, 7642, 1566722147999, 7863, 221, true
2842, 1566722147847, 7711, 1566722148054, 7918, 207, true
2843, 1566722147849, 7713, 1566722148059, 7923, 210, true
2844, 1566722147851, 7715, 1566722148058, 7922, 207, true
2845, 1566722147852, 7716, 1566722148066, 7930, 214, true
2846, 1566722147854, 7718, 1566722148066, 7930, 212, true
2847, 1566722147864, 7728, 1566722148072, 7936, 208, true
2848, 1566722147865, 7729, 1566722148072, 7936, 207, true
2849, 1566722147867, 7731, 1566722148081, 7945, 214, true
2850, 1566722147869, 7733, 1566722148082, 7946, 213, true
2851, 1566722147869, 7733, 1566722148081, 7945, 212, true
2852, 1566722147882, 7746, 1566722148092, 7956, 210, true
2853, 1566722147883, 7747, 1566722148090, 7954, 207, true
2854, 1566722147886, 7750, 1566722148097, 7961, 211, true
2855, 1566722147898, 7762, 1566722148113, 7977, 215, true
2856, 1566722147916, 7780, 1566722148149, 8013, 233, true
2857, 1566722147917, 7781, 1566722148132, 7996, 215, true
2858, 1566722147917, 7781, 1566722148140, 8004, 223, true
2859, 1566722147918, 7782, 1566722148149, 8013, 231, true
2860, 1566722147918, 7782, 1566722148137, 8001, 219, true
2861, 1566722147919, 7783, 1566722148198, 8062, 279, true
2862, 1566722147919, 7783, 1566722148149, 8013, 230, true
2863, 1566722147920, 7784, 1566722148198, 8062, 278, true
2864, 1566722147920, 7784, 1566722148158, 8022, 238, true
2865, 1566722147926, 7790, 1566722148158, 8022, 232, true
2866, 1566722147927, 7791, 1566722148198, 8062, 271, true
2867, 1566722147927, 7791, 1566722148157, 8021, 230, true
2868, 1566722147929, 7793, 1566722148198, 8062, 269, true
2869, 1566722147957, 7821, 1566722148241, 8105, 284, true
2870, 1566722147958, 7822, 1566722148219, 8083, 261, true
2871, 1566722147958, 7822, 1566722148220, 8084, 262, true
2872, 1566722147959, 7823, 1566722148229, 8093, 270, true
2873, 1566722147959, 7823, 1566722148193, 8057, 234, true
2874, 1566722147960, 7824, 1566722148219, 8083, 259, true
2875, 1566722147970, 7834, 1566722148233, 8097, 263, true
2876, 1566722147971, 7835, 1566722148238, 8102, 267, true
2877, 1566722147971, 7835, 1566722148193, 8057, 222, true
2878, 1566722147972, 7836, 1566722148187, 8051, 215, true
2879, 1566722147972, 7836, 1566722148193, 8057, 221, true
2880, 1566722147973, 7837, 1566722148241, 8105, 268, true
2881, 1566722147974, 7838, 1566722148218, 8082, 244, true
2882, 1566722147983, 7847, 1566722148243, 8107, 260, true
2883, 1566722148000, 7864, 1566722148241, 8105, 241, true
2884, 1566722148001, 7865, 1566722148250, 8114, 249, true
2885, 1566722148002, 7866, 1566722148243, 8107, 241, true
2886, 1566722148003, 7867, 1566722148251, 8115, 248, true
2887, 1566722148004, 7868, 1566722148241, 8105, 237, true
2888, 1566722148009, 7873, 1566722148250, 8114, 241, true
2889, 1566722148019, 7883, 1566722148244, 8108, 225, true
2890, 1566722148047, 7911, 1566722148261, 8125, 214, true
2891, 1566722148047, 7911, 1566722148252, 8116, 205, true
2892, 1566722148047, 7911, 1566722148258, 8122, 211, true
2893, 1566722148048, 7912, 1566722148258, 8122, 210, true
2894, 1566722148049, 7913, 1566722148258, 8122, 209, true
2895, 1566722148051, 7915, 1566722148261, 8125, 210, true
2896, 1566722148052, 7916, 1566722148266, 8130, 214, true
2897, 1566722148053, 7917, 1566722148261, 8125, 208, true
2898, 1566722148054, 7918, 1566722148268, 8132, 214, true
2899, 1566722148056, 7920, 1566722148266, 8130, 210, true
2900, 1566722148059, 7923, 1566722148271, 8135, 212, true
2901, 1566722148060, 7924, 1566722148268, 8132, 208, true
2902, 1566722148061, 7925, 1566722148271, 8135, 210, true
2903, 1566722148061, 7925, 1566722148277, 8141, 216, true
2904, 1566722148061, 7925, 1566722148273, 8137, 212, true
2905, 1566722148062, 7926, 1566722148273, 8137, 211, true
2906, 1566722148062, 7926, 1566722148273, 8137, 211, true
2907, 1566722148064, 7928, 1566722148273, 8137, 209, true
2908, 1566722148066, 7930, 1566722148277, 8141, 211, true
2909, 1566722148068, 7932, 1566722148280, 8144, 212, true
2910, 1566722148069, 7933, 1566722148280, 8144, 211, true
2911, 1566722148069, 7933, 1566722148280, 8144, 211, true
2912, 1566722148070, 7934, 1566722148280, 8144, 210, true
2913, 1566722148073, 7937, 1566722148284, 8148, 211, true
2914, 1566722148073, 7937, 1566722148280, 8144, 207, true
2915, 1566722148074, 7938, 1566722148280, 8144, 206, true
2916, 1566722148075, 7939, 1566722148281, 8145, 206, true
2917, 1566722148076, 7940, 1566722148284, 8148, 208, true
2918, 1566722148078, 7942, 1566722148294, 8158, 216, true
2919, 1566722148078, 7942, 1566722148294, 8158, 216, true
2920, 1566722148080, 7944, 1566722148294, 8158, 214, true
2921, 1566722148083, 7947, 1566722148294, 8158, 211, true
2922, 1566722148083, 7947, 1566722148295, 8159, 212, true
2923, 1566722148084, 7948, 1566722148294, 8158, 210, true
2924, 1566722148085, 7949, 1566722148295, 8159, 210, true
2925, 1566722148086, 7950, 1566722148298, 8162, 212, true
2926, 1566722148087, 7951, 1566722148295, 8159, 208, true
2927, 1566722148089, 7953, 1566722148298, 8162, 209, true
2928, 1566722148091, 7955, 1566722148299, 8163, 208, true
2929, 1566722148093, 7957, 1566722148303, 8167, 210, true
2930, 1566722148093, 7957, 1566722148303, 8167, 210, true
2931, 1566722148094, 7958, 1566722148303, 8167, 209, true
2932, 1566722148094, 7958, 1566722148305, 8169, 211, true
2933, 1566722148095, 7959, 1566722148303, 8167, 208, true
2934, 1566722148095, 7959, 1566722148305, 8169, 210, true
2935, 1566722148095, 7959, 1566722148313, 8177, 218, true
2936, 1566722148098, 7962, 1566722148306, 8170, 208, true
2937, 1566722148098, 7962, 1566722148304, 8168, 206, true
2938, 1566722148101, 7965, 1566722148310, 8174, 209, true
2939, 1566722148102, 7966, 1566722148310, 8174, 208, true
2940, 1566722148103, 7967, 1566722148310, 8174, 207, true
2941, 1566722148104, 7968, 1566722148310, 8174, 206, true
2942, 1566722148106, 7970, 1566722148315, 8179, 209, true
2943, 1566722148107, 7971, 1566722148320, 8184, 213, true
2944, 1566722148107, 7971, 1566722148315, 8179, 208, true
2945, 1566722148108, 7972, 1566722148319, 8183, 211, true
2946, 1566722148108, 7972, 1566722148319, 8183, 211, true
2947, 1566722148109, 7973, 1566722148319, 8183, 210, true
2948, 1566722148109, 7973, 1566722148319, 8183, 210, true
2949, 1566722148110, 7974, 1566722148319, 8183, 209, true
2950, 1566722148110, 7974, 1566722148319, 8183, 209, true
2951, 1566722148114, 7978, 1566722148323, 8187, 209, true
2952, 1566722148115, 7979, 1566722148326, 8190, 211, true
2953, 1566722148115, 7979, 1566722148323, 8187, 208, true
2954, 1566722148116, 7980, 1566722148326, 8190, 210, true
2955, 1566722148116, 7980, 1566722148326, 8190, 210, true
2956, 1566722148117, 7981, 1566722148326, 8190, 209, true
2957, 1566722148118, 7982, 1566722148323, 8187, 205, true
2958, 1566722148119, 7983, 1566722148326, 8190, 207, true
2959, 1566722148120, 7984, 1566722148326, 8190, 206, true
2960, 1566722148121, 7985, 1566722148326, 8190, 205, true
2961, 1566722148123, 7987, 1566722148334, 8198, 211, true
2962, 1566722148123, 7987, 1566722148334, 8198, 211, true
2963, 1566722148124, 7988, 1566722148334, 8198, 210, true
2964, 1566722148125, 7989, 1566722148334, 8198, 209, true
2965, 1566722148126, 7990, 1566722148334, 8198, 208, true
2966, 1566722148127, 7991, 1566722148336, 8200, 209, true
2967, 1566722148128, 7992, 1566722148336, 8200, 208, true
2968, 1566722148130, 7994, 1566722148346, 8210, 216, true
2969, 1566722148132, 7996, 1566722148337, 8201, 205, true
2970, 1566722148134, 7998, 1566722148346, 8210, 212, true
2971, 1566722148134, 7998, 1566722148346, 8210, 212, true
2972, 1566722148134, 7998, 1566722148346, 8210, 212, true
2973, 1566722148135, 7999, 1566722148345, 8209, 210, true
2974, 1566722148135, 7999, 1566722148346, 8210, 211, true
2975, 1566722148136, 8000, 1566722148346, 8210, 210, true
2976, 1566722148140, 8004, 1566722148346, 8210, 206, true
2977, 1566722148145, 8009, 1566722148355, 8219, 210, true
2978, 1566722148146, 8010, 1566722148358, 8222, 212, true
2979, 1566722148149, 8013, 1566722148354, 8218, 205, true
2980, 1566722148150, 8014, 1566722148356, 8220, 206, true
2981, 1566722148150, 8014, 1566722148356, 8220, 206, true
2982, 1566722148153, 8017, 1566722148375, 8239, 222, true
2983, 1566722148153, 8017, 1566722148359, 8223, 206, true
2984, 1566722148153, 8017, 1566722148372, 8236, 219, true
2985, 1566722148155, 8019, 1566722148375, 8239, 220, true
2986, 1566722148198, 8062, 1566722148605, 8469, 407, true
2987, 1566722148209, 8073, 1566722148606, 8470, 397, true
2988, 1566722148215, 8079, 1566722148606, 8470, 391, true
2989, 1566722148220, 8084, 1566722148606, 8470, 386, true
2990, 1566722148223, 8087, 1566722148606, 8470, 383, true
2991, 1566722148225, 8089, 1566722148606, 8470, 381, true
2992, 1566722148226, 8090, 1566722148606, 8470, 380, true
2993, 1566722148227, 8091, 1566722148607, 8471, 380, true
2994, 1566722148230, 8094, 1566722148607, 8471, 377, true
2995, 1566722148231, 8095, 1566722148607, 8471, 376, true
2996, 1566722148235, 8099, 1566722148607, 8471, 372, true
2997, 1566722148236, 8100, 1566722148607, 8471, 371, true
2998, 1566722148248, 8112, 1566722148608, 8472, 360, true
2999, 1566722148253, 8117, 1566722148608, 8472, 355, true
3000, 1566722148255, 8119, 1566722148608, 8472, 353, true
3001, 1566722148259, 8123, 1566722148608, 8472, 349, true
3002, 1566722148263, 8127, 1566722148608, 8472, 345, true
3003, 1566722148264, 8128, 1566722148608, 8472, 344, true
3004, 1566722148266, 8130, 1566722148609, 8473, 343, true
3005, 1566722148268, 8132, 1566722148608, 8472, 340, true
3006, 1566722148269, 8133, 1566722148609, 8473, 340, true
3007, 1566722148269, 8133, 1566722148609, 8473, 340, true
3008, 1566722148273, 8137, 1566722148609, 8473, 336, true
3009, 1566722148274, 8138, 1566722148609, 8473, 335, true
3010, 1566722148275, 8139, 1566722148613, 8477, 338, true
3011, 1566722148277, 8141, 1566722148609, 8473, 332, true
3012, 1566722148277, 8141, 1566722148613, 8477, 336, true
3013, 1566722148278, 8142, 1566722148613, 8477, 335, true
3014, 1566722148282, 8146, 1566722148614, 8478, 332, true
3015, 1566722148282, 8146, 1566722148614, 8478, 332, true
3016, 1566722148283, 8147, 1566722148614, 8478, 331, true
3017, 1566722148285, 8149, 1566722148614, 8478, 329, true
3018, 1566722148286, 8150, 1566722148614, 8478, 328, true
3019, 1566722148286, 8150, 1566722148614, 8478, 328, true
3020, 1566722148288, 8152, 1566722148615, 8479, 327, true
3021, 1566722148289, 8153, 1566722148615, 8479, 326, true
3022, 1566722148291, 8155, 1566722148615, 8479, 324, true
3023, 1566722148295, 8159, 1566722148615, 8479, 320, true
3024, 1566722148296, 8160, 1566722148615, 8479, 319, true
3025, 1566722148297, 8161, 1566722148615, 8479, 318, true
3026, 1566722148299, 8163, 1566722148615, 8479, 316, true
3027, 1566722148299, 8163, 1566722148615, 8479, 316, true
3028, 1566722148300, 8164, 1566722148616, 8480, 316, true
3029, 1566722148300, 8164, 1566722148616, 8480, 316, true
3030, 1566722148301, 8165, 1566722148616, 8480, 315, true
3031, 1566722148307, 8171, 1566722148616, 8480, 309, true
3032, 1566722148308, 8172, 1566722148616, 8480, 308, true
3033, 1566722148308, 8172, 1566722148616, 8480, 308, true
3034, 1566722148311, 8175, 1566722148616, 8480, 305, true
3035, 1566722148313, 8177, 1566722148617, 8481, 304, true
3036, 1566722148315, 8179, 1566722148617, 8481, 302, true
3037, 1566722148316, 8180, 1566722148617, 8481, 301, true
3038, 1566722148321, 8185, 1566722148617, 8481, 296, true
3039, 1566722148328, 8192, 1566722148618, 8482, 290, true
3040, 1566722148347, 8211, 1566722148618, 8482, 271, true
3041, 1566722148347, 8211, 1566722148618, 8482, 271, true
3042, 1566722148349, 8213, 1566722148618, 8482, 269, true
3043, 1566722148350, 8214, 1566722148618, 8482, 268, true
3044, 1566722148350, 8214, 1566722148619, 8483, 269, true
3045, 1566722148352, 8216, 1566722148622, 8486, 270, true
3046, 1566722148353, 8217, 1566722148622, 8486, 269, true
3047, 1566722148356, 8220, 1566722148619, 8483, 263, true
3048, 1566722148359, 8223, 1566722148622, 8486, 263, true
3049, 1566722148359, 8223, 1566722148622, 8486, 263, true
3050, 1566722148359, 8223, 1566722148622, 8486, 263, true
3051, 1566722148360, 8224, 1566722148621, 8485, 261, true
3052, 1566722148360, 8224, 1566722148622, 8486, 262, true
3053, 1566722148361, 8225, 1566722148622, 8486, 261, true
3054, 1566722148362, 8226, 1566722148622, 8486, 260, true
3055, 1566722148363, 8227, 1566722148622, 8486, 259, true
3056, 1566722148365, 8229, 1566722148622, 8486, 257, true
3057, 1566722148366, 8230, 1566722148622, 8486, 256, true
3058, 1566722148367, 8231, 1566722148623, 8487, 256, true
3059, 1566722148368, 8232, 1566722148623, 8487, 255, true
3060, 1566722148370, 8234, 1566722148623, 8487, 253, true
3061, 1566722148372, 8236, 1566722148623, 8487, 251, true
3062, 1566722148373, 8237, 1566722148623, 8487, 250, true
3063, 1566722148376, 8240, 1566722148623, 8487, 247, true
3064, 1566722148377, 8241, 1566722148623, 8487, 246, true
3065, 1566722148379, 8243, 1566722148623, 8487, 244, true
3066, 1566722148380, 8244, 1566722148623, 8487, 243, true
3067, 1566722148382, 8246, 1566722148623, 8487, 241, true
3068, 1566722148383, 8247, 1566722148599, 8463, 216, true
3069, 1566722148385, 8249, 1566722148623, 8487, 238, true
3070, 1566722148387, 8251, 1566722148597, 8461, 210, true
3071, 1566722148389, 8253, 1566722148599, 8463, 210, true
3072, 1566722148391, 8255, 1566722148810, 8674, 419, true
3073, 1566722148395, 8259, 1566722148834, 8698, 439, true
3074, 1566722148395, 8259, 1566722148834, 8698, 439, true
3075, 1566722148395, 8259, 1566722148839, 8703, 444, true
3076, 1566722148395, 8259, 1566722148839, 8703, 444, true
3077, 1566722148396, 8260, 1566722148848, 8712, 452, true
3078, 1566722148396, 8260, 1566722148848, 8712, 452, true
3079, 1566722148396, 8260, 1566722148839, 8703, 443, true
3080, 1566722148396, 8260, 1566722148843, 8707, 447, true
3081, 1566722148396, 8260, 1566722148605, 8469, 209, true
3082, 1566722148396, 8260, 1566722148604, 8468, 208, true
3083, 1566722148398, 8262, 1566722148605, 8469, 207, true
3084, 1566722148399, 8263, 1566722148606, 8470, 207, true
3085, 1566722148400, 8264, 1566722148608, 8472, 208, true
3086, 1566722148402, 8266, 1566722148613, 8477, 211, true
3087, 1566722148402, 8266, 1566722148618, 8482, 216, true
3088, 1566722148403, 8267, 1566722148614, 8478, 211, true
3089, 1566722148405, 8269, 1566722148617, 8481, 212, true
3090, 1566722148407, 8271, 1566722148617, 8481, 210, true
3091, 1566722148407, 8271, 1566722148614, 8478, 207, true
3092, 1566722148408, 8272, 1566722148621, 8485, 213, true
3093, 1566722148409, 8273, 1566722148621, 8485, 212, true
3094, 1566722148410, 8274, 1566722148618, 8482, 208, true
3095, 1566722148412, 8276, 1566722148621, 8485, 209, true
3096, 1566722148412, 8276, 1566722148619, 8483, 207, true
3097, 1566722148413, 8277, 1566722148621, 8485, 208, true
3098, 1566722148415, 8279, 1566722148631, 8495, 216, true
3099, 1566722148415, 8279, 1566722148631, 8495, 216, true
3100, 1566722148416, 8280, 1566722148631, 8495, 215, true
3101, 1566722148417, 8281, 1566722148631, 8495, 214, true
3102, 1566722148419, 8283, 1566722148631, 8495, 212, true
3103, 1566722148421, 8285, 1566722148631, 8495, 210, true
3104, 1566722148421, 8285, 1566722148631, 8495, 210, true
3105, 1566722148422, 8286, 1566722148631, 8495, 209, true
3106, 1566722148423, 8287, 1566722148632, 8496, 209, true
3107, 1566722148424, 8288, 1566722148639, 8503, 215, true
3108, 1566722148424, 8288, 1566722148633, 8497, 209, true
3109, 1566722148425, 8289, 1566722148636, 8500, 211, true
3110, 1566722148426, 8290, 1566722148639, 8503, 213, true
3111, 1566722148427, 8291, 1566722148640, 8504, 213, true
3112, 1566722148428, 8292, 1566722148633, 8497, 205, true
3113, 1566722148430, 8294, 1566722148651, 8515, 221, true
3114, 1566722148431, 8295, 1566722148650, 8514, 219, true
3115, 1566722148433, 8297, 1566722148651, 8515, 218, true
3116, 1566722148438, 8302, 1566722148651, 8515, 213, true
3117, 1566722148440, 8304, 1566722148646, 8510, 206, true
3118, 1566722148441, 8305, 1566722148646, 8510, 205, true
3119, 1566722148442, 8306, 1566722148651, 8515, 209, true
3120, 1566722148442, 8306, 1566722148646, 8510, 204, true
3121, 1566722148443, 8307, 1566722148652, 8516, 209, true
3122, 1566722148444, 8308, 1566722148651, 8515, 207, true
3123, 1566722148446, 8310, 1566722148658, 8522, 212, true
3124, 1566722148446, 8310, 1566722148658, 8522, 212, true
3125, 1566722148446, 8310, 1566722148658, 8522, 212, true
3126, 1566722148449, 8313, 1566722148658, 8522, 209, true
3127, 1566722148451, 8315, 1566722148658, 8522, 207, true
3128, 1566722148452, 8316, 1566722148659, 8523, 207, true
3129, 1566722148453, 8317, 1566722148659, 8523, 206, true
3130, 1566722148455, 8319, 1566722148668, 8532, 213, true
3131, 1566722148456, 8320, 1566722148670, 8534, 214, true
3132, 1566722148459, 8323, 1566722148668, 8532, 209, true
3133, 1566722148460, 8324, 1566722148670, 8534, 210, true
3134, 1566722148462, 8326, 1566722148680, 8544, 218, true
3135, 1566722148462, 8326, 1566722148680, 8544, 218, true
3136, 1566722148463, 8327, 1566722148674, 8538, 211, true
3137, 1566722148463, 8327, 1566722148674, 8538, 211, true
3138, 1566722148465, 8329, 1566722148680, 8544, 215, true
3139, 1566722148467, 8331, 1566722148680, 8544, 213, true
3140, 1566722148469, 8333, 1566722148680, 8544, 211, true
3141, 1566722148473, 8337, 1566722148680, 8544, 207, true
3142, 1566722148474, 8338, 1566722148680, 8544, 206, true
3143, 1566722148474, 8338, 1566722148691, 8555, 217, true
3144, 1566722148477, 8341, 1566722148691, 8555, 214, true
3145, 1566722148481, 8345, 1566722148691, 8555, 210, true
3146, 1566722148482, 8346, 1566722148691, 8555, 209, true
3147, 1566722148484, 8348, 1566722148691, 8555, 207, true
3148, 1566722148485, 8349, 1566722148691, 8555, 206, true
3149, 1566722148487, 8351, 1566722148697, 8561, 210, true
3150, 1566722148488, 8352, 1566722148700, 8564, 212, true
3151, 1566722148493, 8357, 1566722148697, 8561, 204, true
3152, 1566722148494, 8358, 1566722148700, 8564, 206, true
3153, 1566722148495, 8359, 1566722148702, 8566, 207, true
3154, 1566722148495, 8359, 1566722148702, 8566, 207, true
3155, 1566722148497, 8361, 1566722148713, 8577, 216, true
3156, 1566722148499, 8363, 1566722148712, 8576, 213, true
3157, 1566722148502, 8366, 1566722148713, 8577, 211, true
3158, 1566722148503, 8367, 1566722148713, 8577, 210, true
3159, 1566722148505, 8369, 1566722148713, 8577, 208, true
3160, 1566722148506, 8370, 1566722148716, 8580, 210, true
3161, 1566722148508, 8372, 1566722148730, 8594, 222, true
3162, 1566722148508, 8372, 1566722148724, 8588, 216, true
3163, 1566722148511, 8375, 1566722148729, 8593, 218, true
3164, 1566722148513, 8377, 1566722148729, 8593, 216, true
3165, 1566722148515, 8379, 1566722148724, 8588, 209, true
3166, 1566722148516, 8380, 1566722148739, 8603, 223, true
3167, 1566722148517, 8381, 1566722148734, 8598, 217, true
3168, 1566722148518, 8382, 1566722148739, 8603, 221, true
3169, 1566722148518, 8382, 1566722148739, 8603, 221, true
3170, 1566722148519, 8383, 1566722148734, 8598, 215, true
3171, 1566722148524, 8388, 1566722148739, 8603, 215, true
3172, 1566722148525, 8389, 1566722148739, 8603, 214, true
3173, 1566722148526, 8390, 1566722148739, 8603, 213, true
3174, 1566722148527, 8391, 1566722148739, 8603, 212, true
3175, 1566722148528, 8392, 1566722148739, 8603, 211, true
3176, 1566722148529, 8393, 1566722148739, 8603, 210, true
3177, 1566722148531, 8395, 1566722148739, 8603, 208, true
3178, 1566722148531, 8395, 1566722148739, 8603, 208, true
3179, 1566722148545, 8409, 1566722148748, 8612, 203, true
3180, 1566722148547, 8411, 1566722148753, 8617, 206, true
3181, 1566722148549, 8413, 1566722148753, 8617, 204, true
3182, 1566722148551, 8415, 1566722148760, 8624, 209, true
3183, 1566722148557, 8421, 1566722148764, 8628, 207, true
3184, 1566722148559, 8423, 1566722148779, 8643, 220, true
3185, 1566722148570, 8434, 1566722148779, 8643, 209, true
3186, 1566722148575, 8439, 1566722148780, 8644, 205, true
3187, 1566722148577, 8441, 1566722148782, 8646, 205, true
3188, 1566722148579, 8443, 1566722148791, 8655, 212, true
3189, 1566722148580, 8444, 1566722148785, 8649, 205, true
3190, 1566722148581, 8445, 1566722148791, 8655, 210, true
3191, 1566722148583, 8447, 1566722148797, 8661, 214, true
3192, 1566722148586, 8450, 1566722148797, 8661, 211, true
3193, 1566722148589, 8453, 1566722149022, 8886, 433, true
3194, 1566722148644, 8508, 1566722148851, 8715, 207, true
3195, 1566722148647, 8511, 1566722148850, 8714, 203, true
3196, 1566722148647, 8511, 1566722148855, 8719, 208, true
3197, 1566722148648, 8512, 1566722148855, 8719, 207, true
3198, 1566722148654, 8518, 1566722148864, 8728, 210, true
3199, 1566722148654, 8518, 1566722148858, 8722, 204, true
3200, 1566722148654, 8518, 1566722148870, 8734, 216, true
3201, 1566722148655, 8519, 1566722148864, 8728, 209, true
3202, 1566722148655, 8519, 1566722148862, 8726, 207, true
3203, 1566722148655, 8519, 1566722148864, 8728, 209, true
3204, 1566722148660, 8524, 1566722148864, 8728, 204, true
3205, 1566722148662, 8526, 1566722148870, 8734, 208, true
3206, 1566722148662, 8526, 1566722148870, 8734, 208, true
3207, 1566722148663, 8527, 1566722148867, 8731, 204, true
3208, 1566722148663, 8527, 1566722148870, 8734, 207, true
3209, 1566722148664, 8528, 1566722148871, 8735, 207, true
3210, 1566722148665, 8529, 1566722148871, 8735, 206, true
3211, 1566722148666, 8530, 1566722148871, 8735, 205, true
3212, 1566722148668, 8532, 1566722148871, 8735, 203, true
3213, 1566722148668, 8532, 1566722148873, 8737, 205, true
3214, 1566722148669, 8533, 1566722148873, 8737, 204, true
3215, 1566722148671, 8535, 1566722148874, 8738, 203, true
3216, 1566722148671, 8535, 1566722148881, 8745, 210, true
3217, 1566722148672, 8536, 1566722148876, 8740, 204, true
3218, 1566722148674, 8538, 1566722148881, 8745, 207, true
3219, 1566722148675, 8539, 1566722148881, 8745, 206, true
3220, 1566722148675, 8539, 1566722148881, 8745, 206, true
3221, 1566722148676, 8540, 1566722148884, 8748, 208, true
3222, 1566722148681, 8545, 1566722148891, 8755, 210, true
3223, 1566722148682, 8546, 1566722148890, 8754, 208, true
3224, 1566722148682, 8546, 1566722148893, 8757, 211, true
3225, 1566722148683, 8547, 1566722148890, 8754, 207, true
3226, 1566722148684, 8548, 1566722148893, 8757, 209, true
3227, 1566722148686, 8550, 1566722148897, 8761, 211, true
3228, 1566722148687, 8551, 1566722148899, 8763, 212, true
3229, 1566722148687, 8551, 1566722148897, 8761, 210, true
3230, 1566722148688, 8552, 1566722148899, 8763, 211, true
3231, 1566722148688, 8552, 1566722148899, 8763, 211, true
3232, 1566722148691, 8555, 1566722148899, 8763, 208, true
3233, 1566722148692, 8556, 1566722148899, 8763, 207, true
3234, 1566722148695, 8559, 1566722148904, 8768, 209, true
3235, 1566722148695, 8559, 1566722148904, 8768, 209, true
3236, 1566722148697, 8561, 1566722148904, 8768, 207, true
3237, 1566722148697, 8561, 1566722148910, 8774, 213, true
3238, 1566722148698, 8562, 1566722148915, 8779, 217, true
3239, 1566722148698, 8562, 1566722148915, 8779, 217, true
3240, 1566722148700, 8564, 1566722148917, 8781, 217, true
3241, 1566722148702, 8566, 1566722148924, 8788, 222, true
3242, 1566722148706, 8570, 1566722148924, 8788, 218, true
3243, 1566722148721, 8585, 1566722148943, 8807, 222, true
3244, 1566722148722, 8586, 1566722148943, 8807, 221, true
3245, 1566722148730, 8594, 1566722148951, 8815, 221, true
3246, 1566722148731, 8595, 1566722148951, 8815, 220, true
3247, 1566722148731, 8595, 1566722148952, 8816, 221, true
3248, 1566722148732, 8596, 1566722148943, 8807, 211, true
3249, 1566722148732, 8596, 1566722148962, 8826, 230, true
3250, 1566722148732, 8596, 1566722148952, 8816, 220, true
3251, 1566722148740, 8604, 1566722148963, 8827, 223, true
3252, 1566722148741, 8605, 1566722148962, 8826, 221, true
3253, 1566722148743, 8607, 1566722148962, 8826, 219, true
3254, 1566722148744, 8608, 1566722148963, 8827, 219, true
3255, 1566722148744, 8608, 1566722148969, 8833, 225, true
3256, 1566722148745, 8609, 1566722148969, 8833, 224, true
3257, 1566722148746, 8610, 1566722148969, 8833, 223, true
3258, 1566722148747, 8611, 1566722148969, 8833, 222, true
3259, 1566722148749, 8613, 1566722148970, 8834, 221, true
3260, 1566722148749, 8613, 1566722148970, 8834, 221, true
3261, 1566722148749, 8613, 1566722148970, 8834, 221, true
3262, 1566722148750, 8614, 1566722148970, 8834, 220, true
3263, 1566722148751, 8615, 1566722148970, 8834, 219, true
3264, 1566722148755, 8619, 1566722148979, 8843, 224, true
3265, 1566722148755, 8619, 1566722148979, 8843, 224, true
3266, 1566722148755, 8619, 1566722148980, 8844, 225, true
3267, 1566722148756, 8620, 1566722148980, 8844, 224, true
3268, 1566722148757, 8621, 1566722148980, 8844, 223, true
3269, 1566722148759, 8623, 1566722148980, 8844, 221, true
3270, 1566722148762, 8626, 1566722148980, 8844, 218, true
3271, 1566722148762, 8626, 1566722148987, 8851, 225, true
3272, 1566722148763, 8627, 1566722148981, 8845, 218, true
3273, 1566722148764, 8628, 1566722148980, 8844, 216, true
3274, 1566722148765, 8629, 1566722148981, 8845, 216, true
3275, 1566722148766, 8630, 1566722148987, 8851, 221, true
3276, 1566722148766, 8630, 1566722148987, 8851, 221, true
3277, 1566722148767, 8631, 1566722148988, 8852, 221, true
3278, 1566722148768, 8632, 1566722148987, 8851, 219, true
3279, 1566722148769, 8633, 1566722148987, 8851, 218, true
3280, 1566722148770, 8634, 1566722148981, 8845, 211, true
3281, 1566722148773, 8637, 1566722148988, 8852, 215, true
3282, 1566722148773, 8637, 1566722148987, 8851, 214, true
3283, 1566722148773, 8637, 1566722148987, 8851, 214, true
3284, 1566722148774, 8638, 1566722148988, 8852, 214, true
3285, 1566722148775, 8639, 1566722148988, 8852, 213, true
3286, 1566722148776, 8640, 1566722148988, 8852, 212, true
3287, 1566722148777, 8641, 1566722148988, 8852, 211, true
3288, 1566722148780, 8644, 1566722148988, 8852, 208, true
3289, 1566722148781, 8645, 1566722148988, 8852, 207, true
3290, 1566722148782, 8646, 1566722148995, 8859, 213, true
3291, 1566722148782, 8646, 1566722148992, 8856, 210, true
3292, 1566722148828, 8692, 1566722149038, 8902, 210, true
3293, 1566722148829, 8693, 1566722149038, 8902, 209, true
3294, 1566722148830, 8694, 1566722149047, 8911, 217, true
3295, 1566722148832, 8696, 1566722149047, 8911, 215, true
3296, 1566722148834, 8698, 1566722149047, 8911, 213, true
3297, 1566722148836, 8700, 1566722149048, 8912, 212, true
3298, 1566722148837, 8701, 1566722149055, 8919, 218, true
3299, 1566722148840, 8704, 1566722149055, 8919, 215, true
3300, 1566722148841, 8705, 1566722149056, 8920, 215, true
3301, 1566722148843, 8707, 1566722149055, 8919, 212, true
3302, 1566722148844, 8708, 1566722149074, 8938, 230, true
3303, 1566722148849, 8713, 1566722149075, 8939, 226, true
3304, 1566722148851, 8715, 1566722149075, 8939, 224, true
3305, 1566722148853, 8717, 1566722149074, 8938, 221, true
3306, 1566722148857, 8721, 1566722149096, 8960, 239, true
3307, 1566722148859, 8723, 1566722149087, 8951, 228, true
3308, 1566722148860, 8724, 1566722149096, 8960, 236, true
3309, 1566722148865, 8729, 1566722149096, 8960, 231, true
3310, 1566722148867, 8731, 1566722149096, 8960, 229, true
3311, 1566722148877, 8741, 1566722149095, 8959, 218, true
3312, 1566722148879, 8743, 1566722149095, 8959, 216, true
3313, 1566722148883, 8747, 1566722149096, 8960, 213, true
3314, 1566722148885, 8749, 1566722149095, 8959, 210, true
3315, 1566722148885, 8749, 1566722149096, 8960, 211, true
3316, 1566722148886, 8750, 1566722149096, 8960, 210, true
3317, 1566722148887, 8751, 1566722149096, 8960, 209, true
3318, 1566722148887, 8751, 1566722149096, 8960, 209, true
3319, 1566722148888, 8752, 1566722149096, 8960, 208, true
3320, 1566722148888, 8752, 1566722149096, 8960, 208, true
3321, 1566722148892, 8756, 1566722149096, 8960, 204, true
3322, 1566722148893, 8757, 1566722149098, 8962, 205, true
3323, 1566722148894, 8758, 1566722149101, 8965, 207, true
3324, 1566722148894, 8758, 1566722149101, 8965, 207, true
3325, 1566722148895, 8759, 1566722149107, 8971, 212, true
3326, 1566722148895, 8759, 1566722149107, 8971, 212, true
3327, 1566722148900, 8764, 1566722149107, 8971, 207, true
3328, 1566722148901, 8765, 1566722149107, 8971, 206, true
3329, 1566722148904, 8768, 1566722149110, 8974, 206, true
3330, 1566722148907, 8771, 1566722149112, 8976, 205, true
3331, 1566722148907, 8771, 1566722149113, 8977, 206, true
3332, 1566722148911, 8775, 1566722149121, 8985, 210, true
3333, 1566722148911, 8775, 1566722149126, 8990, 215, true
3334, 1566722148912, 8776, 1566722149131, 8995, 219, true
3335, 1566722148912, 8776, 1566722149141, 9005, 229, true
3336, 1566722148919, 8783, 1566722149130, 8994, 211, true
3337, 1566722149013, 8877, 1566722149222, 9086, 209, true
3338, 1566722149013, 8877, 1566722149222, 9086, 209, true
3339, 1566722149014, 8878, 1566722149222, 9086, 208, true
3340, 1566722149014, 8878, 1566722149222, 9086, 208, true
3341, 1566722149014, 8878, 1566722149222, 9086, 208, true
3342, 1566722149014, 8878, 1566722149223, 9087, 209, true
3343, 1566722149015, 8879, 1566722149223, 9087, 208, true
3344, 1566722149016, 8880, 1566722149222, 9086, 206, true
3345, 1566722149019, 8883, 1566722149224, 9088, 205, true
3346, 1566722149021, 8885, 1566722149228, 9092, 207, true
3347, 1566722149023, 8887, 1566722149228, 9092, 205, true
3348, 1566722149023, 8887, 1566722149228, 9092, 205, true
3349, 1566722149024, 8888, 1566722149228, 9092, 204, true
3350, 1566722149026, 8890, 1566722149230, 9094, 204, true
3351, 1566722149026, 8890, 1566722149230, 9094, 204, true
3352, 1566722149028, 8892, 1566722149232, 9096, 204, true
3353, 1566722149030, 8894, 1566722149241, 9105, 211, true
3354, 1566722149031, 8895, 1566722149241, 9105, 210, true
3355, 1566722149032, 8896, 1566722149239, 9103, 207, true
3356, 1566722149034, 8898, 1566722149267, 9131, 233, true
3357, 1566722149038, 8902, 1566722149247, 9111, 209, true
3358, 1566722149039, 8903, 1566722149267, 9131, 228, true
3359, 1566722149040, 8904, 1566722149259, 9123, 219, true
3360, 1566722149042, 8906, 1566722149267, 9131, 225, true
3361, 1566722149050, 8914, 1566722149267, 9131, 217, true
3362, 1566722149054, 8918, 1566722149267, 9131, 213, true
3363, 1566722149056, 8920, 1566722149267, 9131, 211, true
3364, 1566722149057, 8921, 1566722149267, 9131, 210, true
3365, 1566722149076, 8940, 1566722149413, 9277, 337, true
3366, 1566722149077, 8941, 1566722149409, 9273, 332, true
3367, 1566722149078, 8942, 1566722149414, 9278, 336, true
3368, 1566722149078, 8942, 1566722149409, 9273, 331, true
3369, 1566722149078, 8942, 1566722149415, 9279, 337, true
3370, 1566722149078, 8942, 1566722149409, 9273, 331, true
3371, 1566722149078, 8942, 1566722149413, 9277, 335, true
3372, 1566722149081, 8945, 1566722149413, 9277, 332, true
3373, 1566722149083, 8947, 1566722149408, 9272, 325, true
3374, 1566722149087, 8951, 1566722149408, 9272, 321, true
3375, 1566722149089, 8953, 1566722149408, 9272, 319, true
3376, 1566722149090, 8954, 1566722149408, 9272, 318, true
3377, 1566722149098, 8962, 1566722149408, 9272, 310, true
3378, 1566722149098, 8962, 1566722149407, 9271, 309, true
3379, 1566722149099, 8963, 1566722149407, 9271, 308, true
3380, 1566722149101, 8965, 1566722149408, 9272, 307, true
3381, 1566722149102, 8966, 1566722149408, 9272, 306, true
3382, 1566722149102, 8966, 1566722149407, 9271, 305, true
3383, 1566722149103, 8967, 1566722149408, 9272, 305, true
3384, 1566722149104, 8968, 1566722149407, 9271, 303, true
3385, 1566722149104, 8968, 1566722149407, 9271, 303, true
3386, 1566722149104, 8968, 1566722149407, 9271, 303, true
3387, 1566722149107, 8971, 1566722149407, 9271, 300, true
3388, 1566722149108, 8972, 1566722149416, 9280, 308, true
3389, 1566722149108, 8972, 1566722149407, 9271, 299, true
3390, 1566722149109, 8973, 1566722149406, 9270, 297, true
3391, 1566722149109, 8973, 1566722149406, 9270, 297, true
3392, 1566722149111, 8975, 1566722149406, 9270, 295, true
3393, 1566722149113, 8977, 1566722149406, 9270, 293, true
3394, 1566722149113, 8977, 1566722149406, 9270, 293, true
3395, 1566722149114, 8978, 1566722149406, 9270, 292, true
3396, 1566722149114, 8978, 1566722149405, 9269, 291, true
3397, 1566722149115, 8979, 1566722149405, 9269, 290, true
3398, 1566722149116, 8980, 1566722149405, 9269, 289, true
3399, 1566722149116, 8980, 1566722149406, 9270, 290, true
3400, 1566722149117, 8981, 1566722149406, 9270, 289, true
3401, 1566722149118, 8982, 1566722149405, 9269, 287, true
3402, 1566722149119, 8983, 1566722149405, 9269, 286, true
3403, 1566722149121, 8985, 1566722149404, 9268, 283, true
3404, 1566722149121, 8985, 1566722149405, 9269, 284, true
3405, 1566722149122, 8986, 1566722149405, 9269, 283, true
3406, 1566722149123, 8987, 1566722149405, 9269, 282, true
3407, 1566722149124, 8988, 1566722149404, 9268, 280, true
3408, 1566722149126, 8990, 1566722149404, 9268, 278, true
3409, 1566722149126, 8990, 1566722149404, 9268, 278, true
3410, 1566722149127, 8991, 1566722149404, 9268, 277, true
3411, 1566722149127, 8991, 1566722149404, 9268, 277, true
3412, 1566722149129, 8993, 1566722149404, 9268, 275, true
3413, 1566722149130, 8994, 1566722149403, 9267, 273, true
3414, 1566722149132, 8996, 1566722149403, 9267, 271, true
3415, 1566722149132, 8996, 1566722149403, 9267, 271, true
3416, 1566722149133, 8997, 1566722149404, 9268, 271, true
3417, 1566722149133, 8997, 1566722149404, 9268, 271, true
3418, 1566722149134, 8998, 1566722149403, 9267, 269, true
3419, 1566722149134, 8998, 1566722149403, 9267, 269, true
3420, 1566722149135, 8999, 1566722149403, 9267, 268, true
3421, 1566722149136, 9000, 1566722149403, 9267, 267, true
3422, 1566722149137, 9001, 1566722149403, 9267, 266, true
3423, 1566722149138, 9002, 1566722149402, 9266, 264, true
3424, 1566722149139, 9003, 1566722149402, 9266, 263, true
3425, 1566722149139, 9003, 1566722149403, 9267, 264, true
3426, 1566722149141, 9005, 1566722149402, 9266, 261, true
3427, 1566722149141, 9005, 1566722149402, 9266, 261, true
3428, 1566722149142, 9006, 1566722149402, 9266, 260, true
3429, 1566722149143, 9007, 1566722149402, 9266, 259, true
3430, 1566722149144, 9008, 1566722149401, 9265, 257, true
3431, 1566722149145, 9009, 1566722149402, 9266, 257, true
3432, 1566722149147, 9011, 1566722149401, 9265, 254, true
3433, 1566722149149, 9013, 1566722149401, 9265, 252, true
3434, 1566722149153, 9017, 1566722149364, 9228, 211, true
3435, 1566722149154, 9018, 1566722149364, 9228, 210, true
3436, 1566722149154, 9018, 1566722149364, 9228, 210, true
3437, 1566722149155, 9019, 1566722149366, 9230, 211, true
3438, 1566722149156, 9020, 1566722149366, 9230, 210, true
3439, 1566722149157, 9021, 1566722149366, 9230, 209, true
3440, 1566722149158, 9022, 1566722149366, 9230, 208, true
3441, 1566722149159, 9023, 1566722149366, 9230, 207, true
3442, 1566722149160, 9024, 1566722149366, 9230, 206, true
3443, 1566722149160, 9024, 1566722149366, 9230, 206, true
3444, 1566722149161, 9025, 1566722149372, 9236, 211, true
3445, 1566722149162, 9026, 1566722149370, 9234, 208, true
3446, 1566722149162, 9026, 1566722149369, 9233, 207, true
3447, 1566722149163, 9027, 1566722149372, 9236, 209, true
3448, 1566722149164, 9028, 1566722149370, 9234, 206, true
3449, 1566722149166, 9030, 1566722149501, 9365, 335, true
3450, 1566722149167, 9031, 1566722149501, 9365, 334, true
3451, 1566722149167, 9031, 1566722149501, 9365, 334, true
3452, 1566722149168, 9032, 1566722149501, 9365, 333, true
3453, 1566722149168, 9032, 1566722149501, 9365, 333, true
3454, 1566722149168, 9032, 1566722149501, 9365, 333, true
3455, 1566722149169, 9033, 1566722149501, 9365, 332, true
3456, 1566722149170, 9034, 1566722149502, 9366, 332, true
3457, 1566722149170, 9034, 1566722149500, 9364, 330, true
3458, 1566722149170, 9034, 1566722149501, 9365, 331, true
3459, 1566722149171, 9035, 1566722149501, 9365, 330, true
3460, 1566722149171, 9035, 1566722149501, 9365, 330, true
3461, 1566722149171, 9035, 1566722149501, 9365, 330, true
3462, 1566722149172, 9036, 1566722149502, 9366, 330, true
3463, 1566722149172, 9036, 1566722149500, 9364, 328, true
3464, 1566722149172, 9036, 1566722149501, 9365, 329, true
3465, 1566722149173, 9037, 1566722149498, 9362, 325, true
3466, 1566722149173, 9037, 1566722149501, 9365, 328, true
3467, 1566722149174, 9038, 1566722149501, 9365, 327, true
3468, 1566722149175, 9039, 1566722149501, 9365, 326, true
3469, 1566722149177, 9041, 1566722149497, 9361, 320, true
3470, 1566722149181, 9045, 1566722149502, 9366, 321, true
3471, 1566722149181, 9045, 1566722149502, 9366, 321, true
3472, 1566722149182, 9046, 1566722149503, 9367, 321, true
3473, 1566722149183, 9047, 1566722149502, 9366, 319, true
3474, 1566722149184, 9048, 1566722149502, 9366, 318, true
3475, 1566722149185, 9049, 1566722149502, 9366, 317, true
3476, 1566722149185, 9049, 1566722149503, 9367, 318, true
3477, 1566722149186, 9050, 1566722149513, 9377, 327, true
3478, 1566722149187, 9051, 1566722149502, 9366, 315, true
3479, 1566722149188, 9052, 1566722149502, 9366, 314, true
3480, 1566722149189, 9053, 1566722149502, 9366, 313, true
3481, 1566722149190, 9054, 1566722149502, 9366, 312, true
3482, 1566722149191, 9055, 1566722149513, 9377, 322, true
3483, 1566722149192, 9056, 1566722149502, 9366, 310, true
3484, 1566722149193, 9057, 1566722149489, 9353, 296, true
3485, 1566722149194, 9058, 1566722149489, 9353, 295, true
3486, 1566722149194, 9058, 1566722149502, 9366, 308, true
3487, 1566722149195, 9059, 1566722149502, 9366, 307, true
3488, 1566722149197, 9061, 1566722149489, 9353, 292, true
3489, 1566722149197, 9061, 1566722149489, 9353, 292, true
3490, 1566722149198, 9062, 1566722149502, 9366, 304, true
3491, 1566722149198, 9062, 1566722149502, 9366, 304, true
3492, 1566722149199, 9063, 1566722149502, 9366, 303, true
3493, 1566722149199, 9063, 1566722149502, 9366, 303, true
3494, 1566722149199, 9063, 1566722149503, 9367, 304, true
3495, 1566722149200, 9064, 1566722149516, 9380, 316, true
3496, 1566722149201, 9065, 1566722149503, 9367, 302, true
3497, 1566722149202, 9066, 1566722149502, 9366, 300, true
3498, 1566722149204, 9068, 1566722149489, 9353, 285, true
3499, 1566722149206, 9070, 1566722149489, 9353, 283, true
3500, 1566722149207, 9071, 1566722149489, 9353, 282, true
3501, 1566722149207, 9071, 1566722149489, 9353, 282, true
3502, 1566722149208, 9072, 1566722149489, 9353, 281, true
3503, 1566722149208, 9072, 1566722149489, 9353, 281, true
3504, 1566722149209, 9073, 1566722149489, 9353, 280, true
3505, 1566722149211, 9075, 1566722149488, 9352, 277, true
3506, 1566722149213, 9077, 1566722149488, 9352, 275, true
3507, 1566722149213, 9077, 1566722149488, 9352, 275, true
3508, 1566722149214, 9078, 1566722149489, 9353, 275, true
3509, 1566722149214, 9078, 1566722149488, 9352, 274, true
3510, 1566722149215, 9079, 1566722149488, 9352, 273, true
3511, 1566722149216, 9080, 1566722149516, 9380, 300, true
3512, 1566722149216, 9080, 1566722149488, 9352, 272, true
3513, 1566722149216, 9080, 1566722149488, 9352, 272, true
3514, 1566722149218, 9082, 1566722149488, 9352, 270, true
3515, 1566722149221, 9085, 1566722149488, 9352, 267, true
3516, 1566722149231, 9095, 1566722149488, 9352, 257, true
3517, 1566722149232, 9096, 1566722149488, 9352, 256, true
3518, 1566722149233, 9097, 1566722149481, 9345, 248, true
3519, 1566722149234, 9098, 1566722149481, 9345, 247, true
3520, 1566722149234, 9098, 1566722149488, 9352, 254, true
3521, 1566722149234, 9098, 1566722149481, 9345, 247, true
3522, 1566722149236, 9100, 1566722149487, 9351, 251, true
3523, 1566722149236, 9100, 1566722149488, 9352, 252, true
3524, 1566722149237, 9101, 1566722149481, 9345, 244, true
3525, 1566722149239, 9103, 1566722149487, 9351, 248, true
3526, 1566722149242, 9106, 1566722149481, 9345, 239, true
3527, 1566722149242, 9106, 1566722149481, 9345, 239, true
3528, 1566722149243, 9107, 1566722149588, 9452, 345, true
3529, 1566722149243, 9107, 1566722149607, 9471, 364, true
3530, 1566722149243, 9107, 1566722149590, 9454, 347, true
3531, 1566722149244, 9108, 1566722149589, 9453, 345, true
3532, 1566722149244, 9108, 1566722149609, 9473, 365, true
3533, 1566722149245, 9109, 1566722149481, 9345, 236, true
3534, 1566722149246, 9110, 1566722149481, 9345, 235, true
3535, 1566722149247, 9111, 1566722149472, 9336, 225, true
3536, 1566722149247, 9111, 1566722149589, 9453, 342, true
3537, 1566722149247, 9111, 1566722149516, 9380, 269, true
3538, 1566722149248, 9112, 1566722149478, 9342, 230, true
3539, 1566722149248, 9112, 1566722149516, 9380, 268, true
3540, 1566722149248, 9112, 1566722149589, 9453, 341, true
3541, 1566722149249, 9113, 1566722149588, 9452, 339, true
3542, 1566722149249, 9113, 1566722149588, 9452, 339, true
3543, 1566722149249, 9113, 1566722149608, 9472, 359, true
3544, 1566722149250, 9114, 1566722149610, 9474, 360, true
3545, 1566722149250, 9114, 1566722149605, 9469, 355, true
3546, 1566722149250, 9114, 1566722149478, 9342, 228, true
3547, 1566722149250, 9114, 1566722149587, 9451, 337, true
3548, 1566722149250, 9114, 1566722149478, 9342, 228, true
3549, 1566722149250, 9114, 1566722149607, 9471, 357, true
3550, 1566722149250, 9114, 1566722149481, 9345, 231, true
3551, 1566722149250, 9114, 1566722149516, 9380, 266, true
3552, 1566722149250, 9114, 1566722149481, 9345, 231, true
3553, 1566722149251, 9115, 1566722149609, 9473, 358, true
3554, 1566722149251, 9115, 1566722149588, 9452, 337, true
3555, 1566722149251, 9115, 1566722149588, 9452, 337, true
3556, 1566722149251, 9115, 1566722149588, 9452, 337, true
3557, 1566722149251, 9115, 1566722149589, 9453, 338, true
3558, 1566722149251, 9115, 1566722149516, 9380, 265, true
3559, 1566722149251, 9115, 1566722149480, 9344, 229, true
3560, 1566722149251, 9115, 1566722149593, 9457, 342, true
3561, 1566722149251, 9115, 1566722149481, 9345, 230, true
3562, 1566722149255, 9119, 1566722149588, 9452, 333, true
3563, 1566722149256, 9120, 1566722149610, 9474, 354, true
3564, 1566722149256, 9120, 1566722149608, 9472, 352, true
3565, 1566722149257, 9121, 1566722149589, 9453, 332, true
3566, 1566722149258, 9122, 1566722149571, 9435, 313, true
3567, 1566722149259, 9123, 1566722149588, 9452, 329, true
3568, 1566722149260, 9124, 1566722149609, 9473, 349, true
3569, 1566722149261, 9125, 1566722149481, 9345, 220, true
3570, 1566722149261, 9125, 1566722149477, 9341, 216, true
3571, 1566722149262, 9126, 1566722149608, 9472, 346, true
3572, 1566722149262, 9126, 1566722149481, 9345, 219, true
3573, 1566722149263, 9127, 1566722149587, 9451, 324, true
3574, 1566722149264, 9128, 1566722149610, 9474, 346, true
3575, 1566722149264, 9128, 1566722149589, 9453, 325, true
3576, 1566722149268, 9132, 1566722149619, 9483, 351, true
3577, 1566722149269, 9133, 1566722149621, 9485, 352, true
3578, 1566722149275, 9139, 1566722149619, 9483, 344, true
3579, 1566722149276, 9140, 1566722149621, 9485, 345, true
3580, 1566722149279, 9143, 1566722149621, 9485, 342, true
3581, 1566722149312, 9176, 1566722149701, 9565, 389, true
3582, 1566722149313, 9177, 1566722149700, 9564, 387, true
3583, 1566722149313, 9177, 1566722149701, 9565, 388, true
3584, 1566722149314, 9178, 1566722149699, 9563, 385, true
3585, 1566722149314, 9178, 1566722149699, 9563, 385, true
3586, 1566722149315, 9179, 1566722149699, 9563, 384, true
3587, 1566722149315, 9179, 1566722149697, 9561, 382, true
3588, 1566722149316, 9180, 1566722149701, 9565, 385, true
3589, 1566722149316, 9180, 1566722149624, 9488, 308, true
3590, 1566722149318, 9182, 1566722149700, 9564, 382, true
3591, 1566722149318, 9182, 1566722149700, 9564, 382, true
3592, 1566722149319, 9183, 1566722149697, 9561, 378, true
3593, 1566722149319, 9183, 1566722149701, 9565, 382, true
3594, 1566722149320, 9184, 1566722149699, 9563, 379, true
3595, 1566722149320, 9184, 1566722149698, 9562, 378, true
3596, 1566722149320, 9184, 1566722149702, 9566, 382, true
3597, 1566722149321, 9185, 1566722149700, 9564, 379, true
3598, 1566722149321, 9185, 1566722149701, 9565, 380, true
3599, 1566722149322, 9186, 1566722149697, 9561, 375, true
3600, 1566722149322, 9186, 1566722149696, 9560, 374, true
3601, 1566722149323, 9187, 1566722149701, 9565, 378, true
3602, 1566722149324, 9188, 1566722149700, 9564, 376, true
3603, 1566722149324, 9188, 1566722149698, 9562, 374, true
3604, 1566722149325, 9189, 1566722149701, 9565, 376, true
3605, 1566722149326, 9190, 1566722149698, 9562, 372, true
3606, 1566722149326, 9190, 1566722149699, 9563, 373, true
3607, 1566722149327, 9191, 1566722149701, 9565, 374, true
3608, 1566722149327, 9191, 1566722149701, 9565, 374, true
3609, 1566722149328, 9192, 1566722149697, 9561, 369, true
3610, 1566722149328, 9192, 1566722149701, 9565, 373, true
3611, 1566722149329, 9193, 1566722149696, 9560, 367, true
3612, 1566722149329, 9193, 1566722149699, 9563, 370, true
3613, 1566722149330, 9194, 1566722149698, 9562, 368, true
3614, 1566722149330, 9194, 1566722149700, 9564, 370, true
3615, 1566722149331, 9195, 1566722149701, 9565, 370, true
3616, 1566722149331, 9195, 1566722149700, 9564, 369, true
3617, 1566722149331, 9195, 1566722149699, 9563, 368, true
3618, 1566722149346, 9210, 1566722149698, 9562, 352, true
3619, 1566722149346, 9210, 1566722149701, 9565, 355, true
3620, 1566722149346, 9210, 1566722149700, 9564, 354, true
3621, 1566722149347, 9211, 1566722149698, 9562, 351, true
3622, 1566722149347, 9211, 1566722149700, 9564, 353, true
3623, 1566722149348, 9212, 1566722149700, 9564, 352, true
3624, 1566722149348, 9212, 1566722149701, 9565, 353, true
3625, 1566722149348, 9212, 1566722149697, 9561, 349, true
3626, 1566722149349, 9213, 1566722149701, 9565, 352, true
3627, 1566722149349, 9213, 1566722149700, 9564, 351, true
3628, 1566722149349, 9213, 1566722149700, 9564, 351, true
3629, 1566722149350, 9214, 1566722149698, 9562, 348, true
3630, 1566722149350, 9214, 1566722149698, 9562, 348, true
3631, 1566722149350, 9214, 1566722149699, 9563, 349, true
3632, 1566722149351, 9215, 1566722149701, 9565, 350, true
3633, 1566722149351, 9215, 1566722149699, 9563, 348, true
3634, 1566722149351, 9215, 1566722149700, 9564, 349, true
3635, 1566722149352, 9216, 1566722149697, 9561, 345, true
3636, 1566722149352, 9216, 1566722149701, 9565, 349, true
3637, 1566722149352, 9216, 1566722149699, 9563, 347, true
3638, 1566722149353, 9217, 1566722149698, 9562, 345, true
3639, 1566722149353, 9217, 1566722149699, 9563, 346, true
3640, 1566722149353, 9217, 1566722149702, 9566, 349, true
3641, 1566722149353, 9217, 1566722149696, 9560, 343, true
3642, 1566722149354, 9218, 1566722149700, 9564, 346, true
3643, 1566722149354, 9218, 1566722149700, 9564, 346, true
3644, 1566722149355, 9219, 1566722149697, 9561, 342, true
3645, 1566722149355, 9219, 1566722149700, 9564, 345, true
3646, 1566722149355, 9219, 1566722149699, 9563, 344, true
3647, 1566722149356, 9220, 1566722149701, 9565, 345, true
3648, 1566722149356, 9220, 1566722149700, 9564, 344, true
3649, 1566722149357, 9221, 1566722149699, 9563, 342, true
3650, 1566722149357, 9221, 1566722149699, 9563, 342, true
3651, 1566722149357, 9221, 1566722149700, 9564, 343, true
3652, 1566722149358, 9222, 1566722149699, 9563, 341, true
3653, 1566722149358, 9222, 1566722149701, 9565, 343, true
3654, 1566722149359, 9223, 1566722149697, 9561, 338, true
3655, 1566722149359, 9223, 1566722149701, 9565, 342, true
3656, 1566722149359, 9223, 1566722149700, 9564, 341, true
3657, 1566722149360, 9224, 1566722149698, 9562, 338, true
3658, 1566722149360, 9224, 1566722149698, 9562, 338, true
3659, 1566722149361, 9225, 1566722149700, 9564, 339, true
3660, 1566722149452, 9316, 1566722149697, 9561, 245, true
3661, 1566722149454, 9318, 1566722149697, 9561, 243, true
3662, 1566722149465, 9329, 1566722149696, 9560, 231, true
3663, 1566722149468, 9332, 1566722149692, 9556, 224, true
3664, 1566722149470, 9334, 1566722149693, 9557, 223, true
3665, 1566722149472, 9336, 1566722149692, 9556, 220, true
3666, 1566722149472, 9336, 1566722149717, 9581, 245, true
3667, 1566722149554, 9418, 1566722149792, 9656, 238, true
3668, 1566722149554, 9418, 1566722149792, 9656, 238, true
3669, 1566722149555, 9419, 1566722149792, 9656, 237, true
3670, 1566722149555, 9419, 1566722149792, 9656, 237, true
3671, 1566722149555, 9419, 1566722149792, 9656, 237, true
3672, 1566722149556, 9420, 1566722149792, 9656, 236, true
3673, 1566722149557, 9421, 1566722149792, 9656, 235, true
3674, 1566722149558, 9422, 1566722149792, 9656, 234, true
3675, 1566722149559, 9423, 1566722149792, 9656, 233, true
3676, 1566722149560, 9424, 1566722149792, 9656, 232, true
3677, 1566722149602, 9466, 1566722149816, 9680, 214, true
3678, 1566722149602, 9466, 1566722149816, 9680, 214, true
3679, 1566722149603, 9467, 1566722149816, 9680, 213, true
3680, 1566722149603, 9467, 1566722149817, 9681, 214, true
3681, 1566722149603, 9467, 1566722149816, 9680, 213, true
3682, 1566722149604, 9468, 1566722149817, 9681, 213, true
3683, 1566722149615, 9479, 1566722149825, 9689, 210, true
3684, 1566722149615, 9479, 1566722149825, 9689, 210, true
3685, 1566722149617, 9481, 1566722149825, 9689, 208, true
3686, 1566722149617, 9481, 1566722149821, 9685, 204, true
3687, 1566722149618, 9482, 1566722149825, 9689, 207, true
3688, 1566722149621, 9485, 1566722149828, 9692, 207, true
3689, 1566722149621, 9485, 1566722149825, 9689, 204, true
3690, 1566722149622, 9486, 1566722149832, 9696, 210, true
3691, 1566722149623, 9487, 1566722149828, 9692, 205, true
3692, 1566722149623, 9487, 1566722149832, 9696, 209, true
3693, 1566722149624, 9488, 1566722149832, 9696, 208, true
3694, 1566722149692, 9556, 1566722149901, 9765, 209, true
3695, 1566722149707, 9571, 1566722149924, 9788, 217, true
3696, 1566722149716, 9580, 1566722149944, 9808, 228, true
3697, 1566722149716, 9580, 1566722149944, 9808, 228, true
3698, 1566722149718, 9582, 1566722149927, 9791, 209, true
3699, 1566722149718, 9582, 1566722149944, 9808, 226, true
3700, 1566722149719, 9583, 1566722149944, 9808, 225, true
3701, 1566722149721, 9585, 1566722149944, 9808, 223, true
3702, 1566722149721, 9585, 1566722149944, 9808, 223, true
3703, 1566722149722, 9586, 1566722149945, 9809, 223, true
3704, 1566722149722, 9586, 1566722149944, 9808, 222, true
3705, 1566722149723, 9587, 1566722149945, 9809, 222, true
3706, 1566722149724, 9588, 1566722149945, 9809, 221, true
3707, 1566722149724, 9588, 1566722149945, 9809, 221, true
3708, 1566722149725, 9589, 1566722149944, 9808, 219, true
3709, 1566722149725, 9589, 1566722149966, 9830, 241, true
3710, 1566722149726, 9590, 1566722149966, 9830, 240, true
3711, 1566722149728, 9592, 1566722149949, 9813, 221, true
3712, 1566722149728, 9592, 1566722149965, 9829, 237, true
3713, 1566722149729, 9593, 1566722149971, 9835, 242, true
3714, 1566722149729, 9593, 1566722149971, 9835, 242, true
3715, 1566722149729, 9593, 1566722149971, 9835, 242, true
3716, 1566722149730, 9594, 1566722149966, 9830, 236, true
3717, 1566722149731, 9595, 1566722149950, 9814, 219, true
3718, 1566722149731, 9595, 1566722149966, 9830, 235, true
3719, 1566722149731, 9595, 1566722149965, 9829, 234, true
3720, 1566722149732, 9596, 1566722149966, 9830, 234, true
3721, 1566722149732, 9596, 1566722149966, 9830, 234, true
3722, 1566722149732, 9596, 1566722149971, 9835, 239, true
3723, 1566722149732, 9596, 1566722149966, 9830, 234, true
3724, 1566722149733, 9597, 1566722149958, 9822, 225, true
3725, 1566722149739, 9603, 1566722149966, 9830, 227, true
3726, 1566722149741, 9605, 1566722149999, 9863, 258, true
3727, 1566722149741, 9605, 1566722149999, 9863, 258, true
3728, 1566722149742, 9606, 1566722149994, 9858, 252, true
3729, 1566722149742, 9606, 1566722149994, 9858, 252, true
3730, 1566722149743, 9607, 1566722150007, 9871, 264, true
3731, 1566722149744, 9608, 1566722150010, 9874, 266, true
3732, 1566722149744, 9608, 1566722150016, 9880, 272, true
3733, 1566722149744, 9608, 1566722150016, 9880, 272, true
3734, 1566722149744, 9608, 1566722150027, 9891, 283, true
3735, 1566722149744, 9608, 1566722150016, 9880, 272, true
3736, 1566722149745, 9609, 1566722150086, 9950, 341, true
3737, 1566722149745, 9609, 1566722150017, 9881, 272, true
3738, 1566722149745, 9609, 1566722150094, 9958, 349, true
3739, 1566722149746, 9610, 1566722150016, 9880, 270, true
3740, 1566722149746, 9610, 1566722150024, 9888, 278, true
3741, 1566722149746, 9610, 1566722150095, 9959, 349, true
3742, 1566722149747, 9611, 1566722150025, 9889, 278, true
3743, 1566722149747, 9611, 1566722150087, 9951, 340, true
3744, 1566722149747, 9611, 1566722150007, 9871, 260, true
3745, 1566722149747, 9611, 1566722150086, 9950, 339, true
3746, 1566722149748, 9612, 1566722150007, 9871, 259, true
3747, 1566722149748, 9612, 1566722150016, 9880, 268, true
3748, 1566722149748, 9612, 1566722150015, 9879, 267, true
3749, 1566722149748, 9612, 1566722150016, 9880, 268, true
3750, 1566722149749, 9613, 1566722150024, 9888, 275, true
3751, 1566722149749, 9613, 1566722150095, 9959, 346, true
3752, 1566722149749, 9613, 1566722150017, 9881, 268, true
3753, 1566722149749, 9613, 1566722150024, 9888, 275, true
3754, 1566722149750, 9614, 1566722150017, 9881, 267, true
3755, 1566722149750, 9614, 1566722149999, 9863, 249, true
3756, 1566722149750, 9614, 1566722150016, 9880, 266, true
3757, 1566722149750, 9614, 1566722150024, 9888, 274, true
3758, 1566722149751, 9615, 1566722150016, 9880, 265, true
3759, 1566722149751, 9615, 1566722150016, 9880, 265, true
3760, 1566722149752, 9616, 1566722150027, 9891, 275, true
3761, 1566722149752, 9616, 1566722150007, 9871, 255, true
3762, 1566722149752, 9616, 1566722150010, 9874, 258, true
3763, 1566722149752, 9616, 1566722150095, 9959, 343, true
3764, 1566722149753, 9617, 1566722150024, 9888, 271, true
3765, 1566722149753, 9617, 1566722150000, 9864, 247, true
3766, 1566722149753, 9617, 1566722150011, 9875, 258, true
3767, 1566722149753, 9617, 1566722150016, 9880, 263, true
3768, 1566722149754, 9618, 1566722150086, 9950, 332, true
3769, 1566722149754, 9618, 1566722150024, 9888, 270, true
3770, 1566722149754, 9618, 1566722150080, 9944, 326, true
3771, 1566722149754, 9618, 1566722150095, 9959, 341, true
3772, 1566722149755, 9619, 1566722150010, 9874, 255, true
3773, 1566722149755, 9619, 1566722150024, 9888, 269, true
3774, 1566722149755, 9619, 1566722150024, 9888, 269, true
3775, 1566722149755, 9619, 1566722150086, 9950, 331, true
3776, 1566722149756, 9620, 1566722150031, 9895, 275, true
3777, 1566722149756, 9620, 1566722150007, 9871, 251, true
3778, 1566722149756, 9620, 1566722150079, 9943, 323, true
3779, 1566722149756, 9620, 1566722150007, 9871, 251, true
3780, 1566722149757, 9621, 1566722150017, 9881, 260, true
3781, 1566722149757, 9621, 1566722150087, 9951, 330, true
3782, 1566722149757, 9621, 1566722150087, 9951, 330, true
3783, 1566722149757, 9621, 1566722150025, 9889, 268, true
3784, 1566722149758, 9622, 1566722150076, 9940, 318, true
3785, 1566722149758, 9622, 1566722150016, 9880, 258, true
3786, 1566722149758, 9622, 1566722150016, 9880, 258, true
3787, 1566722149758, 9622, 1566722150025, 9889, 267, true
3788, 1566722149759, 9623, 1566722150086, 9950, 327, true
3789, 1566722149759, 9623, 1566722150094, 9958, 335, true
3790, 1566722149760, 9624, 1566722150086, 9950, 326, true
3791, 1566722149760, 9624, 1566722150094, 9958, 334, true
3792, 1566722149760, 9624, 1566722150010, 9874, 250, true
3793, 1566722149760, 9624, 1566722150025, 9889, 265, true
3794, 1566722149761, 9625, 1566722150024, 9888, 263, true
3795, 1566722149761, 9625, 1566722150026, 9890, 265, true
3796, 1566722149761, 9625, 1566722150024, 9888, 263, true
3797, 1566722149761, 9625, 1566722150007, 9871, 246, true
3798, 1566722149762, 9626, 1566722150007, 9871, 245, true
3799, 1566722149762, 9626, 1566722150016, 9880, 254, true
3800, 1566722149762, 9626, 1566722150087, 9951, 325, true
3801, 1566722149762, 9626, 1566722150076, 9940, 314, true
3802, 1566722149763, 9627, 1566722150094, 9958, 331, true
3803, 1566722149763, 9627, 1566722150094, 9958, 331, true
3804, 1566722149763, 9627, 1566722150079, 9943, 316, true
3805, 1566722149764, 9628, 1566722150016, 9880, 252, true
3806, 1566722149764, 9628, 1566722150047, 9911, 283, true
3807, 1566722149764, 9628, 1566722150010, 9874, 246, true
3808, 1566722149765, 9629, 1566722150025, 9889, 260, true
3809, 1566722149765, 9629, 1566722150087, 9951, 322, true
3810, 1566722149765, 9629, 1566722150024, 9888, 259, true
3811, 1566722149765, 9629, 1566722150095, 9959, 330, true
3812, 1566722149766, 9630, 1566722150010, 9874, 244, true
3813, 1566722149766, 9630, 1566722150086, 9950, 320, true
3814, 1566722149766, 9630, 1566722150094, 9958, 328, true
3815, 1566722149767, 9631, 1566722150025, 9889, 258, true
3816, 1566722149768, 9632, 1566722150024, 9888, 256, true
3817, 1566722149768, 9632, 1566722150010, 9874, 242, true
3818, 1566722149768, 9632, 1566722150000, 9864, 232, true
3819, 1566722149769, 9633, 1566722150016, 9880, 247, true
3820, 1566722149769, 9633, 1566722150024, 9888, 255, true
3821, 1566722149769, 9633, 1566722150024, 9888, 255, true
3822, 1566722149769, 9633, 1566722150078, 9942, 309, true
3823, 1566722149770, 9634, 1566722150086, 9950, 316, true
3824, 1566722149770, 9634, 1566722150025, 9889, 255, true
3825, 1566722149770, 9634, 1566722150087, 9951, 317, true
3826, 1566722149770, 9634, 1566722150027, 9891, 257, true
3827, 1566722149771, 9635, 1566722150025, 9889, 254, true
3828, 1566722149771, 9635, 1566722150024, 9888, 253, true
3829, 1566722149771, 9635, 1566722150010, 9874, 239, true
3830, 1566722149772, 9636, 1566722150027, 9891, 255, true
3831, 1566722149772, 9636, 1566722150086, 9950, 314, true
3832, 1566722149772, 9636, 1566722150282, 10146, 510, true
3833, 1566722149772, 9636, 1566722150277, 10141, 505, true
3834, 1566722149772, 9636, 1566722150264, 10128, 492, true
3835, 1566722149773, 9637, 1566722150257, 10121, 484, true
3836, 1566722149773, 9637, 1566722150250, 10114, 477, true
3837, 1566722149774, 9638, 1566722150257, 10121, 483, true
3838, 1566722149774, 9638, 1566722150253, 10117, 479, true
3839, 1566722149774, 9638, 1566722150274, 10138, 500, true
3840, 1566722149774, 9638, 1566722150264, 10128, 490, true
3841, 1566722149774, 9638, 1566722150277, 10141, 503, true
3842, 1566722149775, 9639, 1566722150246, 10110, 471, true
3843, 1566722149775, 9639, 1566722150267, 10131, 492, true
3844, 1566722149775, 9639, 1566722150274, 10138, 499, true
3845, 1566722149775, 9639, 1566722150271, 10135, 496, true
3846, 1566722149776, 9640, 1566722150254, 10118, 478, true
3847, 1566722149776, 9640, 1566722150282, 10146, 506, true
3848, 1566722149776, 9640, 1566722150278, 10142, 502, true
3849, 1566722149776, 9640, 1566722150264, 10128, 488, true
3850, 1566722149776, 9640, 1566722150253, 10117, 477, true
3851, 1566722149777, 9641, 1566722150281, 10145, 504, true
3852, 1566722149777, 9641, 1566722150261, 10125, 484, true
3853, 1566722149777, 9641, 1566722150264, 10128, 487, true
3854, 1566722149777, 9641, 1566722150263, 10127, 486, true
3855, 1566722149777, 9641, 1566722150246, 10110, 469, true
3856, 1566722149777, 9641, 1566722150282, 10146, 505, true
3857, 1566722149778, 9642, 1566722150278, 10142, 500, true
3858, 1566722149778, 9642, 1566722150264, 10128, 486, true
3859, 1566722149778, 9642, 1566722150282, 10146, 504, true
3860, 1566722149778, 9642, 1566722150258, 10122, 480, true
3861, 1566722149778, 9642, 1566722150277, 10141, 499, true
3862, 1566722149778, 9642, 1566722150267, 10131, 489, true
3863, 1566722149778, 9642, 1566722150274, 10138, 496, true
3864, 1566722149779, 9643, 1566722150265, 10129, 486, true
3865, 1566722149779, 9643, 1566722150274, 10138, 495, true
3866, 1566722149779, 9643, 1566722150278, 10142, 499, true
3867, 1566722149779, 9643, 1566722150272, 10136, 493, true
3868, 1566722149779, 9643, 1566722150261, 10125, 482, true
3869, 1566722149779, 9643, 1566722150271, 10135, 492, true
3870, 1566722149780, 9644, 1566722150246, 10110, 466, true
3871, 1566722149780, 9644, 1566722150277, 10141, 497, true
3872, 1566722149780, 9644, 1566722150264, 10128, 484, true
3873, 1566722149780, 9644, 1566722150258, 10122, 478, true
3874, 1566722149781, 9645, 1566722150246, 10110, 465, true
3875, 1566722149781, 9645, 1566722150250, 10114, 469, true
3876, 1566722149781, 9645, 1566722150007, 9871, 226, true
3877, 1566722149781, 9645, 1566722150085, 9949, 304, true
3878, 1566722149782, 9646, 1566722150094, 9958, 312, true
3879, 1566722149782, 9646, 1566722150024, 9888, 242, true
3880, 1566722149782, 9646, 1566722150010, 9874, 228, true
3881, 1566722149783, 9647, 1566722150024, 9888, 241, true
3882, 1566722149783, 9647, 1566722149999, 9863, 216, true
3883, 1566722149784, 9648, 1566722150095, 9959, 311, true
3884, 1566722149784, 9648, 1566722150010, 9874, 226, true
3885, 1566722149846, 9710, 1566722150094, 9958, 248, true
3886, 1566722149849, 9713, 1566722150094, 9958, 245, true
3887, 1566722149852, 9716, 1566722150094, 9958, 242, true
3888, 1566722149853, 9717, 1566722150094, 9958, 241, true
3889, 1566722149854, 9718, 1566722150094, 9958, 240, true
3890, 1566722149856, 9720, 1566722150076, 9940, 220, true
3891, 1566722149857, 9721, 1566722150094, 9958, 237, true
3892, 1566722149859, 9723, 1566722150094, 9958, 235, true
3893, 1566722149860, 9724, 1566722150093, 9957, 233, true
3894, 1566722149862, 9726, 1566722150094, 9958, 232, true
3895, 1566722149866, 9730, 1566722150093, 9957, 227, true
3896, 1566722149867, 9731, 1566722150087, 9951, 220, true
3897, 1566722149869, 9733, 1566722150087, 9951, 218, true
3898, 1566722149870, 9734, 1566722150087, 9951, 217, true
3899, 1566722149872, 9736, 1566722150087, 9951, 215, true
3900, 1566722149872, 9736, 1566722150087, 9951, 215, true
3901, 1566722149873, 9737, 1566722150087, 9951, 214, true
3902, 1566722149874, 9738, 1566722150087, 9951, 213, true
3903, 1566722149875, 9739, 1566722150244, 10108, 369, true
3904, 1566722149876, 9740, 1566722150237, 10101, 361, true
3905, 1566722149876, 9740, 1566722150211, 10075, 335, true
3906, 1566722149876, 9740, 1566722150246, 10110, 370, true
3907, 1566722149877, 9741, 1566722150246, 10110, 369, true
3908, 1566722149877, 9741, 1566722150228, 10092, 351, true
3909, 1566722149877, 9741, 1566722150260, 10124, 383, true
3910, 1566722149878, 9742, 1566722150258, 10122, 380, true
3911, 1566722149878, 9742, 1566722150271, 10135, 393, true
3912, 1566722149878, 9742, 1566722150275, 10139, 397, true
3913, 1566722149878, 9742, 1566722150281, 10145, 403, true
3914, 1566722149879, 9743, 1566722150257, 10121, 378, true
3915, 1566722149879, 9743, 1566722150261, 10125, 382, true
3916, 1566722149880, 9744, 1566722150264, 10128, 384, true
3917, 1566722149880, 9744, 1566722150271, 10135, 391, true
3918, 1566722149880, 9744, 1566722150271, 10135, 391, true
3919, 1566722149881, 9745, 1566722150274, 10138, 393, true
3920, 1566722149881, 9745, 1566722150277, 10141, 396, true
3921, 1566722149882, 9746, 1566722150274, 10138, 392, true
3922, 1566722149882, 9746, 1566722150260, 10124, 378, true
3923, 1566722149882, 9746, 1566722150281, 10145, 399, true
3924, 1566722149882, 9746, 1566722150252, 10116, 370, true
3925, 1566722149883, 9747, 1566722150260, 10124, 377, true
3926, 1566722149883, 9747, 1566722150270, 10134, 387, true
3927, 1566722149883, 9747, 1566722150266, 10130, 383, true
3928, 1566722149883, 9747, 1566722150253, 10117, 370, true
3929, 1566722149884, 9748, 1566722150263, 10127, 379, true
3930, 1566722149884, 9748, 1566722150258, 10122, 374, true
3931, 1566722149885, 9749, 1566722150246, 10110, 361, true
3932, 1566722149885, 9749, 1566722150265, 10129, 380, true
3933, 1566722149885, 9749, 1566722150281, 10145, 396, true
3934, 1566722149885, 9749, 1566722150277, 10141, 392, true
3935, 1566722149885, 9749, 1566722150253, 10117, 368, true
3936, 1566722149886, 9750, 1566722150277, 10141, 391, true
3937, 1566722149886, 9750, 1566722150254, 10118, 368, true
3938, 1566722149886, 9750, 1566722150272, 10136, 386, true
3939, 1566722149887, 9751, 1566722150260, 10124, 373, true
3940, 1566722149887, 9751, 1566722150253, 10117, 366, true
3941, 1566722149888, 9752, 1566722150258, 10122, 370, true
3942, 1566722149888, 9752, 1566722150254, 10118, 366, true
3943, 1566722149888, 9752, 1566722150270, 10134, 382, true
3944, 1566722149889, 9753, 1566722150271, 10135, 382, true
3945, 1566722149889, 9753, 1566722150278, 10142, 389, true
3946, 1566722149889, 9753, 1566722150266, 10130, 377, true
3947, 1566722149889, 9753, 1566722150257, 10121, 368, true
3948, 1566722149890, 9754, 1566722150271, 10135, 381, true
3949, 1566722149890, 9754, 1566722150257, 10121, 367, true
3950, 1566722149890, 9754, 1566722150261, 10125, 371, true
3951, 1566722149891, 9755, 1566722150250, 10114, 359, true
3952, 1566722149893, 9757, 1566722150264, 10128, 371, true
3953, 1566722149894, 9758, 1566722150271, 10135, 377, true
3954, 1566722149896, 9760, 1566722150266, 10130, 370, true
3955, 1566722149899, 9763, 1566722150277, 10141, 378, true
3956, 1566722149901, 9765, 1566722150197, 10061, 296, true
3957, 1566722149901, 9765, 1566722150264, 10128, 363, true
3958, 1566722149902, 9766, 1566722150274, 10138, 372, true
3959, 1566722149903, 9767, 1566722150277, 10141, 374, true
3960, 1566722149904, 9768, 1566722150282, 10146, 378, true
3961, 1566722149905, 9769, 1566722150314, 10178, 409, true
3962, 1566722149905, 9769, 1566722150253, 10117, 348, true
3963, 1566722149906, 9770, 1566722150202, 10066, 296, true
3964, 1566722149906, 9770, 1566722150204, 10068, 298, true
3965, 1566722149906, 9770, 1566722150246, 10110, 340, true
3966, 1566722149907, 9771, 1566722150246, 10110, 339, true
3967, 1566722149907, 9771, 1566722150204, 10068, 297, true
3968, 1566722149907, 9771, 1566722150194, 10058, 287, true
3969, 1566722149908, 9772, 1566722150236, 10100, 328, true
3970, 1566722149908, 9772, 1566722150246, 10110, 338, true
3971, 1566722149908, 9772, 1566722150246, 10110, 338, true
3972, 1566722149908, 9772, 1566722150237, 10101, 329, true
3973, 1566722149908, 9772, 1566722150238, 10102, 330, true
3974, 1566722149909, 9773, 1566722150202, 10066, 293, true
3975, 1566722149909, 9773, 1566722150209, 10073, 300, true
3976, 1566722149909, 9773, 1566722150206, 10070, 297, true
3977, 1566722149909, 9773, 1566722150201, 10065, 292, true
3978, 1566722149917, 9781, 1566722150205, 10069, 288, true
3979, 1566722149996, 9860, 1566722150275, 10139, 279, true
3980, 1566722150030, 9894, 1566722150300, 10164, 270, true
3981, 1566722150033, 9897, 1566722150300, 10164, 267, true
3982, 1566722150033, 9897, 1566722150300, 10164, 267, true
3983, 1566722150035, 9899, 1566722150305, 10169, 270, true
3984, 1566722150039, 9903, 1566722150300, 10164, 261, true
3985, 1566722150039, 9903, 1566722150300, 10164, 261, true
3986, 1566722150040, 9904, 1566722150308, 10172, 268, true
3987, 1566722150042, 9906, 1566722150282, 10146, 240, true
3988, 1566722150043, 9907, 1566722150303, 10167, 260, true
3989, 1566722150044, 9908, 1566722150303, 10167, 259, true
3990, 1566722150066, 9930, 1566722150311, 10175, 245, true
3991, 1566722150068, 9932, 1566722150312, 10176, 244, true
3992, 1566722150069, 9933, 1566722150312, 10176, 243, true
3993, 1566722150070, 9934, 1566722150314, 10178, 244, true
3994, 1566722150111, 9975, 1566722150317, 10181, 206, true
3995, 1566722150112, 9976, 1566722150316, 10180, 204, true
3996, 1566722150112, 9976, 1566722150316, 10180, 204, true
3997, 1566722150112, 9976, 1566722150317, 10181, 205, true
3998, 1566722150113, 9977, 1566722150318, 10182, 205, true
3999, 1566722150114, 9978, 1566722150320, 10184, 206, true
4000, 1566722150115, 9979, 1566722150320, 10184, 205, true
4001, 1566722150116, 9980, 1566722150320, 10184, 204, true
4002, 1566722150117, 9981, 1566722150329, 10193, 212, true
4003, 1566722150117, 9981, 1566722150329, 10193, 212, true
4004, 1566722150118, 9982, 1566722150321, 10185, 203, true
4005, 1566722150120, 9984, 1566722150329, 10193, 209, true
4006, 1566722150120, 9984, 1566722150329, 10193, 209, true
4007, 1566722150121, 9985, 1566722150330, 10194, 209, true
4008, 1566722150121, 9985, 1566722150329, 10193, 208, true
4009, 1566722150122, 9986, 1566722150329, 10193, 207, true
4010, 1566722150123, 9987, 1566722150330, 10194, 207, true
4011, 1566722150124, 9988, 1566722150329, 10193, 205, true
4012, 1566722150125, 9989, 1566722150331, 10195, 206, true
4013, 1566722150126, 9990, 1566722150332, 10196, 206, true
4014, 1566722150127, 9991, 1566722150331, 10195, 204, true
4015, 1566722150128, 9992, 1566722150336, 10200, 208, true
4016, 1566722150129, 9993, 1566722150333, 10197, 204, true
4017, 1566722150129, 9993, 1566722150337, 10201, 208, true
4018, 1566722150130, 9994, 1566722150336, 10200, 206, true
4019, 1566722150131, 9995, 1566722150346, 10210, 215, true
4020, 1566722150132, 9996, 1566722150336, 10200, 204, true
4021, 1566722150132, 9996, 1566722150341, 10205, 209, true
4022, 1566722150133, 9997, 1566722150387, 10251, 254, true
4023, 1566722150133, 9997, 1566722150387, 10251, 254, true
4024, 1566722150134, 9998, 1566722150390, 10254, 256, true
4025, 1566722150134, 9998, 1566722150391, 10255, 257, true
4026, 1566722150135, 9999, 1566722150391, 10255, 256, true
4027, 1566722150135, 9999, 1566722150391, 10255, 256, true
4028, 1566722150136, 10000, 1566722150356, 10220, 220, true
4029, 1566722150136, 10000, 1566722150391, 10255, 255, true
4030, 1566722150137, 10001, 1566722150388, 10252, 251, true
4031, 1566722150138, 10002, 1566722150390, 10254, 252, true
4032, 1566722150138, 10002, 1566722150387, 10251, 249, true
4033, 1566722150138, 10002, 1566722150390, 10254, 252, true
4034, 1566722150139, 10003, 1566722150387, 10251, 248, true
4035, 1566722150140, 10004, 1566722150391, 10255, 251, true
4036, 1566722150140, 10004, 1566722150395, 10259, 255, true
4037, 1566722150140, 10004, 1566722150381, 10245, 241, true
4038, 1566722150141, 10005, 1566722150395, 10259, 254, true
4039, 1566722150141, 10005, 1566722150387, 10251, 246, true
4040, 1566722150141, 10005, 1566722150392, 10256, 251, true
4041, 1566722150142, 10006, 1566722150391, 10255, 249, true
4042, 1566722150142, 10006, 1566722150395, 10259, 253, true
4043, 1566722150143, 10007, 1566722150390, 10254, 247, true
4044, 1566722150144, 10008, 1566722150390, 10254, 246, true
4045, 1566722150144, 10008, 1566722150391, 10255, 247, true
4046, 1566722150144, 10008, 1566722150391, 10255, 247, true
4047, 1566722150145, 10009, 1566722150390, 10254, 245, true
4048, 1566722150145, 10009, 1566722150387, 10251, 242, true
4049, 1566722150146, 10010, 1566722150391, 10255, 245, true
4050, 1566722150148, 10012, 1566722150396, 10260, 248, true
4051, 1566722150149, 10013, 1566722150387, 10251, 238, true
4052, 1566722150151, 10015, 1566722150395, 10259, 244, true
4053, 1566722150152, 10016, 1566722150398, 10262, 246, true
4054, 1566722150153, 10017, 1566722150383, 10247, 230, true
4055, 1566722150154, 10018, 1566722150395, 10259, 241, true
4056, 1566722150154, 10018, 1566722150398, 10262, 244, true
4057, 1566722150155, 10019, 1566722150398, 10262, 243, true
4058, 1566722150155, 10019, 1566722150387, 10251, 232, true
4059, 1566722150156, 10020, 1566722150398, 10262, 242, true
4060, 1566722150157, 10021, 1566722150395, 10259, 238, true
4061, 1566722150157, 10021, 1566722150396, 10260, 239, true
4062, 1566722150158, 10022, 1566722150396, 10260, 238, true
4063, 1566722150158, 10022, 1566722150398, 10262, 240, true
4064, 1566722150159, 10023, 1566722150398, 10262, 239, true
4065, 1566722150170, 10034, 1566722150386, 10250, 216, true
4066, 1566722150182, 10046, 1566722150395, 10259, 213, true
4067, 1566722150183, 10047, 1566722150395, 10259, 212, true
4068, 1566722150185, 10049, 1566722150393, 10257, 208, true
4069, 1566722150186, 10050, 1566722150396, 10260, 210, true
4070, 1566722150189, 10053, 1566722150396, 10260, 207, true
4071, 1566722150190, 10054, 1566722150398, 10262, 208, true
4072, 1566722150192, 10056, 1566722150398, 10262, 206, true
4073, 1566722150194, 10058, 1566722150400, 10264, 206, true
4074, 1566722150195, 10059, 1566722150409, 10273, 214, true
4075, 1566722150195, 10059, 1566722150406, 10270, 211, true
4076, 1566722150195, 10059, 1566722150411, 10275, 216, true
4077, 1566722150196, 10060, 1566722150412, 10276, 216, true
4078, 1566722150198, 10062, 1566722150405, 10269, 207, true
4079, 1566722150198, 10062, 1566722150412, 10276, 214, true
4080, 1566722150199, 10063, 1566722150410, 10274, 211, true
4081, 1566722150200, 10064, 1566722150409, 10273, 209, true
4082, 1566722150207, 10071, 1566722150412, 10276, 205, true
4083, 1566722150209, 10073, 1566722150415, 10279, 206, true
4084, 1566722150210, 10074, 1566722150415, 10279, 205, true
4085, 1566722150210, 10074, 1566722150415, 10279, 205, true
4086, 1566722150213, 10077, 1566722150418, 10282, 205, true
4087, 1566722150213, 10077, 1566722150417, 10281, 204, true
4088, 1566722150218, 10082, 1566722150425, 10289, 207, true
4089, 1566722150218, 10082, 1566722150425, 10289, 207, true
4090, 1566722150221, 10085, 1566722150430, 10294, 209, true
4091, 1566722150224, 10088, 1566722150430, 10294, 206, true
4092, 1566722150226, 10090, 1566722150430, 10294, 204, true
4093, 1566722150228, 10092, 1566722150431, 10295, 203, true
4094, 1566722150230, 10094, 1566722150435, 10299, 205, true
4095, 1566722150233, 10097, 1566722150444, 10308, 211, true
4096, 1566722150234, 10098, 1566722150441, 10305, 207, true
4097, 1566722150238, 10102, 1566722150446, 10310, 208, true
4098, 1566722150239, 10103, 1566722150448, 10312, 209, true
4099, 1566722150240, 10104, 1566722150448, 10312, 208, true
4100, 1566722150241, 10105, 1566722150452, 10316, 211, true
4101, 1566722150293, 10157, 1566722150522, 10386, 229, true
4102, 1566722150293, 10157, 1566722150519, 10383, 226, true
4103, 1566722150294, 10158, 1566722150518, 10382, 224, true
4104, 1566722150294, 10158, 1566722150546, 10410, 252, true
4105, 1566722150294, 10158, 1566722150527, 10391, 233, true
4106, 1566722150295, 10159, 1566722150541, 10405, 246, true
4107, 1566722150296, 10160, 1566722150541, 10405, 245, true
4108, 1566722150296, 10160, 1566722150530, 10394, 234, true
4109, 1566722150296, 10160, 1566722150541, 10405, 245, true
4110, 1566722150300, 10164, 1566722150541, 10405, 241, true
4111, 1566722150305, 10169, 1566722150527, 10391, 222, true
4112, 1566722150307, 10171, 1566722150541, 10405, 234, true
4113, 1566722150311, 10175, 1566722150541, 10405, 230, true
4114, 1566722150319, 10183, 1566722150543, 10407, 224, true
4115, 1566722150332, 10196, 1566722150548, 10412, 216, true
4116, 1566722150333, 10197, 1566722150549, 10413, 216, true
4117, 1566722150338, 10202, 1566722150548, 10412, 210, true
4118, 1566722150339, 10203, 1566722150548, 10412, 209, true
4119, 1566722150343, 10207, 1566722150546, 10410, 203, true
4120, 1566722150344, 10208, 1566722150551, 10415, 207, true
4121, 1566722150344, 10208, 1566722150551, 10415, 207, true
4122, 1566722150345, 10209, 1566722150551, 10415, 206, true
4123, 1566722150347, 10211, 1566722150551, 10415, 204, true
4124, 1566722150347, 10211, 1566722150551, 10415, 204, true
4125, 1566722150348, 10212, 1566722150552, 10416, 204, true
4126, 1566722150349, 10213, 1566722150552, 10416, 203, true
4127, 1566722150349, 10213, 1566722150559, 10423, 210, true
4128, 1566722150350, 10214, 1566722150554, 10418, 204, true
4129, 1566722150351, 10215, 1566722150555, 10419, 204, true
4130, 1566722150352, 10216, 1566722150559, 10423, 207, true
4131, 1566722150354, 10218, 1566722150559, 10423, 205, true
4132, 1566722150354, 10218, 1566722150559, 10423, 205, true
4133, 1566722150355, 10219, 1566722150559, 10423, 204, true
4134, 1566722150356, 10220, 1566722150559, 10423, 203, true
4135, 1566722150357, 10221, 1566722150560, 10424, 203, true
4136, 1566722150358, 10222, 1566722150561, 10425, 203, true
4137, 1566722150359, 10223, 1566722150564, 10428, 205, true
4138, 1566722150360, 10224, 1566722150564, 10428, 204, true
4139, 1566722150360, 10224, 1566722150564, 10428, 204, true
4140, 1566722150361, 10225, 1566722150565, 10429, 204, true
4141, 1566722150362, 10226, 1566722150567, 10431, 205, true
4142, 1566722150363, 10227, 1566722150570, 10434, 207, true
4143, 1566722150364, 10228, 1566722150567, 10431, 203, true
4144, 1566722150365, 10229, 1566722150574, 10438, 209, true
4145, 1566722150365, 10229, 1566722150571, 10435, 206, true
4146, 1566722150366, 10230, 1566722150571, 10435, 205, true
4147, 1566722150366, 10230, 1566722150573, 10437, 207, true
4148, 1566722150369, 10233, 1566722150577, 10441, 208, true
4149, 1566722150369, 10233, 1566722150576, 10440, 207, true
4150, 1566722150369, 10233, 1566722150581, 10445, 212, true
4151, 1566722150370, 10234, 1566722150577, 10441, 207, true
4152, 1566722150370, 10234, 1566722150587, 10451, 217, true
4153, 1566722150370, 10234, 1566722150581, 10445, 211, true
4154, 1566722150371, 10235, 1566722150583, 10447, 212, true
4155, 1566722150371, 10235, 1566722150587, 10451, 216, true
4156, 1566722150372, 10236, 1566722150583, 10447, 211, true
4157, 1566722150372, 10236, 1566722150583, 10447, 211, true
4158, 1566722150373, 10237, 1566722150587, 10451, 214, true
4159, 1566722150373, 10237, 1566722150587, 10451, 214, true
4160, 1566722150374, 10238, 1566722150584, 10448, 210, true
4161, 1566722150377, 10241, 1566722150587, 10451, 210, true
4162, 1566722150378, 10242, 1566722150584, 10448, 206, true
4163, 1566722150379, 10243, 1566722150587, 10451, 208, true
4164, 1566722150382, 10246, 1566722150588, 10452, 206, true
4165, 1566722150402, 10266, 1566722150617, 10481, 215, true
4166, 1566722150406, 10270, 1566722150611, 10475, 205, true
4167, 1566722150407, 10271, 1566722150618, 10482, 211, true
4168, 1566722150408, 10272, 1566722150619, 10483, 211, true
4169, 1566722150410, 10274, 1566722150615, 10479, 205, true
4170, 1566722150413, 10277, 1566722150630, 10494, 217, true
4171, 1566722150413, 10277, 1566722150622, 10486, 209, true
4172, 1566722150415, 10279, 1566722150622, 10486, 207, true
4173, 1566722150416, 10280, 1566722150625, 10489, 209, true
4174, 1566722150417, 10281, 1566722150630, 10494, 213, true
4175, 1566722150417, 10281, 1566722150622, 10486, 205, true
4176, 1566722150418, 10282, 1566722150624, 10488, 206, true
4177, 1566722150421, 10285, 1566722150627, 10491, 206, true
4178, 1566722150421, 10285, 1566722150625, 10489, 204, true
4179, 1566722150422, 10286, 1566722150630, 10494, 208, true
4180, 1566722150423, 10287, 1566722150631, 10495, 208, true
4181, 1566722150424, 10288, 1566722150630, 10494, 206, true
4182, 1566722150425, 10289, 1566722150638, 10502, 213, true
4183, 1566722150425, 10289, 1566722150638, 10502, 213, true
4184, 1566722150426, 10290, 1566722150633, 10497, 207, true
4185, 1566722150431, 10295, 1566722150644, 10508, 213, true
4186, 1566722150432, 10296, 1566722150642, 10506, 210, true
4187, 1566722150432, 10296, 1566722150644, 10508, 212, true
4188, 1566722150432, 10296, 1566722150643, 10507, 211, true
4189, 1566722150433, 10297, 1566722150654, 10518, 221, true
4190, 1566722150433, 10297, 1566722150652, 10516, 219, true
4191, 1566722150434, 10298, 1566722150651, 10515, 217, true
4192, 1566722150434, 10298, 1566722150652, 10516, 218, true
4193, 1566722150435, 10299, 1566722150651, 10515, 216, true
4194, 1566722150436, 10300, 1566722150650, 10514, 214, true
4195, 1566722150437, 10301, 1566722150651, 10515, 214, true
4196, 1566722150438, 10302, 1566722150654, 10518, 216, true
4197, 1566722150439, 10303, 1566722150648, 10512, 209, true
4198, 1566722150440, 10304, 1566722150650, 10514, 210, true
4199, 1566722150440, 10304, 1566722150654, 10518, 214, true
4200, 1566722150441, 10305, 1566722150656, 10520, 215, true
4201, 1566722150442, 10306, 1566722150654, 10518, 212, true
4202, 1566722150443, 10307, 1566722150655, 10519, 212, true
4203, 1566722150447, 10311, 1566722150656, 10520, 209, true
4204, 1566722150448, 10312, 1566722150655, 10519, 207, true
4205, 1566722150452, 10316, 1566722150656, 10520, 204, true
4206, 1566722150454, 10318, 1566722150659, 10523, 205, true
4207, 1566722150455, 10319, 1566722150660, 10524, 205, true
4208, 1566722150455, 10319, 1566722150663, 10527, 208, true
4209, 1566722150455, 10319, 1566722150663, 10527, 208, true
4210, 1566722150456, 10320, 1566722150668, 10532, 212, true
4211, 1566722150458, 10322, 1566722150668, 10532, 210, true
4212, 1566722150458, 10322, 1566722150677, 10541, 219, true
4213, 1566722150458, 10322, 1566722150669, 10533, 211, true
4214, 1566722150459, 10323, 1566722150668, 10532, 209, true
4215, 1566722150460, 10324, 1566722150677, 10541, 217, true
4216, 1566722150461, 10325, 1566722150689, 10553, 228, true
4217, 1566722150462, 10326, 1566722150680, 10544, 218, true
4218, 1566722150462, 10326, 1566722150677, 10541, 215, true
4219, 1566722150463, 10327, 1566722150677, 10541, 214, true
4220, 1566722150464, 10328, 1566722150678, 10542, 214, true
4221, 1566722150465, 10329, 1566722150680, 10544, 215, true
4222, 1566722150466, 10330, 1566722150688, 10552, 222, true
4223, 1566722150466, 10330, 1566722150680, 10544, 214, true
4224, 1566722150467, 10331, 1566722150678, 10542, 211, true
4225, 1566722150469, 10333, 1566722150680, 10544, 211, true
4226, 1566722150470, 10334, 1566722150682, 10546, 212, true
4227, 1566722150471, 10335, 1566722150689, 10553, 218, true
4228, 1566722150472, 10336, 1566722150688, 10552, 216, true
4229, 1566722150473, 10337, 1566722150689, 10553, 216, true
4230, 1566722150474, 10338, 1566722150689, 10553, 215, true
4231, 1566722150475, 10339, 1566722150684, 10548, 209, true
4232, 1566722150476, 10340, 1566722150689, 10553, 213, true
4233, 1566722150477, 10341, 1566722150693, 10557, 216, true
4234, 1566722150478, 10342, 1566722150689, 10553, 211, true
4235, 1566722150480, 10344, 1566722150693, 10557, 213, true
4236, 1566722150481, 10345, 1566722150693, 10557, 212, true
4237, 1566722150482, 10346, 1566722150693, 10557, 211, true
4238, 1566722150483, 10347, 1566722150693, 10557, 210, true
4239, 1566722150485, 10349, 1566722150694, 10558, 209, true
4240, 1566722150486, 10350, 1566722150694, 10558, 208, true
4241, 1566722150488, 10352, 1566722150694, 10558, 206, true
4242, 1566722150488, 10352, 1566722150696, 10560, 208, true
4243, 1566722150489, 10353, 1566722150694, 10558, 205, true
4244, 1566722150490, 10354, 1566722150701, 10565, 211, true
4245, 1566722150491, 10355, 1566722150701, 10565, 210, true
4246, 1566722150491, 10355, 1566722150701, 10565, 210, true
4247, 1566722150493, 10357, 1566722150701, 10565, 208, true
4248, 1566722150494, 10358, 1566722150701, 10565, 207, true
4249, 1566722150495, 10359, 1566722150701, 10565, 206, true
4250, 1566722150496, 10360, 1566722150701, 10565, 205, true
4251, 1566722150496, 10360, 1566722150701, 10565, 205, true
4252, 1566722150497, 10361, 1566722150701, 10565, 204, true
4253, 1566722150498, 10362, 1566722150703, 10567, 205, true
4254, 1566722150499, 10363, 1566722150703, 10567, 204, true
4255, 1566722150500, 10364, 1566722150709, 10573, 209, true
4256, 1566722150501, 10365, 1566722150703, 10567, 202, true
4257, 1566722150501, 10365, 1566722150709, 10573, 208, true
4258, 1566722150502, 10366, 1566722150709, 10573, 207, true
4259, 1566722150503, 10367, 1566722150709, 10573, 206, true
4260, 1566722150504, 10368, 1566722150709, 10573, 205, true
4261, 1566722150504, 10368, 1566722150713, 10577, 209, true
4262, 1566722150505, 10369, 1566722150713, 10577, 208, true
4263, 1566722150505, 10369, 1566722150713, 10577, 208, true
4264, 1566722150506, 10370, 1566722150713, 10577, 207, true
4265, 1566722150507, 10371, 1566722150713, 10577, 206, true
4266, 1566722150509, 10373, 1566722150713, 10577, 204, true
4267, 1566722150510, 10374, 1566722150714, 10578, 204, true
4268, 1566722150510, 10374, 1566722150720, 10584, 210, true
4269, 1566722150511, 10375, 1566722150719, 10583, 208, true
4270, 1566722150512, 10376, 1566722150716, 10580, 204, true
4271, 1566722150513, 10377, 1566722150720, 10584, 207, true
4272, 1566722150514, 10378, 1566722150720, 10584, 206, true
4273, 1566722150514, 10378, 1566722150722, 10586, 208, true
4274, 1566722150515, 10379, 1566722150726, 10590, 211, true
4275, 1566722150516, 10380, 1566722150751, 10615, 235, true
4276, 1566722150516, 10380, 1566722150751, 10615, 235, true
4277, 1566722150518, 10382, 1566722150739, 10603, 221, true
4278, 1566722150520, 10384, 1566722150722, 10586, 202, true
4279, 1566722150521, 10385, 1566722150728, 10592, 207, true
4280, 1566722150521, 10385, 1566722150750, 10614, 229, true
4281, 1566722150522, 10386, 1566722150728, 10592, 206, true
4282, 1566722150523, 10387, 1566722150750, 10614, 227, true
4283, 1566722150523, 10387, 1566722150739, 10603, 216, true
4284, 1566722150524, 10388, 1566722150751, 10615, 227, true
4285, 1566722150525, 10389, 1566722150740, 10604, 215, true
4286, 1566722150525, 10389, 1566722150751, 10615, 226, true
4287, 1566722150526, 10390, 1566722150751, 10615, 225, true
4288, 1566722150527, 10391, 1566722150732, 10596, 205, true
4289, 1566722150528, 10392, 1566722150734, 10598, 206, true
4290, 1566722150528, 10392, 1566722150743, 10607, 215, true
4291, 1566722150529, 10393, 1566722150739, 10603, 210, true
4292, 1566722150530, 10394, 1566722150751, 10615, 221, true
4293, 1566722150531, 10395, 1566722150735, 10599, 204, true
4294, 1566722150531, 10395, 1566722150740, 10604, 209, true
4295, 1566722150532, 10396, 1566722150751, 10615, 219, true
4296, 1566722150532, 10396, 1566722150745, 10609, 213, true
4297, 1566722150533, 10397, 1566722150751, 10615, 218, true
4298, 1566722150533, 10397, 1566722150751, 10615, 218, true
4299, 1566722150533, 10397, 1566722150751, 10615, 218, true
4300, 1566722150534, 10398, 1566722150751, 10615, 217, true
4301, 1566722150534, 10398, 1566722150751, 10615, 217, true
4302, 1566722150534, 10398, 1566722150751, 10615, 217, true
4303, 1566722150534, 10398, 1566722150751, 10615, 217, true
4304, 1566722150590, 10454, 1566722150796, 10660, 206, true
4305, 1566722150591, 10455, 1566722150796, 10660, 205, true
4306, 1566722150592, 10456, 1566722150801, 10665, 209, true
4307, 1566722150594, 10458, 1566722150797, 10661, 203, true
4308, 1566722150595, 10459, 1566722150802, 10666, 207, true
4309, 1566722150596, 10460, 1566722150801, 10665, 205, true
4310, 1566722150598, 10462, 1566722150803, 10667, 205, true
4311, 1566722150601, 10465, 1566722150853, 10717, 252, true
4312, 1566722150603, 10467, 1566722150853, 10717, 250, true
4313, 1566722150604, 10468, 1566722150853, 10717, 249, true
4314, 1566722150606, 10470, 1566722150853, 10717, 247, true
4315, 1566722150609, 10473, 1566722150853, 10717, 244, true
4316, 1566722150611, 10475, 1566722150853, 10717, 242, true
4317, 1566722150613, 10477, 1566722150853, 10717, 240, true
4318, 1566722150615, 10479, 1566722150853, 10717, 238, true
4319, 1566722150619, 10483, 1566722150856, 10720, 237, true
4320, 1566722150623, 10487, 1566722150856, 10720, 233, true
4321, 1566722150627, 10491, 1566722150856, 10720, 229, true
4322, 1566722150631, 10495, 1566722150856, 10720, 225, true
4323, 1566722150633, 10497, 1566722150857, 10721, 224, true
4324, 1566722150634, 10498, 1566722150857, 10721, 223, true
4325, 1566722150635, 10499, 1566722150857, 10721, 222, true
4326, 1566722150638, 10502, 1566722150857, 10721, 219, true
4327, 1566722150639, 10503, 1566722150857, 10721, 218, true
4328, 1566722150641, 10505, 1566722150857, 10721, 216, true
4329, 1566722150646, 10510, 1566722150857, 10721, 211, true
4330, 1566722150648, 10512, 1566722150857, 10721, 209, true
4331, 1566722150661, 10525, 1566722150868, 10732, 207, true
4332, 1566722150661, 10525, 1566722150868, 10732, 207, true
4333, 1566722150661, 10525, 1566722150870, 10734, 209, true
4334, 1566722150662, 10526, 1566722150872, 10736, 210, true
4335, 1566722150664, 10528, 1566722150872, 10736, 208, true
4336, 1566722150666, 10530, 1566722150881, 10745, 215, true
4337, 1566722150666, 10530, 1566722150872, 10736, 206, true
4338, 1566722150668, 10532, 1566722150882, 10746, 214, true
4339, 1566722150669, 10533, 1566722150873, 10737, 204, true
4340, 1566722150669, 10533, 1566722150878, 10742, 209, true
4341, 1566722150671, 10535, 1566722150885, 10749, 214, true
4342, 1566722150671, 10535, 1566722150888, 10752, 217, true
4343, 1566722150671, 10535, 1566722150890, 10754, 219, true
4344, 1566722150672, 10536, 1566722150890, 10754, 218, true
4345, 1566722150672, 10536, 1566722150883, 10747, 211, true
4346, 1566722150672, 10536, 1566722150885, 10749, 213, true
4347, 1566722150672, 10536, 1566722150890, 10754, 218, true
4348, 1566722150673, 10537, 1566722150890, 10754, 217, true
4349, 1566722150673, 10537, 1566722150885, 10749, 212, true
4350, 1566722150673, 10537, 1566722150890, 10754, 217, true
4351, 1566722150674, 10538, 1566722150885, 10749, 211, true
4352, 1566722150675, 10539, 1566722150942, 10806, 267, true
4353, 1566722150684, 10548, 1566722150940, 10804, 256, true
4354, 1566722150685, 10549, 1566722150954, 10818, 269, true
4355, 1566722150690, 10554, 1566722150954, 10818, 264, true
4356, 1566722150690, 10554, 1566722150954, 10818, 264, true
4357, 1566722150690, 10554, 1566722150954, 10818, 264, true
4358, 1566722150695, 10559, 1566722150951, 10815, 256, true
4359, 1566722150697, 10561, 1566722150954, 10818, 257, true
4360, 1566722150704, 10568, 1566722150954, 10818, 250, true
4361, 1566722150704, 10568, 1566722150954, 10818, 250, true
4362, 1566722150705, 10569, 1566722150954, 10818, 249, true
4363, 1566722150705, 10569, 1566722150950, 10814, 245, true
4364, 1566722150709, 10573, 1566722150951, 10815, 242, true
4365, 1566722150715, 10579, 1566722150950, 10814, 235, true
4366, 1566722150716, 10580, 1566722150950, 10814, 234, true
4367, 1566722150717, 10581, 1566722150954, 10818, 237, true
4368, 1566722150720, 10584, 1566722150950, 10814, 230, true
4369, 1566722150722, 10586, 1566722150950, 10814, 228, true
4370, 1566722150723, 10587, 1566722150942, 10806, 219, true
4371, 1566722150723, 10587, 1566722150950, 10814, 227, true
4372, 1566722150723, 10587, 1566722150942, 10806, 219, true
4373, 1566722150724, 10588, 1566722150943, 10807, 219, true
4374, 1566722150724, 10588, 1566722150942, 10806, 218, true
4375, 1566722150725, 10589, 1566722150945, 10809, 220, true
4376, 1566722150726, 10590, 1566722150945, 10809, 219, true
4377, 1566722150728, 10592, 1566722150942, 10806, 214, true
4378, 1566722150729, 10593, 1566722150940, 10804, 211, true
4379, 1566722150732, 10596, 1566722150956, 10820, 224, true
4380, 1566722150733, 10597, 1566722150958, 10822, 225, true
4381, 1566722150736, 10600, 1566722150942, 10806, 206, true
4382, 1566722150736, 10600, 1566722150955, 10819, 219, true
4383, 1566722150739, 10603, 1566722150955, 10819, 216, true
4384, 1566722150741, 10605, 1566722150955, 10819, 214, true
4385, 1566722150741, 10605, 1566722150958, 10822, 217, true
4386, 1566722150743, 10607, 1566722150954, 10818, 211, true
4387, 1566722150752, 10616, 1566722150992, 10856, 240, true
4388, 1566722150752, 10616, 1566722150960, 10824, 208, true
4389, 1566722150753, 10617, 1566722150992, 10856, 239, true
4390, 1566722150754, 10618, 1566722150996, 10860, 242, true
4391, 1566722150754, 10618, 1566722150998, 10862, 244, true
4392, 1566722150755, 10619, 1566722150991, 10855, 236, true
4393, 1566722150756, 10620, 1566722151072, 10936, 316, true
4394, 1566722150756, 10620, 1566722151076, 10940, 320, true
4395, 1566722150757, 10621, 1566722151083, 10947, 326, true
4396, 1566722150757, 10621, 1566722151073, 10937, 316, true
4397, 1566722150758, 10622, 1566722151004, 10868, 246, true
4398, 1566722150758, 10622, 1566722151085, 10949, 327, true
4399, 1566722150758, 10622, 1566722151092, 10956, 334, true
4400, 1566722150758, 10622, 1566722151003, 10867, 245, true
4401, 1566722150759, 10623, 1566722151091, 10955, 332, true
4402, 1566722150759, 10623, 1566722151034, 10898, 275, true
4403, 1566722150759, 10623, 1566722151081, 10945, 322, true
4404, 1566722150759, 10623, 1566722151079, 10943, 320, true
4405, 1566722150760, 10624, 1566722151021, 10885, 261, true
4406, 1566722150760, 10624, 1566722151082, 10946, 322, true
4407, 1566722150760, 10624, 1566722151004, 10868, 244, true
4408, 1566722150761, 10625, 1566722151006, 10870, 245, true
4409, 1566722150761, 10625, 1566722151078, 10942, 317, true
4410, 1566722150762, 10626, 1566722151076, 10940, 314, true
4411, 1566722150762, 10626, 1566722151078, 10942, 316, true
4412, 1566722150763, 10627, 1566722150993, 10857, 230, true
4413, 1566722150763, 10627, 1566722150998, 10862, 235, true
4414, 1566722150763, 10627, 1566722151091, 10955, 328, true
4415, 1566722150763, 10627, 1566722151076, 10940, 313, true
4416, 1566722150764, 10628, 1566722151004, 10868, 240, true
4417, 1566722150764, 10628, 1566722151071, 10935, 307, true
4418, 1566722150764, 10628, 1566722151079, 10943, 315, true
4419, 1566722150764, 10628, 1566722151079, 10943, 315, true
4420, 1566722150765, 10629, 1566722151071, 10935, 306, true
4421, 1566722150765, 10629, 1566722151079, 10943, 314, true
4422, 1566722150765, 10629, 1566722151073, 10937, 308, true
4423, 1566722150765, 10629, 1566722151072, 10936, 307, true
4424, 1566722150766, 10630, 1566722151076, 10940, 310, true
4425, 1566722150766, 10630, 1566722151074, 10938, 308, true
4426, 1566722150767, 10631, 1566722151007, 10871, 240, true
4427, 1566722150767, 10631, 1566722151002, 10866, 235, true
4428, 1566722150767, 10631, 1566722150997, 10861, 230, true
4429, 1566722150767, 10631, 1566722151091, 10955, 324, true
4430, 1566722150768, 10632, 1566722151003, 10867, 235, true
4431, 1566722150768, 10632, 1566722151085, 10949, 317, true
4432, 1566722150768, 10632, 1566722151085, 10949, 317, true
4433, 1566722150768, 10632, 1566722151006, 10870, 238, true
4434, 1566722150769, 10633, 1566722151081, 10945, 312, true
4435, 1566722150770, 10634, 1566722151068, 10932, 298, true
4436, 1566722150770, 10634, 1566722151068, 10932, 298, true
4437, 1566722150770, 10634, 1566722151074, 10938, 304, true
4438, 1566722150771, 10635, 1566722151074, 10938, 303, true
4439, 1566722150771, 10635, 1566722151003, 10867, 232, true
4440, 1566722150772, 10636, 1566722151079, 10943, 307, true
4441, 1566722150772, 10636, 1566722151071, 10935, 299, true
4442, 1566722150772, 10636, 1566722151076, 10940, 304, true
4443, 1566722150773, 10637, 1566722151060, 10924, 287, true
4444, 1566722150773, 10637, 1566722151091, 10955, 318, true
4445, 1566722150773, 10637, 1566722151002, 10866, 229, true
4446, 1566722150773, 10637, 1566722151004, 10868, 231, true
4447, 1566722150774, 10638, 1566722150997, 10861, 223, true
4448, 1566722150774, 10638, 1566722151079, 10943, 305, true
4449, 1566722150774, 10638, 1566722151079, 10943, 305, true
4450, 1566722150774, 10638, 1566722151076, 10940, 302, true
4451, 1566722150775, 10639, 1566722151076, 10940, 301, true
4452, 1566722150775, 10639, 1566722151072, 10936, 297, true
4453, 1566722150775, 10639, 1566722151091, 10955, 316, true
4454, 1566722150775, 10639, 1566722151091, 10955, 316, true
4455, 1566722150776, 10640, 1566722151075, 10939, 299, true
4456, 1566722150776, 10640, 1566722151092, 10956, 316, true
4457, 1566722150776, 10640, 1566722151079, 10943, 303, true
4458, 1566722150776, 10640, 1566722151071, 10935, 295, true
4459, 1566722150777, 10641, 1566722151003, 10867, 226, true
4460, 1566722150778, 10642, 1566722151004, 10868, 226, true
4461, 1566722150778, 10642, 1566722151092, 10956, 314, true
4462, 1566722150779, 10643, 1566722151007, 10871, 228, true
4463, 1566722150779, 10643, 1566722151004, 10868, 225, true
4464, 1566722150780, 10644, 1566722151079, 10943, 299, true
4465, 1566722150780, 10644, 1566722151085, 10949, 305, true
4466, 1566722150780, 10644, 1566722151071, 10935, 291, true
4467, 1566722150781, 10645, 1566722151003, 10867, 222, true
4468, 1566722150781, 10645, 1566722151066, 10930, 285, true
4469, 1566722150781, 10645, 1566722151006, 10870, 225, true
4470, 1566722150782, 10646, 1566722151004, 10868, 222, true
4471, 1566722150782, 10646, 1566722151003, 10867, 221, true
4472, 1566722150782, 10646, 1566722151091, 10955, 309, true
4473, 1566722150782, 10646, 1566722151085, 10949, 303, true
4474, 1566722150789, 10653, 1566722151115, 10979, 326, true
4475, 1566722150790, 10654, 1566722151115, 10979, 325, true
4476, 1566722150791, 10655, 1566722151115, 10979, 324, true
4477, 1566722150792, 10656, 1566722151121, 10985, 329, true
4478, 1566722150799, 10663, 1566722151108, 10972, 309, true
4479, 1566722150799, 10663, 1566722151121, 10985, 322, true
4480, 1566722150858, 10722, 1566722151103, 10967, 245, true
4481, 1566722150858, 10722, 1566722151115, 10979, 257, true
4482, 1566722150859, 10723, 1566722151115, 10979, 256, true
4483, 1566722150859, 10723, 1566722151110, 10974, 251, true
4484, 1566722150859, 10723, 1566722151115, 10979, 256, true
4485, 1566722150860, 10724, 1566722151115, 10979, 255, true
4486, 1566722150862, 10726, 1566722151115, 10979, 253, true
4487, 1566722150866, 10730, 1566722151121, 10985, 255, true
4488, 1566722150874, 10738, 1566722151121, 10985, 247, true
4489, 1566722150875, 10739, 1566722151118, 10982, 243, true
4490, 1566722150875, 10739, 1566722151118, 10982, 243, true
4491, 1566722150876, 10740, 1566722151109, 10973, 233, true
4492, 1566722150876, 10740, 1566722151108, 10972, 232, true
4493, 1566722150876, 10740, 1566722151121, 10985, 245, true
4494, 1566722150886, 10750, 1566722151122, 10986, 236, true
4495, 1566722150887, 10751, 1566722151122, 10986, 235, true
4496, 1566722150891, 10755, 1566722151128, 10992, 237, true
4497, 1566722150891, 10755, 1566722151128, 10992, 237, true
4498, 1566722150891, 10755, 1566722151128, 10992, 237, true
4499, 1566722150892, 10756, 1566722151128, 10992, 236, true
4500, 1566722150892, 10756, 1566722151128, 10992, 236, true
4501, 1566722150892, 10756, 1566722151124, 10988, 232, true
4502, 1566722150894, 10758, 1566722151121, 10985, 227, true
4503, 1566722150895, 10759, 1566722151128, 10992, 233, true
4504, 1566722150896, 10760, 1566722151128, 10992, 232, true
4505, 1566722150898, 10762, 1566722151121, 10985, 223, true
4506, 1566722150899, 10763, 1566722151123, 10987, 224, true
4507, 1566722150900, 10764, 1566722151122, 10986, 222, true
4508, 1566722150901, 10765, 1566722151122, 10986, 221, true
4509, 1566722150901, 10765, 1566722151122, 10986, 221, true
4510, 1566722150902, 10766, 1566722151121, 10985, 219, true
4511, 1566722150902, 10766, 1566722151127, 10991, 225, true
4512, 1566722150903, 10767, 1566722151124, 10988, 221, true
4513, 1566722150903, 10767, 1566722151127, 10991, 224, true
4514, 1566722150904, 10768, 1566722151128, 10992, 224, true
4515, 1566722150905, 10769, 1566722151128, 10992, 223, true
4516, 1566722150906, 10770, 1566722151121, 10985, 215, true
4517, 1566722150923, 10787, 1566722151129, 10993, 206, true
4518, 1566722150924, 10788, 1566722151129, 10993, 205, true
4519, 1566722150925, 10789, 1566722151134, 10998, 209, true
4520, 1566722150927, 10791, 1566722151137, 11001, 210, true
4521, 1566722150928, 10792, 1566722151137, 11001, 209, true
4522, 1566722150931, 10795, 1566722151137, 11001, 206, true
4523, 1566722150933, 10797, 1566722151137, 11001, 204, true
4524, 1566722150934, 10798, 1566722151138, 11002, 204, true
4525, 1566722150936, 10800, 1566722151140, 11004, 204, true
4526, 1566722150938, 10802, 1566722151152, 11016, 214, true
4527, 1566722150945, 10809, 1566722151164, 11028, 219, true
4528, 1566722150946, 10810, 1566722151163, 11027, 217, true
4529, 1566722150946, 10810, 1566722151163, 11027, 217, true
4530, 1566722150966, 10830, 1566722151172, 11036, 206, true
4531, 1566722150969, 10833, 1566722151184, 11048, 215, true
4532, 1566722150969, 10833, 1566722151182, 11046, 213, true
4533, 1566722150970, 10834, 1566722151189, 11053, 219, true
4534, 1566722150970, 10834, 1566722151181, 11045, 211, true
4535, 1566722150970, 10834, 1566722151189, 11053, 219, true
4536, 1566722150971, 10835, 1566722151185, 11049, 214, true
4537, 1566722150973, 10837, 1566722151183, 11047, 210, true
4538, 1566722150973, 10837, 1566722151185, 11049, 212, true
4539, 1566722150974, 10838, 1566722151189, 11053, 215, true
4540, 1566722150976, 10840, 1566722151189, 11053, 213, true
4541, 1566722150977, 10841, 1566722151191, 11055, 214, true
4542, 1566722150978, 10842, 1566722151189, 11053, 211, true
4543, 1566722150982, 10846, 1566722151191, 11055, 209, true
4544, 1566722150984, 10848, 1566722151189, 11053, 205, true
4545, 1566722150986, 10850, 1566722151194, 11058, 208, true
4546, 1566722150990, 10854, 1566722151194, 11058, 204, true
4547, 1566722151008, 10872, 1566722151216, 11080, 208, true
4548, 1566722151012, 10876, 1566722151229, 11093, 217, true
4549, 1566722151013, 10877, 1566722151223, 11087, 210, true
4550, 1566722151013, 10877, 1566722151229, 11093, 216, true
4551, 1566722151013, 10877, 1566722151229, 11093, 216, true
4552, 1566722151014, 10878, 1566722151227, 11091, 213, true
4553, 1566722151021, 10885, 1566722151231, 11095, 210, true
4554, 1566722151022, 10886, 1566722151231, 11095, 209, true
4555, 1566722151024, 10888, 1566722151229, 11093, 205, true
4556, 1566722151026, 10890, 1566722151231, 11095, 205, true
4557, 1566722151029, 10893, 1566722151233, 11097, 204, true
4558, 1566722151030, 10894, 1566722151237, 11101, 207, true
4559, 1566722151033, 10897, 1566722151240, 11104, 207, true
4560, 1566722151036, 10900, 1566722151242, 11106, 206, true
4561, 1566722151036, 10900, 1566722151240, 11104, 204, true
4562, 1566722151036, 10900, 1566722151251, 11115, 215, true
4563, 1566722151037, 10901, 1566722151249, 11113, 212, true
4564, 1566722151037, 10901, 1566722151252, 11116, 215, true
4565, 1566722151038, 10902, 1566722151250, 11114, 212, true
4566, 1566722151039, 10903, 1566722151252, 11116, 213, true
4567, 1566722151040, 10904, 1566722151252, 11116, 212, true
4568, 1566722151041, 10905, 1566722151252, 11116, 211, true
4569, 1566722151042, 10906, 1566722151252, 11116, 210, true
4570, 1566722151043, 10907, 1566722151252, 11116, 209, true
4571, 1566722151044, 10908, 1566722151250, 11114, 206, true
4572, 1566722151046, 10910, 1566722151253, 11117, 207, true
4573, 1566722151047, 10911, 1566722151256, 11120, 209, true
4574, 1566722151047, 10911, 1566722151257, 11121, 210, true
4575, 1566722151048, 10912, 1566722151255, 11119, 207, true
4576, 1566722151049, 10913, 1566722151257, 11121, 208, true
4577, 1566722151049, 10913, 1566722151257, 11121, 208, true
4578, 1566722151050, 10914, 1566722151257, 11121, 207, true
4579, 1566722151053, 10917, 1566722151257, 11121, 204, true
4580, 1566722151053, 10917, 1566722151270, 11134, 217, true
4581, 1566722151054, 10918, 1566722151262, 11126, 208, true
4582, 1566722151054, 10918, 1566722151262, 11126, 208, true
4583, 1566722151055, 10919, 1566722151266, 11130, 211, true
4584, 1566722151055, 10919, 1566722151264, 11128, 209, true
4585, 1566722151055, 10919, 1566722151270, 11134, 215, true
4586, 1566722151056, 10920, 1566722151311, 11175, 255, true
4587, 1566722151056, 10920, 1566722151301, 11165, 245, true
4588, 1566722151057, 10921, 1566722151312, 11176, 255, true
4589, 1566722151057, 10921, 1566722151347, 11211, 290, true
4590, 1566722151058, 10922, 1566722151318, 11182, 260, true
4591, 1566722151061, 10925, 1566722151301, 11165, 240, true
4592, 1566722151061, 10925, 1566722151300, 11164, 239, true
4593, 1566722151062, 10926, 1566722151317, 11181, 255, true
4594, 1566722151063, 10927, 1566722151318, 11182, 255, true
4595, 1566722151065, 10929, 1566722151299, 11163, 234, true
4596, 1566722151068, 10932, 1566722151308, 11172, 240, true
4597, 1566722151094, 10958, 1566722151343, 11207, 249, true
4598, 1566722151094, 10958, 1566722151336, 11200, 242, true
4599, 1566722151094, 10958, 1566722151338, 11202, 244, true
4600, 1566722151095, 10959, 1566722151341, 11205, 246, true
4601, 1566722151095, 10959, 1566722151368, 11232, 273, true
4602, 1566722151095, 10959, 1566722151362, 11226, 267, true
4603, 1566722151098, 10962, 1566722151374, 11238, 276, true
4604, 1566722151098, 10962, 1566722151354, 11218, 256, true
4605, 1566722151100, 10964, 1566722151368, 11232, 268, true
4606, 1566722151100, 10964, 1566722151367, 11231, 267, true
4607, 1566722151101, 10965, 1566722151367, 11231, 266, true
4608, 1566722151102, 10966, 1566722151374, 11238, 272, true
4609, 1566722151103, 10967, 1566722151374, 11238, 271, true
4610, 1566722151103, 10967, 1566722151348, 11212, 245, true
4611, 1566722151104, 10968, 1566722151358, 11222, 254, true
4612, 1566722151104, 10968, 1566722151367, 11231, 263, true
4613, 1566722151105, 10969, 1566722151374, 11238, 269, true
4614, 1566722151106, 10970, 1566722151349, 11213, 243, true
4615, 1566722151132, 10996, 1566722151374, 11238, 242, true
4616, 1566722151133, 10997, 1566722151370, 11234, 237, true
4617, 1566722151135, 10999, 1566722151368, 11232, 233, true
4618, 1566722151135, 10999, 1566722151358, 11222, 223, true
4619, 1566722151138, 11002, 1566722151367, 11231, 229, true
4620, 1566722151138, 11002, 1566722151348, 11212, 210, true
4621, 1566722151139, 11003, 1566722151368, 11232, 229, true
4622, 1566722151141, 11005, 1566722151369, 11233, 228, true
4623, 1566722151142, 11006, 1566722151368, 11232, 226, true
4624, 1566722151142, 11006, 1566722151362, 11226, 220, true
4625, 1566722151142, 11006, 1566722151380, 11244, 238, true
4626, 1566722151145, 11009, 1566722151370, 11234, 225, true
4627, 1566722151149, 11013, 1566722151374, 11238, 225, true
4628, 1566722151154, 11018, 1566722151374, 11238, 220, true
4629, 1566722151156, 11020, 1566722151374, 11238, 218, true
4630, 1566722151156, 11020, 1566722151369, 11233, 213, true
4631, 1566722151157, 11021, 1566722151380, 11244, 223, true
4632, 1566722151166, 11030, 1566722151383, 11247, 217, true
4633, 1566722151166, 11030, 1566722151380, 11244, 214, true
4634, 1566722151167, 11031, 1566722151383, 11247, 216, true
4635, 1566722151167, 11031, 1566722151375, 11239, 208, true
4636, 1566722151168, 11032, 1566722151380, 11244, 212, true
4637, 1566722151168, 11032, 1566722151388, 11252, 220, true
4638, 1566722151169, 11033, 1566722151375, 11239, 206, true
4639, 1566722151170, 11034, 1566722151380, 11244, 210, true
4640, 1566722151170, 11034, 1566722151382, 11246, 212, true
4641, 1566722151172, 11036, 1566722151383, 11247, 211, true
4642, 1566722151174, 11038, 1566722151389, 11253, 215, true
4643, 1566722151174, 11038, 1566722151398, 11262, 224, true
4644, 1566722151175, 11039, 1566722151393, 11257, 218, true
4645, 1566722151176, 11040, 1566722151397, 11261, 221, true
4646, 1566722151177, 11041, 1566722151398, 11262, 221, true
4647, 1566722151178, 11042, 1566722151399, 11263, 221, true
4648, 1566722151178, 11042, 1566722151398, 11262, 220, true
4649, 1566722151178, 11042, 1566722151398, 11262, 220, true
4650, 1566722151179, 11043, 1566722151401, 11265, 222, true
4651, 1566722151179, 11043, 1566722151399, 11263, 220, true
4652, 1566722151180, 11044, 1566722151400, 11264, 220, true
4653, 1566722151185, 11049, 1566722151400, 11264, 215, true
4654, 1566722151186, 11050, 1566722151400, 11264, 214, true
4655, 1566722151196, 11060, 1566722151404, 11268, 208, true
4656, 1566722151196, 11060, 1566722151404, 11268, 208, true
4657, 1566722151197, 11061, 1566722151402, 11266, 205, true
4658, 1566722151197, 11061, 1566722151404, 11268, 207, true
4659, 1566722151197, 11061, 1566722151404, 11268, 207, true
4660, 1566722151199, 11063, 1566722151405, 11269, 206, true
4661, 1566722151201, 11065, 1566722151405, 11269, 204, true
4662, 1566722151202, 11066, 1566722151406, 11270, 204, true
4663, 1566722151203, 11067, 1566722151415, 11279, 212, true
4664, 1566722151204, 11068, 1566722151410, 11274, 206, true
4665, 1566722151204, 11068, 1566722151414, 11278, 210, true
4666, 1566722151205, 11069, 1566722151413, 11277, 208, true
4667, 1566722151205, 11069, 1566722151414, 11278, 209, true
4668, 1566722151206, 11070, 1566722151410, 11274, 204, true
4669, 1566722151209, 11073, 1566722151415, 11279, 206, true
4670, 1566722151209, 11073, 1566722151418, 11282, 209, true
4671, 1566722151209, 11073, 1566722151416, 11280, 207, true
4672, 1566722151210, 11074, 1566722151416, 11280, 206, true
4673, 1566722151210, 11074, 1566722151418, 11282, 208, true
4674, 1566722151211, 11075, 1566722151420, 11284, 209, true
4675, 1566722151212, 11076, 1566722151420, 11284, 208, true
4676, 1566722151212, 11076, 1566722151420, 11284, 208, true
4677, 1566722151213, 11077, 1566722151421, 11285, 208, true
4678, 1566722151214, 11078, 1566722151433, 11297, 219, true
4679, 1566722151216, 11080, 1566722151434, 11298, 218, true
4680, 1566722151217, 11081, 1566722151434, 11298, 217, true
4681, 1566722151218, 11082, 1566722151434, 11298, 216, true
4682, 1566722151218, 11082, 1566722151434, 11298, 216, true
4683, 1566722151219, 11083, 1566722151434, 11298, 215, true
4684, 1566722151220, 11084, 1566722151434, 11298, 214, true
4685, 1566722151221, 11085, 1566722151434, 11298, 213, true
4686, 1566722151222, 11086, 1566722151434, 11298, 212, true
4687, 1566722151224, 11088, 1566722151434, 11298, 210, true
4688, 1566722151225, 11089, 1566722151434, 11298, 209, true
4689, 1566722151226, 11090, 1566722151436, 11300, 210, true
4690, 1566722151226, 11090, 1566722151434, 11298, 208, true
4691, 1566722151227, 11091, 1566722151436, 11300, 209, true
4692, 1566722151231, 11095, 1566722151436, 11300, 205, true
4693, 1566722151234, 11098, 1566722151438, 11302, 204, true
4694, 1566722151234, 11098, 1566722151438, 11302, 204, true
4695, 1566722151235, 11099, 1566722151438, 11302, 203, true
4696, 1566722151237, 11101, 1566722151447, 11311, 210, true
4697, 1566722151238, 11102, 1566722151443, 11307, 205, true
4698, 1566722151238, 11102, 1566722151449, 11313, 211, true
4699, 1566722151238, 11102, 1566722151453, 11317, 215, true
4700, 1566722151240, 11104, 1566722151453, 11317, 213, true
4701, 1566722151240, 11104, 1566722151449, 11313, 209, true
4702, 1566722151241, 11105, 1566722151451, 11315, 210, true
4703, 1566722151243, 11107, 1566722151453, 11317, 210, true
4704, 1566722151244, 11108, 1566722151460, 11324, 216, true
4705, 1566722151244, 11108, 1566722151456, 11320, 212, true
4706, 1566722151245, 11109, 1566722151462, 11326, 217, true
4707, 1566722151247, 11111, 1566722151462, 11326, 215, true
4708, 1566722151247, 11111, 1566722151466, 11330, 219, true
4709, 1566722151258, 11122, 1566722151467, 11331, 209, true
4710, 1566722151263, 11127, 1566722151467, 11331, 204, true
4711, 1566722151265, 11129, 1566722151471, 11335, 206, true
4712, 1566722151265, 11129, 1566722151475, 11339, 210, true
4713, 1566722151265, 11129, 1566722151471, 11335, 206, true
4714, 1566722151267, 11131, 1566722151476, 11340, 209, true
4715, 1566722151271, 11135, 1566722151479, 11343, 208, true
4716, 1566722151272, 11136, 1566722151483, 11347, 211, true
4717, 1566722151272, 11136, 1566722151478, 11342, 206, true
4718, 1566722151273, 11137, 1566722151478, 11342, 205, true
4719, 1566722151275, 11139, 1566722151486, 11350, 211, true
4720, 1566722151275, 11139, 1566722151485, 11349, 210, true
4721, 1566722151276, 11140, 1566722151483, 11347, 207, true
4722, 1566722151277, 11141, 1566722151490, 11354, 213, true
4723, 1566722151277, 11141, 1566722151490, 11354, 213, true
4724, 1566722151279, 11143, 1566722151486, 11350, 207, true
4725, 1566722151279, 11143, 1566722151486, 11350, 207, true
4726, 1566722151282, 11146, 1566722151490, 11354, 208, true
4727, 1566722151282, 11146, 1566722151490, 11354, 208, true
4728, 1566722151283, 11147, 1566722151490, 11354, 207, true
4729, 1566722151283, 11147, 1566722151490, 11354, 207, true
4730, 1566722151284, 11148, 1566722151490, 11354, 206, true
4731, 1566722151285, 11149, 1566722151490, 11354, 205, true
4732, 1566722151287, 11151, 1566722151494, 11358, 207, true
4733, 1566722151287, 11151, 1566722151497, 11361, 210, true
4734, 1566722151288, 11152, 1566722151502, 11366, 214, true
4735, 1566722151289, 11153, 1566722151502, 11366, 213, true
4736, 1566722151292, 11156, 1566722151500, 11364, 208, true
4737, 1566722151294, 11158, 1566722151500, 11364, 206, true
4738, 1566722151297, 11161, 1566722151503, 11367, 206, true
4739, 1566722151304, 11168, 1566722151511, 11375, 207, true
4740, 1566722151306, 11170, 1566722151516, 11380, 210, true
4741, 1566722151307, 11171, 1566722151518, 11382, 211, true
4742, 1566722151309, 11173, 1566722151514, 11378, 205, true
4743, 1566722151313, 11177, 1566722151517, 11381, 204, true
4744, 1566722151314, 11178, 1566722151518, 11382, 204, true
4745, 1566722151315, 11179, 1566722151522, 11386, 207, true
4746, 1566722151319, 11183, 1566722151529, 11393, 210, true
4747, 1566722151320, 11184, 1566722151524, 11388, 204, true
4748, 1566722151322, 11186, 1566722151529, 11393, 207, true
4749, 1566722151323, 11187, 1566722151528, 11392, 205, true
4750, 1566722151324, 11188, 1566722151529, 11393, 205, true
4751, 1566722151328, 11192, 1566722151535, 11399, 207, true
4752, 1566722151330, 11194, 1566722151535, 11399, 205, true
4753, 1566722151331, 11195, 1566722151536, 11400, 205, true
4754, 1566722151333, 11197, 1566722151538, 11402, 205, true
4755, 1566722151334, 11198, 1566722151540, 11404, 206, true
4756, 1566722151335, 11199, 1566722151539, 11403, 204, true
4757, 1566722151338, 11202, 1566722151542, 11406, 204, true
4758, 1566722151338, 11202, 1566722151542, 11406, 204, true
4759, 1566722151339, 11203, 1566722151548, 11412, 209, true
4760, 1566722151342, 11206, 1566722151545, 11409, 203, true
4761, 1566722151344, 11208, 1566722151550, 11414, 206, true
4762, 1566722151345, 11209, 1566722151554, 11418, 209, true
4763, 1566722151350, 11214, 1566722151556, 11420, 206, true
4764, 1566722151352, 11216, 1566722151556, 11420, 204, true
4765, 1566722151353, 11217, 1566722151556, 11420, 203, true
4766, 1566722151355, 11219, 1566722151558, 11422, 203, true
4767, 1566722151356, 11220, 1566722151559, 11423, 203, true
4768, 1566722151359, 11223, 1566722151568, 11432, 209, true
4769, 1566722151360, 11224, 1566722151567, 11431, 207, true
4770, 1566722151390, 11254, 1566722151599, 11463, 209, true
4771, 1566722151391, 11255, 1566722151599, 11463, 208, true
4772, 1566722151393, 11257, 1566722151599, 11463, 206, true
4773, 1566722151410, 11274, 1566722151621, 11485, 211, true
4774, 1566722151411, 11275, 1566722151620, 11484, 209, true
4775, 1566722151412, 11276, 1566722151621, 11485, 209, true
4776, 1566722151419, 11283, 1566722151633, 11497, 214, true
4777, 1566722151422, 11286, 1566722151633, 11497, 211, true
4778, 1566722151423, 11287, 1566722151642, 11506, 219, true
4779, 1566722151423, 11287, 1566722151637, 11501, 214, true
4780, 1566722151423, 11287, 1566722151639, 11503, 216, true
4781, 1566722151424, 11288, 1566722151630, 11494, 206, true
4782, 1566722151425, 11289, 1566722151659, 11523, 234, true
4783, 1566722151425, 11289, 1566722151647, 11511, 222, true
4784, 1566722151426, 11290, 1566722151660, 11524, 234, true
4785, 1566722151427, 11291, 1566722151658, 11522, 231, true
4786, 1566722151427, 11291, 1566722151661, 11525, 234, true
4787, 1566722151428, 11292, 1566722151669, 11533, 241, true
4788, 1566722151428, 11292, 1566722151665, 11529, 237, true
4789, 1566722151430, 11294, 1566722151644, 11508, 214, true
4790, 1566722151439, 11303, 1566722151659, 11523, 220, true
4791, 1566722151440, 11304, 1566722151658, 11522, 218, true
4792, 1566722151440, 11304, 1566722151650, 11514, 210, true
4793, 1566722151440, 11304, 1566722151735, 11599, 295, true
4794, 1566722151440, 11304, 1566722151741, 11605, 301, true
4795, 1566722151441, 11305, 1566722151741, 11605, 300, true
4796, 1566722151442, 11306, 1566722151740, 11604, 298, true
4797, 1566722151442, 11306, 1566722151740, 11604, 298, true
4798, 1566722151442, 11306, 1566722151741, 11605, 299, true
4799, 1566722151444, 11308, 1566722151741, 11605, 297, true
4800, 1566722151444, 11308, 1566722151730, 11594, 286, true
4801, 1566722151450, 11314, 1566722151741, 11605, 291, true
4802, 1566722151453, 11317, 1566722151736, 11600, 283, true
4803, 1566722151454, 11318, 1566722151741, 11605, 287, true
4804, 1566722151454, 11318, 1566722151734, 11598, 280, true
4805, 1566722151455, 11319, 1566722151736, 11600, 281, true
4806, 1566722151458, 11322, 1566722151742, 11606, 284, true
4807, 1566722151459, 11323, 1566722151734, 11598, 275, true
4808, 1566722151460, 11324, 1566722151737, 11601, 277, true
4809, 1566722151461, 11325, 1566722151740, 11604, 279, true
4810, 1566722151462, 11326, 1566722151742, 11606, 280, true
4811, 1566722151463, 11327, 1566722151737, 11601, 274, true
4812, 1566722151463, 11327, 1566722151794, 11658, 331, true
4813, 1566722151464, 11328, 1566722151772, 11636, 308, true
4814, 1566722151465, 11329, 1566722151793, 11657, 328, true
4815, 1566722151465, 11329, 1566722151785, 11649, 320, true
4816, 1566722151466, 11330, 1566722151795, 11659, 329, true
4817, 1566722151466, 11330, 1566722151785, 11649, 319, true
4818, 1566722151467, 11331, 1566722151795, 11659, 328, true
4819, 1566722151467, 11331, 1566722151786, 11650, 319, true
4820, 1566722151468, 11332, 1566722151774, 11638, 306, true
4821, 1566722151468, 11332, 1566722151786, 11650, 318, true
4822, 1566722151468, 11332, 1566722151785, 11649, 317, true
4823, 1566722151468, 11332, 1566722151752, 11616, 284, true
4824, 1566722151469, 11333, 1566722151762, 11626, 293, true
4825, 1566722151469, 11333, 1566722151758, 11622, 289, true
4826, 1566722151470, 11334, 1566722151786, 11650, 316, true
4827, 1566722151471, 11335, 1566722151761, 11625, 290, true
4828, 1566722151471, 11335, 1566722151761, 11625, 290, true
4829, 1566722151471, 11335, 1566722151792, 11656, 321, true
4830, 1566722151471, 11335, 1566722151793, 11657, 322, true
4831, 1566722151472, 11336, 1566722151772, 11636, 300, true
4832, 1566722151472, 11336, 1566722151772, 11636, 300, true
4833, 1566722151472, 11336, 1566722151773, 11637, 301, true
4834, 1566722151473, 11337, 1566722151760, 11624, 287, true
4835, 1566722151473, 11337, 1566722151761, 11625, 288, true
4836, 1566722151473, 11337, 1566722151766, 11630, 293, true
4837, 1566722151474, 11338, 1566722151760, 11624, 286, true
4838, 1566722151474, 11338, 1566722151800, 11664, 326, true
4839, 1566722151475, 11339, 1566722151792, 11656, 317, true
4840, 1566722151476, 11340, 1566722151752, 11616, 276, true
4841, 1566722151476, 11340, 1566722151759, 11623, 283, true
4842, 1566722151477, 11341, 1566722151758, 11622, 281, true
4843, 1566722151478, 11342, 1566722151785, 11649, 307, true
4844, 1566722151479, 11343, 1566722151792, 11656, 313, true
4845, 1566722151479, 11343, 1566722151776, 11640, 297, true
4846, 1566722151480, 11344, 1566722151795, 11659, 315, true
4847, 1566722151480, 11344, 1566722151795, 11659, 315, true
4848, 1566722151480, 11344, 1566722151758, 11622, 278, true
4849, 1566722151480, 11344, 1566722151772, 11636, 292, true
4850, 1566722151480, 11344, 1566722151795, 11659, 315, true
4851, 1566722151481, 11345, 1566722151772, 11636, 291, true
4852, 1566722151481, 11345, 1566722151786, 11650, 305, true
4853, 1566722151482, 11346, 1566722151800, 11664, 318, true
4854, 1566722151482, 11346, 1566722151792, 11656, 310, true
4855, 1566722151483, 11347, 1566722151792, 11656, 309, true
4856, 1566722151484, 11348, 1566722151814, 11678, 330, true
4857, 1566722151484, 11348, 1566722151766, 11630, 282, true
4858, 1566722151485, 11349, 1566722151773, 11637, 288, true
4859, 1566722151486, 11350, 1566722151785, 11649, 299, true
4860, 1566722151486, 11350, 1566722151793, 11657, 307, true
4861, 1566722151487, 11351, 1566722151771, 11635, 284, true
4862, 1566722151489, 11353, 1566722151758, 11622, 269, true
4863, 1566722151490, 11354, 1566722151793, 11657, 303, true
4864, 1566722151491, 11355, 1566722151792, 11656, 301, true
4865, 1566722151491, 11355, 1566722151773, 11637, 282, true
4866, 1566722151491, 11355, 1566722151793, 11657, 302, true
4867, 1566722151491, 11355, 1566722151752, 11616, 261, true
4868, 1566722151491, 11355, 1566722151784, 11648, 293, true
4869, 1566722151492, 11356, 1566722151784, 11648, 292, true
4870, 1566722151492, 11356, 1566722151765, 11629, 273, true
4871, 1566722151492, 11356, 1566722151786, 11650, 294, true
4872, 1566722151492, 11356, 1566722151776, 11640, 284, true
4873, 1566722151492, 11356, 1566722151773, 11637, 281, true
4874, 1566722151494, 11358, 1566722151749, 11613, 255, true
4875, 1566722151495, 11359, 1566722151758, 11622, 263, true
4876, 1566722151495, 11359, 1566722151794, 11658, 299, true
4877, 1566722151496, 11360, 1566722151758, 11622, 262, true
4878, 1566722151496, 11360, 1566722151783, 11647, 287, true
4879, 1566722151496, 11360, 1566722151795, 11659, 299, true
4880, 1566722151497, 11361, 1566722151792, 11656, 295, true
4881, 1566722151498, 11362, 1566722151747, 11611, 249, true
4882, 1566722151498, 11362, 1566722151800, 11664, 302, true
4883, 1566722151498, 11362, 1566722151758, 11622, 260, true
4884, 1566722151498, 11362, 1566722151751, 11615, 253, true
4885, 1566722151499, 11363, 1566722151771, 11635, 272, true
4886, 1566722151500, 11364, 1566722151759, 11623, 259, true
4887, 1566722151500, 11364, 1566722151784, 11648, 284, true
4888, 1566722151501, 11365, 1566722151786, 11650, 285, true
4889, 1566722151502, 11366, 1566722151783, 11647, 281, true
4890, 1566722151502, 11366, 1566722151758, 11622, 256, true
4891, 1566722151503, 11367, 1566722151774, 11638, 271, true
4892, 1566722151503, 11367, 1566722151786, 11650, 283, true
4893, 1566722151503, 11367, 1566722151765, 11629, 262, true
4894, 1566722151504, 11368, 1566722151758, 11622, 254, true
4895, 1566722151504, 11368, 1566722151785, 11649, 281, true
4896, 1566722151504, 11368, 1566722151793, 11657, 289, true
4897, 1566722151505, 11369, 1566722151786, 11650, 281, true
4898, 1566722151505, 11369, 1566722151784, 11648, 279, true
4899, 1566722151505, 11369, 1566722151792, 11656, 287, true
4900, 1566722151505, 11369, 1566722151793, 11657, 288, true
4901, 1566722151506, 11370, 1566722151786, 11650, 280, true
4902, 1566722151506, 11370, 1566722151792, 11656, 286, true
4903, 1566722151507, 11371, 1566722151784, 11648, 277, true
4904, 1566722151507, 11371, 1566722151759, 11623, 252, true
4905, 1566722151507, 11371, 1566722151758, 11622, 251, true
4906, 1566722151508, 11372, 1566722151776, 11640, 268, true
4907, 1566722151508, 11372, 1566722151772, 11636, 264, true
4908, 1566722151508, 11372, 1566722151748, 11612, 240, true
4909, 1566722151509, 11373, 1566722151786, 11650, 277, true
4910, 1566722151509, 11373, 1566722151760, 11624, 251, true
4911, 1566722151511, 11375, 1566722151759, 11623, 248, true
4912, 1566722151511, 11375, 1566722151765, 11629, 254, true
4913, 1566722151512, 11376, 1566722151760, 11624, 248, true
4914, 1566722151512, 11376, 1566722151765, 11629, 253, true
4915, 1566722151512, 11376, 1566722151795, 11659, 283, true
4916, 1566722151512, 11376, 1566722151784, 11648, 272, true
4917, 1566722151513, 11377, 1566722151772, 11636, 259, true
4918, 1566722151513, 11377, 1566722151795, 11659, 282, true
4919, 1566722151514, 11378, 1566722151785, 11649, 271, true
4920, 1566722151515, 11379, 1566722151765, 11629, 250, true
4921, 1566722151515, 11379, 1566722151786, 11650, 271, true
4922, 1566722151516, 11380, 1566722151765, 11629, 249, true
4923, 1566722151517, 11381, 1566722151765, 11629, 248, true
4924, 1566722151517, 11381, 1566722151793, 11657, 276, true
4925, 1566722151518, 11382, 1566722151771, 11635, 253, true
4926, 1566722151519, 11383, 1566722151758, 11622, 239, true
4927, 1566722151519, 11383, 1566722151752, 11616, 233, true
4928, 1566722151519, 11383, 1566722151784, 11648, 265, true
4929, 1566722151519, 11383, 1566722151771, 11635, 252, true
4930, 1566722151520, 11384, 1566722151772, 11636, 252, true
4931, 1566722151520, 11384, 1566722151785, 11649, 265, true
4932, 1566722151520, 11384, 1566722151784, 11648, 264, true
4933, 1566722151521, 11385, 1566722151772, 11636, 251, true
4934, 1566722151522, 11386, 1566722151776, 11640, 254, true
4935, 1566722151523, 11387, 1566722151760, 11624, 237, true
4936, 1566722151523, 11387, 1566722151793, 11657, 270, true
4937, 1566722151524, 11388, 1566722151774, 11638, 250, true
4938, 1566722151532, 11396, 1566722151801, 11665, 269, true
4939, 1566722151537, 11401, 1566722151802, 11666, 265, true
4940, 1566722151539, 11403, 1566722151802, 11666, 263, true
4941, 1566722151540, 11404, 1566722151801, 11665, 261, true
4942, 1566722151540, 11404, 1566722151802, 11666, 262, true
4943, 1566722151541, 11405, 1566722151802, 11666, 261, true
4944, 1566722151543, 11407, 1566722151800, 11664, 257, true
4945, 1566722151544, 11408, 1566722151803, 11667, 259, true
4946, 1566722151545, 11409, 1566722151801, 11665, 256, true
4947, 1566722151560, 11424, 1566722151813, 11677, 253, true
4948, 1566722151570, 11434, 1566722151803, 11667, 233, true
4949, 1566722151583, 11447, 1566722151803, 11667, 220, true
4950, 1566722151584, 11448, 1566722151801, 11665, 217, true
4951, 1566722151584, 11448, 1566722151802, 11666, 218, true
4952, 1566722151585, 11449, 1566722151801, 11665, 216, true
4953, 1566722151585, 11449, 1566722151801, 11665, 216, true
4954, 1566722151585, 11449, 1566722151801, 11665, 216, true
4955, 1566722151586, 11450, 1566722151801, 11665, 215, true
4956, 1566722151586, 11450, 1566722151801, 11665, 215, true
4957, 1566722151586, 11450, 1566722151803, 11667, 217, true
4958, 1566722151592, 11456, 1566722151805, 11669, 213, true
4959, 1566722151592, 11456, 1566722151806, 11670, 214, true
4960, 1566722151593, 11457, 1566722151805, 11669, 212, true
4961, 1566722151593, 11457, 1566722151806, 11670, 213, true
4962, 1566722151594, 11458, 1566722151805, 11669, 211, true
4963, 1566722151595, 11459, 1566722151813, 11677, 218, true
4964, 1566722151596, 11460, 1566722151812, 11676, 216, true
4965, 1566722151596, 11460, 1566722151806, 11670, 210, true
4966, 1566722151600, 11464, 1566722151812, 11676, 212, true
4967, 1566722151601, 11465, 1566722151812, 11676, 211, true
4968, 1566722151601, 11465, 1566722151812, 11676, 211, true
4969, 1566722151602, 11466, 1566722151813, 11677, 211, true
4970, 1566722151602, 11466, 1566722151813, 11677, 211, true
4971, 1566722151602, 11466, 1566722151812, 11676, 210, true
4972, 1566722151603, 11467, 1566722151813, 11677, 210, true
4973, 1566722151604, 11468, 1566722151813, 11677, 209, true
4974, 1566722151605, 11469, 1566722151813, 11677, 208, true
4975, 1566722151606, 11470, 1566722151813, 11677, 207, true
4976, 1566722151606, 11470, 1566722151813, 11677, 207, true
4977, 1566722151608, 11472, 1566722151814, 11678, 206, true
4978, 1566722151609, 11473, 1566722151819, 11683, 210, true
4979, 1566722151610, 11474, 1566722151819, 11683, 209, true
4980, 1566722151611, 11475, 1566722151820, 11684, 209, true
4981, 1566722151612, 11476, 1566722151819, 11683, 207, true
4982, 1566722151612, 11476, 1566722151819, 11683, 207, true
4983, 1566722151614, 11478, 1566722151820, 11684, 206, true
4984, 1566722151614, 11478, 1566722151820, 11684, 206, true
4985, 1566722151615, 11479, 1566722151820, 11684, 205, true
4986, 1566722151616, 11480, 1566722151821, 11685, 205, true
4987, 1566722151617, 11481, 1566722151821, 11685, 204, true
4988, 1566722151618, 11482, 1566722151838, 11702, 220, true
4989, 1566722151619, 11483, 1566722151829, 11693, 210, true
4990, 1566722151619, 11483, 1566722151834, 11698, 215, true
4991, 1566722151622, 11486, 1566722151826, 11690, 204, true
4992, 1566722151622, 11486, 1566722151826, 11690, 204, true
4993, 1566722151622, 11486, 1566722151827, 11691, 205, true
4994, 1566722151623, 11487, 1566722151828, 11692, 205, true
4995, 1566722151623, 11487, 1566722151834, 11698, 211, true
4996, 1566722151624, 11488, 1566722151834, 11698, 210, true
4997, 1566722151625, 11489, 1566722151844, 11708, 219, true
4998, 1566722151626, 11490, 1566722151850, 11714, 224, true
4999, 1566722151627, 11491, 1566722151850, 11714, 223, true
5000, 1566722151628, 11492, 1566722151844, 11708, 216, true
5001, 1566722151629, 11493, 1566722151843, 11707, 214, true
5002, 1566722151633, 11497, 1566722151844, 11708, 211, true
5003, 1566722151639, 11503, 1566722151844, 11708, 205, true
5004, 1566722151640, 11504, 1566722151851, 11715, 211, true
5005, 1566722151642, 11506, 1566722151851, 11715, 209, true
5006, 1566722151643, 11507, 1566722151853, 11717, 210, true
5007, 1566722151643, 11507, 1566722151851, 11715, 208, true
5008, 1566722151646, 11510, 1566722151851, 11715, 205, true
5009, 1566722151647, 11511, 1566722151860, 11724, 213, true
5010, 1566722151648, 11512, 1566722151866, 11730, 218, true
5011, 1566722151654, 11518, 1566722151900, 11764, 246, true
5012, 1566722151655, 11519, 1566722151874, 11738, 219, true
5013, 1566722151663, 11527, 1566722151889, 11753, 226, true
5014, 1566722151671, 11535, 1566722151913, 11777, 242, true
5015, 1566722151674, 11538, 1566722151913, 11777, 239, true
5016, 1566722151678, 11542, 1566722151898, 11762, 220, true
5017, 1566722151680, 11544, 1566722151913, 11777, 233, true
5018, 1566722151684, 11548, 1566722151913, 11777, 229, true
5019, 1566722151685, 11549, 1566722151899, 11763, 214, true
5020, 1566722151690, 11554, 1566722151900, 11764, 210, true
5021, 1566722151693, 11557, 1566722151900, 11764, 207, true
5022, 1566722151697, 11561, 1566722151913, 11777, 216, true
5023, 1566722151701, 11565, 1566722151913, 11777, 212, true
5024, 1566722151704, 11568, 1566722151913, 11777, 209, true
5025, 1566722151706, 11570, 1566722151913, 11777, 207, true
5026, 1566722151709, 11573, 1566722151915, 11779, 206, true
5027, 1566722151711, 11575, 1566722151919, 11783, 208, true
5028, 1566722151713, 11577, 1566722151921, 11785, 208, true
5029, 1566722151714, 11578, 1566722151920, 11784, 206, true
5030, 1566722151717, 11581, 1566722151921, 11785, 204, true
5031, 1566722151720, 11584, 1566722151924, 11788, 204, true
5032, 1566722151722, 11586, 1566722151926, 11790, 204, true
5033, 1566722151724, 11588, 1566722151929, 11793, 205, true
5034, 1566722151729, 11593, 1566722151934, 11798, 205, true
5035, 1566722151731, 11595, 1566722151938, 11802, 207, true
5036, 1566722151845, 11709, 1566722152058, 11922, 213, true
5037, 1566722151856, 11720, 1566722152069, 11933, 213, true
5038, 1566722151856, 11720, 1566722152069, 11933, 213, true
5039, 1566722151856, 11720, 1566722152061, 11925, 205, true
5040, 1566722151857, 11721, 1566722152061, 11925, 204, true
5041, 1566722151857, 11721, 1566722152069, 11933, 212, true
5042, 1566722151858, 11722, 1566722152069, 11933, 211, true
5043, 1566722151859, 11723, 1566722152069, 11933, 210, true
5044, 1566722151859, 11723, 1566722152069, 11933, 210, true
5045, 1566722151859, 11723, 1566722152069, 11933, 210, true
5046, 1566722151860, 11724, 1566722152069, 11933, 209, true
5047, 1566722151862, 11726, 1566722152069, 11933, 207, true
5048, 1566722151862, 11726, 1566722152069, 11933, 207, true
5049, 1566722151862, 11726, 1566722152069, 11933, 207, true
5050, 1566722151863, 11727, 1566722152069, 11933, 206, true
5051, 1566722151865, 11729, 1566722152074, 11938, 209, true
5052, 1566722151865, 11729, 1566722152074, 11938, 209, true
5053, 1566722151865, 11729, 1566722152074, 11938, 209, true
5054, 1566722151866, 11730, 1566722152069, 11933, 203, true
5055, 1566722151866, 11730, 1566722152074, 11938, 208, true
5056, 1566722151867, 11731, 1566722152075, 11939, 208, true
5057, 1566722151868, 11732, 1566722152075, 11939, 207, true
5058, 1566722151868, 11732, 1566722152075, 11939, 207, true
5059, 1566722151868, 11732, 1566722152075, 11939, 207, true
5060, 1566722151870, 11734, 1566722152078, 11942, 208, true
5061, 1566722151872, 11736, 1566722152079, 11943, 207, true
5062, 1566722151873, 11737, 1566722152079, 11943, 206, true
5063, 1566722151874, 11738, 1566722152079, 11943, 205, true
5064, 1566722151874, 11738, 1566722152080, 11944, 206, true
5065, 1566722151875, 11739, 1566722152081, 11945, 206, true
5066, 1566722151876, 11740, 1566722152090, 11954, 214, true
5067, 1566722151877, 11741, 1566722152090, 11954, 213, true
5068, 1566722151877, 11741, 1566722152087, 11951, 210, true
5069, 1566722151878, 11742, 1566722152091, 11955, 213, true
5070, 1566722151879, 11743, 1566722152084, 11948, 205, true
5071, 1566722151880, 11744, 1566722152087, 11951, 207, true
5072, 1566722151880, 11744, 1566722152104, 11968, 224, true
5073, 1566722151881, 11745, 1566722152091, 11955, 210, true
5074, 1566722151882, 11746, 1566722152092, 11956, 210, true
5075, 1566722151882, 11746, 1566722152111, 11975, 229, true
5076, 1566722151883, 11747, 1566722152090, 11954, 207, true
5077, 1566722151884, 11748, 1566722152111, 11975, 227, true
5078, 1566722151889, 11753, 1566722152111, 11975, 222, true
5079, 1566722151893, 11757, 1566722152112, 11976, 219, true
5080, 1566722151894, 11758, 1566722152112, 11976, 218, true
5081, 1566722151894, 11758, 1566722152112, 11976, 218, true
5082, 1566722151895, 11759, 1566722152107, 11971, 212, true
5083, 1566722151895, 11759, 1566722152112, 11976, 217, true
5084, 1566722151896, 11760, 1566722152108, 11972, 212, true
5085, 1566722151900, 11764, 1566722152107, 11971, 207, true
5086, 1566722151901, 11765, 1566722152112, 11976, 211, true
5087, 1566722151901, 11765, 1566722152112, 11976, 211, true
5088, 1566722151901, 11765, 1566722152108, 11972, 207, true
5089, 1566722151902, 11766, 1566722152112, 11976, 210, true
5090, 1566722151905, 11769, 1566722152117, 11981, 212, true
5091, 1566722151906, 11770, 1566722152116, 11980, 210, true
5092, 1566722151906, 11770, 1566722152118, 11982, 212, true
5093, 1566722151916, 11780, 1566722152123, 11987, 207, true
5094, 1566722151917, 11781, 1566722152120, 11984, 203, true
5095, 1566722151917, 11781, 1566722152123, 11987, 206, true
5096, 1566722151917, 11781, 1566722152123, 11987, 206, true
5097, 1566722151917, 11781, 1566722152123, 11987, 206, true
5098, 1566722151921, 11785, 1566722152124, 11988, 203, true
5099, 1566722151921, 11785, 1566722152124, 11988, 203, true
5100, 1566722151922, 11786, 1566722152125, 11989, 203, true
5101, 1566722151922, 11786, 1566722152127, 11991, 205, true
5102, 1566722151923, 11787, 1566722152130, 11994, 207, true
5103, 1566722151924, 11788, 1566722152129, 11993, 205, true
5104, 1566722151925, 11789, 1566722152132, 11996, 207, true
5105, 1566722151927, 11791, 1566722152131, 11995, 204, true
5106, 1566722151930, 11794, 1566722152140, 12004, 210, true
5107, 1566722151930, 11794, 1566722152143, 12007, 213, true
5108, 1566722151931, 11795, 1566722152143, 12007, 212, true
5109, 1566722151931, 11795, 1566722152140, 12004, 209, true
5110, 1566722151932, 11796, 1566722152143, 12007, 211, true
5111, 1566722151932, 11796, 1566722152143, 12007, 211, true
5112, 1566722151932, 11796, 1566722152143, 12007, 211, true
5113, 1566722151933, 11797, 1566722152140, 12004, 207, true
5114, 1566722151933, 11797, 1566722152143, 12007, 210, true
5115, 1566722151933, 11797, 1566722152140, 12004, 207, true
5116, 1566722151934, 11798, 1566722152142, 12006, 208, true
5117, 1566722151934, 11798, 1566722152143, 12007, 209, true
5118, 1566722151934, 11798, 1566722152140, 12004, 206, true
5119, 1566722151938, 11802, 1566722152148, 12012, 210, true
5120, 1566722151939, 11803, 1566722152148, 12012, 209, true
5121, 1566722151939, 11803, 1566722152153, 12017, 214, true
5122, 1566722151940, 11804, 1566722152145, 12009, 205, true
5123, 1566722151940, 11804, 1566722152170, 12034, 230, true
5124, 1566722151941, 11805, 1566722152159, 12023, 218, true
5125, 1566722151941, 11805, 1566722152159, 12023, 218, true
5126, 1566722151942, 11806, 1566722152155, 12019, 213, true
5127, 1566722151943, 11807, 1566722152153, 12017, 210, true
5128, 1566722151944, 11808, 1566722152159, 12023, 215, true
5129, 1566722151945, 11809, 1566722152159, 12023, 214, true
5130, 1566722151945, 11809, 1566722152160, 12024, 215, true
5131, 1566722151946, 11810, 1566722152155, 12019, 209, true
5132, 1566722151947, 11811, 1566722152159, 12023, 212, true
5133, 1566722151947, 11811, 1566722152155, 12019, 208, true
5134, 1566722151947, 11811, 1566722152159, 12023, 212, true
5135, 1566722151948, 11812, 1566722152156, 12020, 208, true
5136, 1566722151948, 11812, 1566722152159, 12023, 211, true
5137, 1566722151948, 11812, 1566722152156, 12020, 208, true
5138, 1566722151953, 11817, 1566722152168, 12032, 215, true
5139, 1566722151954, 11818, 1566722152159, 12023, 205, true
5140, 1566722151954, 11818, 1566722152168, 12032, 214, true
5141, 1566722151954, 11818, 1566722152170, 12034, 216, true
5142, 1566722151955, 11819, 1566722152169, 12033, 214, true
5143, 1566722151956, 11820, 1566722152166, 12030, 210, true
5144, 1566722151956, 11820, 1566722152165, 12029, 209, true
5145, 1566722151956, 11820, 1566722152175, 12039, 219, true
5146, 1566722151959, 11823, 1566722152169, 12033, 210, true
5147, 1566722151960, 11824, 1566722152230, 12094, 270, true
5148, 1566722151961, 11825, 1566722152180, 12044, 219, true
5149, 1566722151961, 11825, 1566722152178, 12042, 217, true
5150, 1566722151962, 11826, 1566722152228, 12092, 266, true
5151, 1566722151963, 11827, 1566722152232, 12096, 269, true
5152, 1566722151964, 11828, 1566722152176, 12040, 212, true
5153, 1566722151964, 11828, 1566722152232, 12096, 268, true
5154, 1566722151965, 11829, 1566722152232, 12096, 267, true
5155, 1566722151966, 11830, 1566722152232, 12096, 266, true
5156, 1566722151966, 11830, 1566722152179, 12043, 213, true
5157, 1566722151967, 11831, 1566722152228, 12092, 261, true
5158, 1566722151968, 11832, 1566722152175, 12039, 207, true
5159, 1566722151968, 11832, 1566722152232, 12096, 264, true
5160, 1566722151969, 11833, 1566722152232, 12096, 263, true
5161, 1566722151971, 11835, 1566722152289, 12153, 318, true
5162, 1566722151972, 11836, 1566722152277, 12141, 305, true
5163, 1566722151973, 11837, 1566722152256, 12120, 283, true
5164, 1566722151973, 11837, 1566722152235, 12099, 262, true
5165, 1566722151974, 11838, 1566722152284, 12148, 310, true
5166, 1566722151975, 11839, 1566722152274, 12138, 299, true
5167, 1566722151976, 11840, 1566722152267, 12131, 291, true
5168, 1566722151976, 11840, 1566722152289, 12153, 313, true
5169, 1566722151977, 11841, 1566722152290, 12154, 313, true
5170, 1566722151978, 11842, 1566722152304, 12168, 326, true
5171, 1566722151978, 11842, 1566722152241, 12105, 263, true
5172, 1566722151978, 11842, 1566722152248, 12112, 270, true
5173, 1566722151978, 11842, 1566722152304, 12168, 326, true
5174, 1566722151979, 11843, 1566722152256, 12120, 277, true
5175, 1566722151979, 11843, 1566722152287, 12151, 308, true
5176, 1566722151979, 11843, 1566722152267, 12131, 288, true
5177, 1566722151979, 11843, 1566722152276, 12140, 297, true
5178, 1566722151980, 11844, 1566722152248, 12112, 268, true
5179, 1566722151980, 11844, 1566722152277, 12141, 297, true
5180, 1566722151981, 11845, 1566722152277, 12141, 296, true
5181, 1566722151981, 11845, 1566722152276, 12140, 295, true
5182, 1566722151981, 11845, 1566722152248, 12112, 267, true
5183, 1566722151981, 11845, 1566722152274, 12138, 293, true
5184, 1566722151982, 11846, 1566722152256, 12120, 274, true
5185, 1566722151982, 11846, 1566722152248, 12112, 266, true
5186, 1566722151982, 11846, 1566722152256, 12120, 274, true
5187, 1566722151982, 11846, 1566722152251, 12115, 269, true
5188, 1566722151983, 11847, 1566722152303, 12167, 320, true
5189, 1566722151983, 11847, 1566722152274, 12138, 291, true
5190, 1566722151984, 11848, 1566722152276, 12140, 292, true
5191, 1566722151984, 11848, 1566722152263, 12127, 279, true
5192, 1566722151985, 11849, 1566722152303, 12167, 318, true
5193, 1566722151985, 11849, 1566722152256, 12120, 271, true
5194, 1566722151985, 11849, 1566722152276, 12140, 291, true
5195, 1566722151985, 11849, 1566722152304, 12168, 319, true
5196, 1566722151986, 11850, 1566722152240, 12104, 254, true
5197, 1566722151986, 11850, 1566722152303, 12167, 317, true
5198, 1566722151986, 11850, 1566722152275, 12139, 289, true
5199, 1566722151987, 11851, 1566722152275, 12139, 288, true
5200, 1566722151987, 11851, 1566722152256, 12120, 269, true
5201, 1566722151988, 11852, 1566722152276, 12140, 288, true
5202, 1566722151988, 11852, 1566722152279, 12143, 291, true
5203, 1566722151988, 11852, 1566722152289, 12153, 301, true
5204, 1566722151989, 11853, 1566722152274, 12138, 285, true
5205, 1566722151989, 11853, 1566722152240, 12104, 251, true
5206, 1566722151989, 11853, 1566722152275, 12139, 286, true
5207, 1566722151990, 11854, 1566722152248, 12112, 258, true
5208, 1566722151990, 11854, 1566722152303, 12167, 313, true
5209, 1566722151990, 11854, 1566722152277, 12141, 287, true
5210, 1566722151990, 11854, 1566722152256, 12120, 266, true
5211, 1566722151991, 11855, 1566722152285, 12149, 294, true
5212, 1566722151991, 11855, 1566722152303, 12167, 312, true
5213, 1566722151991, 11855, 1566722152279, 12143, 288, true
5214, 1566722151992, 11856, 1566722152278, 12142, 286, true
5215, 1566722151992, 11856, 1566722152285, 12149, 293, true
5216, 1566722151992, 11856, 1566722152275, 12139, 283, true
5217, 1566722151992, 11856, 1566722152243, 12107, 251, true
5218, 1566722151993, 11857, 1566722152305, 12169, 312, true
5219, 1566722151993, 11857, 1566722152264, 12128, 271, true
5220, 1566722151993, 11857, 1566722152303, 12167, 310, true
5221, 1566722151993, 11857, 1566722152244, 12108, 251, true
5222, 1566722151994, 11858, 1566722152239, 12103, 245, true
5223, 1566722151994, 11858, 1566722152287, 12151, 293, true
5224, 1566722151994, 11858, 1566722152267, 12131, 273, true
5225, 1566722151994, 11858, 1566722152266, 12130, 272, true
5226, 1566722151995, 11859, 1566722152263, 12127, 268, true
5227, 1566722151995, 11859, 1566722152256, 12120, 261, true
5228, 1566722151995, 11859, 1566722152275, 12139, 280, true
5229, 1566722151995, 11859, 1566722152279, 12143, 284, true
5230, 1566722151996, 11860, 1566722152262, 12126, 266, true
5231, 1566722151996, 11860, 1566722152255, 12119, 259, true
5232, 1566722151996, 11860, 1566722152262, 12126, 266, true
5233, 1566722151996, 11860, 1566722152240, 12104, 244, true
5234, 1566722151997, 11861, 1566722152240, 12104, 243, true
5235, 1566722151997, 11861, 1566722152287, 12151, 290, true
5236, 1566722151997, 11861, 1566722152277, 12141, 280, true
5237, 1566722151998, 11862, 1566722152303, 12167, 305, true
5238, 1566722151998, 11862, 1566722152256, 12120, 258, true
5239, 1566722151998, 11862, 1566722152244, 12108, 246, true
5240, 1566722151998, 11862, 1566722152240, 12104, 242, true
5241, 1566722151999, 11863, 1566722152304, 12168, 305, true
5242, 1566722151999, 11863, 1566722152274, 12138, 275, true
5243, 1566722152000, 11864, 1566722152248, 12112, 248, true
5244, 1566722152000, 11864, 1566722152277, 12141, 277, true
5245, 1566722152000, 11864, 1566722152285, 12149, 285, true
5246, 1566722152001, 11865, 1566722152286, 12150, 285, true
5247, 1566722152001, 11865, 1566722152304, 12168, 303, true
5248, 1566722152001, 11865, 1566722152248, 12112, 247, true
5249, 1566722152001, 11865, 1566722152256, 12120, 255, true
5250, 1566722152001, 11865, 1566722152266, 12130, 265, true
5251, 1566722152002, 11866, 1566722152267, 12131, 265, true
5252, 1566722152002, 11866, 1566722152265, 12129, 263, true
5253, 1566722152003, 11867, 1566722152251, 12115, 248, true
5254, 1566722152003, 11867, 1566722152276, 12140, 273, true
5255, 1566722152003, 11867, 1566722152275, 12139, 272, true
5256, 1566722152004, 11868, 1566722152248, 12112, 244, true
5257, 1566722152005, 11869, 1566722152282, 12146, 277, true
5258, 1566722152005, 11869, 1566722152255, 12119, 250, true
5259, 1566722152006, 11870, 1566722152276, 12140, 270, true
5260, 1566722152007, 11871, 1566722152303, 12167, 296, true
5261, 1566722152007, 11871, 1566722152304, 12168, 297, true
5262, 1566722152007, 11871, 1566722152274, 12138, 267, true
5263, 1566722152008, 11872, 1566722152274, 12138, 266, true
5264, 1566722152008, 11872, 1566722152290, 12154, 282, true
5265, 1566722152009, 11873, 1566722152255, 12119, 246, true
5266, 1566722152009, 11873, 1566722152287, 12151, 278, true
5267, 1566722152009, 11873, 1566722152240, 12104, 231, true
5268, 1566722152010, 11874, 1566722152258, 12122, 248, true
5269, 1566722152010, 11874, 1566722152276, 12140, 266, true
5270, 1566722152010, 11874, 1566722152265, 12129, 255, true
5271, 1566722152011, 11875, 1566722152240, 12104, 229, true
5272, 1566722152011, 11875, 1566722152274, 12138, 263, true
5273, 1566722152011, 11875, 1566722152276, 12140, 265, true
5274, 1566722152012, 11876, 1566722152275, 12139, 263, true
5275, 1566722152012, 11876, 1566722152275, 12139, 263, true
5276, 1566722152012, 11876, 1566722152262, 12126, 250, true
5277, 1566722152013, 11877, 1566722152263, 12127, 250, true
5278, 1566722152013, 11877, 1566722152240, 12104, 227, true
5279, 1566722152013, 11877, 1566722152262, 12126, 249, true
5280, 1566722152014, 11878, 1566722152298, 12162, 284, true
5281, 1566722152014, 11878, 1566722152276, 12140, 262, true
5282, 1566722152014, 11878, 1566722152263, 12127, 249, true
5283, 1566722152015, 11879, 1566722152248, 12112, 233, true
5284, 1566722152016, 11880, 1566722152256, 12120, 240, true
5285, 1566722152016, 11880, 1566722152255, 12119, 239, true
5286, 1566722152016, 11880, 1566722152279, 12143, 263, true
5287, 1566722152017, 11881, 1566722152304, 12168, 287, true
5288, 1566722152018, 11882, 1566722152310, 12174, 292, true
5289, 1566722152018, 11882, 1566722152306, 12170, 288, true
5290, 1566722152018, 11882, 1566722152310, 12174, 292, true
5291, 1566722152019, 11883, 1566722152310, 12174, 291, true
5292, 1566722152019, 11883, 1566722152310, 12174, 291, true
5293, 1566722152019, 11883, 1566722152310, 12174, 291, true
5294, 1566722152020, 11884, 1566722152312, 12176, 292, true
5295, 1566722152021, 11885, 1566722152313, 12177, 292, true
5296, 1566722152021, 11885, 1566722152314, 12178, 293, true
5297, 1566722152022, 11886, 1566722152310, 12174, 288, true
5298, 1566722152022, 11886, 1566722152306, 12170, 284, true
5299, 1566722152023, 11887, 1566722152305, 12169, 282, true
5300, 1566722152024, 11888, 1566722152310, 12174, 286, true
5301, 1566722152025, 11889, 1566722152309, 12173, 284, true
5302, 1566722152026, 11890, 1566722152309, 12173, 283, true
5303, 1566722152027, 11891, 1566722152314, 12178, 287, true
5304, 1566722152029, 11893, 1566722152309, 12173, 280, true
5305, 1566722152030, 11894, 1566722152305, 12169, 275, true
5306, 1566722152031, 11895, 1566722152312, 12176, 281, true
5307, 1566722152032, 11896, 1566722152304, 12168, 272, true
5308, 1566722152033, 11897, 1566722152310, 12174, 277, true
5309, 1566722152036, 11900, 1566722152305, 12169, 269, true
5310, 1566722152115, 11979, 1566722152324, 12188, 209, true
5311, 1566722152118, 11982, 1566722152324, 12188, 206, true
5312, 1566722152120, 11984, 1566722152328, 12192, 208, true
5313, 1566722152127, 11991, 1566722152335, 12199, 208, true
5314, 1566722152134, 11998, 1566722152338, 12202, 204, true
5315, 1566722152136, 12000, 1566722152343, 12207, 207, true
5316, 1566722152172, 12036, 1566722152387, 12251, 215, true
5317, 1566722152173, 12037, 1566722152386, 12250, 213, true
5318, 1566722152179, 12043, 1566722152387, 12251, 208, true
5319, 1566722152180, 12044, 1566722152387, 12251, 207, true
5320, 1566722152182, 12046, 1566722152390, 12254, 208, true
5321, 1566722152182, 12046, 1566722152392, 12256, 210, true
5322, 1566722152183, 12047, 1566722152391, 12255, 208, true
5323, 1566722152186, 12050, 1566722152390, 12254, 204, true
5324, 1566722152186, 12050, 1566722152394, 12258, 208, true
5325, 1566722152186, 12050, 1566722152394, 12258, 208, true
5326, 1566722152187, 12051, 1566722152392, 12256, 205, true
5327, 1566722152188, 12052, 1566722152392, 12256, 204, true
5328, 1566722152190, 12054, 1566722152407, 12271, 217, true
5329, 1566722152191, 12055, 1566722152395, 12259, 204, true
5330, 1566722152192, 12056, 1566722152417, 12281, 225, true
5331, 1566722152193, 12057, 1566722152407, 12271, 214, true
5332, 1566722152194, 12058, 1566722152417, 12281, 223, true
5333, 1566722152200, 12064, 1566722152417, 12281, 217, true
5334, 1566722152200, 12064, 1566722152417, 12281, 217, true
5335, 1566722152200, 12064, 1566722152414, 12278, 214, true
5336, 1566722152202, 12066, 1566722152414, 12278, 212, true
5337, 1566722152203, 12067, 1566722152415, 12279, 212, true
5338, 1566722152204, 12068, 1566722152415, 12279, 211, true
5339, 1566722152206, 12070, 1566722152415, 12279, 209, true
5340, 1566722152207, 12071, 1566722152415, 12279, 208, true
5341, 1566722152208, 12072, 1566722152417, 12281, 209, true
5342, 1566722152209, 12073, 1566722152417, 12281, 208, true
5343, 1566722152210, 12074, 1566722152427, 12291, 217, true
5344, 1566722152211, 12075, 1566722152425, 12289, 214, true
5345, 1566722152212, 12076, 1566722152428, 12292, 216, true
5346, 1566722152213, 12077, 1566722152428, 12292, 215, true
5347, 1566722152213, 12077, 1566722152429, 12293, 216, true
5348, 1566722152213, 12077, 1566722152446, 12310, 233, true
5349, 1566722152214, 12078, 1566722152440, 12304, 226, true
5350, 1566722152214, 12078, 1566722152440, 12304, 226, true
5351, 1566722152215, 12079, 1566722152430, 12294, 215, true
5352, 1566722152216, 12080, 1566722152430, 12294, 214, true
5353, 1566722152216, 12080, 1566722152430, 12294, 214, true
5354, 1566722152216, 12080, 1566722152445, 12309, 229, true
5355, 1566722152217, 12081, 1566722152436, 12300, 219, true
5356, 1566722152217, 12081, 1566722152433, 12297, 216, true
5357, 1566722152218, 12082, 1566722152440, 12304, 222, true
5358, 1566722152218, 12082, 1566722152432, 12296, 214, true
5359, 1566722152218, 12082, 1566722152438, 12302, 220, true
5360, 1566722152219, 12083, 1566722152445, 12309, 226, true
5361, 1566722152220, 12084, 1566722152440, 12304, 220, true
5362, 1566722152221, 12085, 1566722152430, 12294, 209, true
5363, 1566722152221, 12085, 1566722152446, 12310, 225, true
5364, 1566722152221, 12085, 1566722152431, 12295, 210, true
5365, 1566722152222, 12086, 1566722152438, 12302, 216, true
5366, 1566722152223, 12087, 1566722152486, 12350, 263, true
5367, 1566722152224, 12088, 1566722152453, 12317, 229, true
5368, 1566722152224, 12088, 1566722152453, 12317, 229, true
5369, 1566722152226, 12090, 1566722152483, 12347, 257, true
5370, 1566722152228, 12092, 1566722152461, 12325, 233, true
5371, 1566722152233, 12097, 1566722152468, 12332, 235, true
5372, 1566722152235, 12099, 1566722152479, 12343, 244, true
5373, 1566722152245, 12109, 1566722152495, 12359, 250, true
5374, 1566722152257, 12121, 1566722152527, 12391, 270, true
5375, 1566722152329, 12193, 1566722152533, 12397, 204, true
5376, 1566722152331, 12195, 1566722152534, 12398, 203, true
5377, 1566722152332, 12196, 1566722152539, 12403, 207, true
5378, 1566722152333, 12197, 1566722152537, 12401, 204, true
5379, 1566722152336, 12200, 1566722152541, 12405, 205, true
5380, 1566722152339, 12203, 1566722152542, 12406, 203, true
5381, 1566722152340, 12204, 1566722152543, 12407, 203, true
5382, 1566722152341, 12205, 1566722152548, 12412, 207, true
5383, 1566722152344, 12208, 1566722152548, 12412, 204, true
5384, 1566722152345, 12209, 1566722152550, 12414, 205, true
5385, 1566722152347, 12211, 1566722152554, 12418, 207, true
5386, 1566722152349, 12213, 1566722152558, 12422, 209, true
5387, 1566722152350, 12214, 1566722152558, 12422, 208, true
5388, 1566722152352, 12216, 1566722152559, 12423, 207, true
5389, 1566722152354, 12218, 1566722152558, 12422, 204, true
5390, 1566722152356, 12220, 1566722152559, 12423, 203, true
5391, 1566722152357, 12221, 1566722152563, 12427, 206, true
5392, 1566722152359, 12223, 1566722152564, 12428, 205, true
5393, 1566722152362, 12226, 1566722152565, 12429, 203, true
5394, 1566722152364, 12228, 1566722152570, 12434, 206, true
5395, 1566722152366, 12230, 1566722152570, 12434, 204, true
5396, 1566722152368, 12232, 1566722152572, 12436, 204, true
5397, 1566722152370, 12234, 1566722152574, 12438, 204, true
5398, 1566722152371, 12235, 1566722152575, 12439, 204, true
5399, 1566722152373, 12237, 1566722152578, 12442, 205, true
5400, 1566722152374, 12238, 1566722152584, 12448, 210, true
5401, 1566722152376, 12240, 1566722152589, 12453, 213, true
5402, 1566722152378, 12242, 1566722152583, 12447, 205, true
5403, 1566722152380, 12244, 1566722152589, 12453, 209, true
5404, 1566722152382, 12246, 1566722152590, 12454, 208, true
5405, 1566722152384, 12248, 1566722152590, 12454, 206, true
5406, 1566722152388, 12252, 1566722152591, 12455, 203, true
5407, 1566722152389, 12253, 1566722152594, 12458, 205, true
5408, 1566722152398, 12262, 1566722152602, 12466, 204, true
5409, 1566722152399, 12263, 1566722152602, 12466, 203, true
5410, 1566722152401, 12265, 1566722152604, 12468, 203, true
5411, 1566722152402, 12266, 1566722152610, 12474, 208, true
5412, 1566722152403, 12267, 1566722152610, 12474, 207, true
5413, 1566722152404, 12268, 1566722152610, 12474, 206, true
5414, 1566722152408, 12272, 1566722152612, 12476, 204, true
5415, 1566722152409, 12273, 1566722152622, 12486, 213, true
5416, 1566722152418, 12282, 1566722152624, 12488, 206, true
5417, 1566722152418, 12282, 1566722152624, 12488, 206, true
5418, 1566722152418, 12282, 1566722152628, 12492, 210, true
5419, 1566722152419, 12283, 1566722152629, 12493, 210, true
5420, 1566722152420, 12284, 1566722152640, 12504, 220, true
5421, 1566722152421, 12285, 1566722152640, 12504, 219, true
5422, 1566722152421, 12285, 1566722152636, 12500, 215, true
5423, 1566722152422, 12286, 1566722152636, 12500, 214, true
5424, 1566722152422, 12286, 1566722152640, 12504, 218, true
5425, 1566722152423, 12287, 1566722152640, 12504, 217, true
5426, 1566722152423, 12287, 1566722152630, 12494, 207, true
5427, 1566722152423, 12287, 1566722152635, 12499, 212, true
5428, 1566722152424, 12288, 1566722152635, 12499, 211, true
5429, 1566722152425, 12289, 1566722152648, 12512, 223, true
5430, 1566722152434, 12298, 1566722152640, 12504, 206, true
5431, 1566722152437, 12301, 1566722152652, 12516, 215, true
5432, 1566722152441, 12305, 1566722152654, 12518, 213, true
5433, 1566722152441, 12305, 1566722152653, 12517, 212, true
5434, 1566722152441, 12305, 1566722152654, 12518, 213, true
5435, 1566722152442, 12306, 1566722152654, 12518, 212, true
5436, 1566722152442, 12306, 1566722152654, 12518, 212, true
5437, 1566722152443, 12307, 1566722152668, 12532, 225, true
5438, 1566722152446, 12310, 1566722152668, 12532, 222, true
5439, 1566722152447, 12311, 1566722152668, 12532, 221, true
5440, 1566722152447, 12311, 1566722152667, 12531, 220, true
5441, 1566722152449, 12313, 1566722152667, 12531, 218, true
5442, 1566722152450, 12314, 1566722152667, 12531, 217, true
5443, 1566722152451, 12315, 1566722152668, 12532, 217, true
5444, 1566722152453, 12317, 1566722152657, 12521, 204, true
5445, 1566722152453, 12317, 1566722152657, 12521, 204, true
5446, 1566722152454, 12318, 1566722152668, 12532, 214, true
5447, 1566722152454, 12318, 1566722152668, 12532, 214, true
5448, 1566722152455, 12319, 1566722152668, 12532, 213, true
5449, 1566722152456, 12320, 1566722152668, 12532, 212, true
5450, 1566722152459, 12323, 1566722152668, 12532, 209, true
5451, 1566722152459, 12323, 1566722152668, 12532, 209, true
5452, 1566722152461, 12325, 1566722152669, 12533, 208, true
5453, 1566722152463, 12327, 1566722152672, 12536, 209, true
5454, 1566722152464, 12328, 1566722152688, 12552, 224, true
5455, 1566722152465, 12329, 1566722152682, 12546, 217, true
5456, 1566722152465, 12329, 1566722152676, 12540, 211, true
5457, 1566722152465, 12329, 1566722152676, 12540, 211, true
5458, 1566722152466, 12330, 1566722152680, 12544, 214, true
5459, 1566722152468, 12332, 1566722152682, 12546, 214, true
5460, 1566722152468, 12332, 1566722152688, 12552, 220, true
5461, 1566722152469, 12333, 1566722152680, 12544, 211, true
5462, 1566722152469, 12333, 1566722152682, 12546, 213, true
5463, 1566722152470, 12334, 1566722152688, 12552, 218, true
5464, 1566722152470, 12334, 1566722152688, 12552, 218, true
5465, 1566722152471, 12335, 1566722152680, 12544, 209, true
5466, 1566722152471, 12335, 1566722152688, 12552, 217, true
5467, 1566722152472, 12336, 1566722152688, 12552, 216, true
5468, 1566722152472, 12336, 1566722152683, 12547, 211, true
5469, 1566722152473, 12337, 1566722152688, 12552, 215, true
5470, 1566722152473, 12337, 1566722152684, 12548, 211, true
5471, 1566722152474, 12338, 1566722152688, 12552, 214, true
5472, 1566722152480, 12344, 1566722152688, 12552, 208, true
5473, 1566722152480, 12344, 1566722152693, 12557, 213, true
5474, 1566722152481, 12345, 1566722152693, 12557, 212, true
5475, 1566722152481, 12345, 1566722152689, 12553, 208, true
5476, 1566722152483, 12347, 1566722152692, 12556, 209, true
5477, 1566722152484, 12348, 1566722152693, 12557, 209, true
5478, 1566722152484, 12348, 1566722152693, 12557, 209, true
5479, 1566722152486, 12350, 1566722152693, 12557, 207, true
5480, 1566722152487, 12351, 1566722152693, 12557, 206, true
5481, 1566722152490, 12354, 1566722152697, 12561, 207, true
5482, 1566722152490, 12354, 1566722152697, 12561, 207, true
5483, 1566722152490, 12354, 1566722152697, 12561, 207, true
5484, 1566722152491, 12355, 1566722152706, 12570, 215, true
5485, 1566722152492, 12356, 1566722152699, 12563, 207, true
5486, 1566722152492, 12356, 1566722152699, 12563, 207, true
5487, 1566722152493, 12357, 1566722152699, 12563, 206, true
5488, 1566722152496, 12360, 1566722152714, 12578, 218, true
5489, 1566722152496, 12360, 1566722152716, 12580, 220, true
5490, 1566722152498, 12362, 1566722152709, 12573, 211, true
5491, 1566722152499, 12363, 1566722152716, 12580, 217, true
5492, 1566722152499, 12363, 1566722152714, 12578, 215, true
5493, 1566722152499, 12363, 1566722152713, 12577, 214, true
5494, 1566722152500, 12364, 1566722152713, 12577, 213, true
5495, 1566722152500, 12364, 1566722152709, 12573, 209, true
5496, 1566722152504, 12368, 1566722152712, 12576, 208, true
5497, 1566722152506, 12370, 1566722152713, 12577, 207, true
5498, 1566722152507, 12371, 1566722152713, 12577, 206, true
5499, 1566722152508, 12372, 1566722152721, 12585, 213, true
5500, 1566722152509, 12373, 1566722152721, 12585, 212, true
5501, 1566722152509, 12373, 1566722152721, 12585, 212, true
5502, 1566722152509, 12373, 1566722152728, 12592, 219, true
5503, 1566722152510, 12374, 1566722152728, 12592, 218, true
5504, 1566722152511, 12375, 1566722152728, 12592, 217, true
5505, 1566722152511, 12375, 1566722152721, 12585, 210, true
5506, 1566722152512, 12376, 1566722152732, 12596, 220, true
5507, 1566722152512, 12376, 1566722152732, 12596, 220, true
5508, 1566722152512, 12376, 1566722152724, 12588, 212, true
5509, 1566722152513, 12377, 1566722152721, 12585, 208, true
5510, 1566722152513, 12377, 1566722152723, 12587, 210, true
5511, 1566722152514, 12378, 1566722152728, 12592, 214, true
5512, 1566722152515, 12379, 1566722152728, 12592, 213, true
5513, 1566722152516, 12380, 1566722152728, 12592, 212, true
5514, 1566722152516, 12380, 1566722152731, 12595, 215, true
5515, 1566722152516, 12380, 1566722152728, 12592, 212, true
5516, 1566722152517, 12381, 1566722152732, 12596, 215, true
5517, 1566722152521, 12385, 1566722152732, 12596, 211, true
5518, 1566722152521, 12385, 1566722152728, 12592, 207, true
5519, 1566722152522, 12386, 1566722152732, 12596, 210, true
5520, 1566722152522, 12386, 1566722152733, 12597, 211, true
5521, 1566722152523, 12387, 1566722152732, 12596, 209, true
5522, 1566722152524, 12388, 1566722152735, 12599, 211, true
5523, 1566722152524, 12388, 1566722152733, 12597, 209, true
5524, 1566722152525, 12389, 1566722152735, 12599, 210, true
5525, 1566722152525, 12389, 1566722152735, 12599, 210, true
5526, 1566722152526, 12390, 1566722152735, 12599, 209, true
5527, 1566722152529, 12393, 1566722152733, 12597, 204, true
5528, 1566722152530, 12394, 1566722152738, 12602, 208, true
5529, 1566722152531, 12395, 1566722152747, 12611, 216, true
5530, 1566722152534, 12398, 1566722152742, 12606, 208, true
5531, 1566722152534, 12398, 1566722152741, 12605, 207, true
5532, 1566722152535, 12399, 1566722152747, 12611, 212, true
5533, 1566722152536, 12400, 1566722152747, 12611, 211, true
5534, 1566722152541, 12405, 1566722152754, 12618, 213, true
5535, 1566722152541, 12405, 1566722152750, 12614, 209, true
5536, 1566722152544, 12408, 1566722152750, 12614, 206, true
5537, 1566722152544, 12408, 1566722152750, 12614, 206, true
5538, 1566722152545, 12409, 1566722152750, 12614, 205, true
5539, 1566722152545, 12409, 1566722152754, 12618, 209, true
5540, 1566722152546, 12410, 1566722152750, 12614, 204, true
5541, 1566722152548, 12412, 1566722152755, 12619, 207, true
5542, 1566722152548, 12412, 1566722152757, 12621, 209, true
5543, 1566722152550, 12414, 1566722152757, 12621, 207, true
5544, 1566722152552, 12416, 1566722152758, 12622, 206, true
5545, 1566722152552, 12416, 1566722152757, 12621, 205, true
5546, 1566722152553, 12417, 1566722152761, 12625, 208, true
5547, 1566722152554, 12418, 1566722152758, 12622, 204, true
5548, 1566722152556, 12420, 1566722152763, 12627, 207, true
5549, 1566722152559, 12423, 1566722152764, 12628, 205, true
5550, 1566722152561, 12425, 1566722152768, 12632, 207, true
5551, 1566722152561, 12425, 1566722152768, 12632, 207, true
5552, 1566722152562, 12426, 1566722152768, 12632, 206, true
5553, 1566722152565, 12429, 1566722152770, 12634, 205, true
5554, 1566722152566, 12430, 1566722152770, 12634, 204, true
5555, 1566722152566, 12430, 1566722152770, 12634, 204, true
5556, 1566722152568, 12432, 1566722152773, 12637, 205, true
5557, 1566722152568, 12432, 1566722152786, 12650, 218, true
5558, 1566722152568, 12432, 1566722152778, 12642, 210, true
5559, 1566722152569, 12433, 1566722152776, 12640, 207, true
5560, 1566722152570, 12434, 1566722152777, 12641, 207, true
5561, 1566722152571, 12435, 1566722152782, 12646, 211, true
5562, 1566722152574, 12438, 1566722152777, 12641, 203, true
5563, 1566722152575, 12439, 1566722152783, 12647, 208, true
5564, 1566722152575, 12439, 1566722152780, 12644, 205, true
5565, 1566722152576, 12440, 1566722152784, 12648, 208, true
5566, 1566722152577, 12441, 1566722152784, 12648, 207, true
5567, 1566722152579, 12443, 1566722152784, 12648, 205, true
5568, 1566722152581, 12445, 1566722152790, 12654, 209, true
5569, 1566722152581, 12445, 1566722152790, 12654, 209, true
5570, 1566722152581, 12445, 1566722152790, 12654, 209, true
5571, 1566722152586, 12450, 1566722152799, 12663, 213, true
5572, 1566722152586, 12450, 1566722152791, 12655, 205, true
5573, 1566722152587, 12451, 1566722152802, 12666, 215, true
5574, 1566722152591, 12455, 1566722152795, 12659, 204, true
5575, 1566722152592, 12456, 1566722152798, 12662, 206, true
5576, 1566722152594, 12458, 1566722152802, 12666, 208, true
5577, 1566722152594, 12458, 1566722152802, 12666, 208, true
5578, 1566722152594, 12458, 1566722152801, 12665, 207, true
5579, 1566722152595, 12459, 1566722152801, 12665, 206, true
5580, 1566722152597, 12461, 1566722152806, 12670, 209, true
5581, 1566722152597, 12461, 1566722152806, 12670, 209, true
5582, 1566722152597, 12461, 1566722152806, 12670, 209, true
5583, 1566722152598, 12462, 1566722152803, 12667, 205, true
5584, 1566722152598, 12462, 1566722152803, 12667, 205, true
5585, 1566722152600, 12464, 1566722152806, 12670, 206, true
5586, 1566722152604, 12468, 1566722152817, 12681, 213, true
5587, 1566722152605, 12469, 1566722152813, 12677, 208, true
5588, 1566722152605, 12469, 1566722152817, 12681, 212, true
5589, 1566722152605, 12469, 1566722152817, 12681, 212, true
5590, 1566722152606, 12470, 1566722152817, 12681, 211, true
5591, 1566722152607, 12471, 1566722152817, 12681, 210, true
5592, 1566722152611, 12475, 1566722152817, 12681, 206, true
5593, 1566722152614, 12478, 1566722152819, 12683, 205, true
5594, 1566722152614, 12478, 1566722152817, 12681, 203, true
5595, 1566722152615, 12479, 1566722152820, 12684, 205, true
5596, 1566722152615, 12479, 1566722152821, 12685, 206, true
5597, 1566722152616, 12480, 1566722152820, 12684, 204, true
5598, 1566722152618, 12482, 1566722152824, 12688, 206, true
5599, 1566722152618, 12482, 1566722152824, 12688, 206, true
5600, 1566722152620, 12484, 1566722152829, 12693, 209, true
5601, 1566722152625, 12489, 1566722152835, 12699, 210, true
5602, 1566722152626, 12490, 1566722152837, 12701, 211, true
5603, 1566722152631, 12495, 1566722152837, 12701, 206, true
5604, 1566722152631, 12495, 1566722152837, 12701, 206, true
5605, 1566722152631, 12495, 1566722152837, 12701, 206, true
5606, 1566722152633, 12497, 1566722152840, 12704, 207, true
5607, 1566722152633, 12497, 1566722152855, 12719, 222, true
5608, 1566722152633, 12497, 1566722152851, 12715, 218, true
5609, 1566722152636, 12500, 1566722152852, 12716, 216, true
5610, 1566722152636, 12500, 1566722152855, 12719, 219, true
5611, 1566722152637, 12501, 1566722152840, 12704, 203, true
5612, 1566722152637, 12501, 1566722152849, 12713, 212, true
5613, 1566722152637, 12501, 1566722152852, 12716, 215, true
5614, 1566722152641, 12505, 1566722152856, 12720, 215, true
5615, 1566722152641, 12505, 1566722152855, 12719, 214, true
5616, 1566722152642, 12506, 1566722152856, 12720, 214, true
5617, 1566722152642, 12506, 1566722152855, 12719, 213, true
5618, 1566722152642, 12506, 1566722152853, 12717, 211, true
5619, 1566722152643, 12507, 1566722152855, 12719, 212, true
5620, 1566722152646, 12510, 1566722152855, 12719, 209, true
5621, 1566722152649, 12513, 1566722152856, 12720, 207, true
5622, 1566722152650, 12514, 1566722152861, 12725, 211, true
5623, 1566722152651, 12515, 1566722152861, 12725, 210, true
5624, 1566722152658, 12522, 1566722152865, 12729, 207, true
5625, 1566722152660, 12524, 1566722152870, 12734, 210, true
5626, 1566722152660, 12524, 1566722152862, 12726, 202, true
5627, 1566722152660, 12524, 1566722152871, 12735, 211, true
5628, 1566722152660, 12524, 1566722152872, 12736, 212, true
5629, 1566722152673, 12537, 1566722152875, 12739, 202, true
5630, 1566722152674, 12538, 1566722152878, 12742, 204, true
5631, 1566722152677, 12541, 1566722152882, 12746, 205, true
5632, 1566722152702, 12566, 1566722152907, 12771, 205, true
5633, 1566722152702, 12566, 1566722152911, 12775, 209, true
5634, 1566722152706, 12570, 1566722152918, 12782, 212, true
5635, 1566722152740, 12604, 1566722152944, 12808, 204, true
5636, 1566722152742, 12606, 1566722152946, 12810, 204, true
5637, 1566722152744, 12608, 1566722152954, 12818, 210, true
5638, 1566722152759, 12623, 1566722152964, 12828, 205, true
5639, 1566722152761, 12625, 1566722152966, 12830, 205, true
5640, 1566722152765, 12629, 1566722152967, 12831, 202, true
5641, 1566722152766, 12630, 1566722152971, 12835, 205, true
5642, 1566722152772, 12636, 1566722152979, 12843, 207, true
5643, 1566722152773, 12637, 1566722152979, 12843, 206, true
5644, 1566722152774, 12638, 1566722152979, 12843, 205, true
5645, 1566722152779, 12643, 1566722152987, 12851, 208, true
5646, 1566722152781, 12645, 1566722152990, 12854, 209, true
5647, 1566722152785, 12649, 1566722152990, 12854, 205, true
5648, 1566722152786, 12650, 1566722152994, 12858, 208, true
5649, 1566722152786, 12650, 1566722152995, 12859, 209, true
5650, 1566722152787, 12651, 1566722152992, 12856, 205, true
5651, 1566722152787, 12651, 1566722152994, 12858, 207, true
5652, 1566722152787, 12651, 1566722153005, 12869, 218, true
5653, 1566722152788, 12652, 1566722153001, 12865, 213, true
5654, 1566722152791, 12655, 1566722152996, 12860, 205, true
5655, 1566722152792, 12656, 1566722153004, 12868, 212, true
5656, 1566722152792, 12656, 1566722152999, 12863, 207, true
5657, 1566722152792, 12656, 1566722153002, 12866, 210, true
5658, 1566722152793, 12657, 1566722152999, 12863, 206, true
5659, 1566722152796, 12660, 1566722153001, 12865, 205, true
5660, 1566722152796, 12660, 1566722153003, 12867, 207, true
5661, 1566722152797, 12661, 1566722153007, 12871, 210, true
5662, 1566722152798, 12662, 1566722153011, 12875, 213, true
5663, 1566722152804, 12668, 1566722153012, 12876, 208, true
5664, 1566722152806, 12670, 1566722153014, 12878, 208, true
5665, 1566722152807, 12671, 1566722153012, 12876, 205, true
5666, 1566722152808, 12672, 1566722153018, 12882, 210, true
5667, 1566722152808, 12672, 1566722153017, 12881, 209, true
5668, 1566722152809, 12673, 1566722153018, 12882, 209, true
5669, 1566722152810, 12674, 1566722153023, 12887, 213, true
5670, 1566722152810, 12674, 1566722153023, 12887, 213, true
5671, 1566722152811, 12675, 1566722153020, 12884, 209, true
5672, 1566722152814, 12678, 1566722153024, 12888, 210, true
5673, 1566722152814, 12678, 1566722153026, 12890, 212, true
5674, 1566722152818, 12682, 1566722153028, 12892, 210, true
5675, 1566722152821, 12685, 1566722153032, 12896, 211, true
5676, 1566722152821, 12685, 1566722153028, 12892, 207, true
5677, 1566722152822, 12686, 1566722153041, 12905, 219, true
5678, 1566722152822, 12686, 1566722153036, 12900, 214, true
5679, 1566722152824, 12688, 1566722153041, 12905, 217, true
5680, 1566722152824, 12688, 1566722153041, 12905, 217, true
5681, 1566722152825, 12689, 1566722153041, 12905, 216, true
5682, 1566722152825, 12689, 1566722153041, 12905, 216, true
5683, 1566722152826, 12690, 1566722153040, 12904, 214, true
5684, 1566722152828, 12692, 1566722153041, 12905, 213, true
5685, 1566722152828, 12692, 1566722153041, 12905, 213, true
5686, 1566722152830, 12694, 1566722153048, 12912, 218, true
5687, 1566722152830, 12694, 1566722153048, 12912, 218, true
5688, 1566722152832, 12696, 1566722153051, 12915, 219, true
5689, 1566722152833, 12697, 1566722153048, 12912, 215, true
5690, 1566722152833, 12697, 1566722153048, 12912, 215, true
5691, 1566722152835, 12699, 1566722153048, 12912, 213, true
5692, 1566722152839, 12703, 1566722153048, 12912, 209, true
5693, 1566722152840, 12704, 1566722153051, 12915, 211, true
5694, 1566722152840, 12704, 1566722153051, 12915, 211, true
5695, 1566722152841, 12705, 1566722153051, 12915, 210, true
5696, 1566722152842, 12706, 1566722153048, 12912, 206, true
5697, 1566722152844, 12708, 1566722153051, 12915, 207, true
5698, 1566722152845, 12709, 1566722153051, 12915, 206, true
5699, 1566722152846, 12710, 1566722153052, 12916, 206, true
5700, 1566722152846, 12710, 1566722153051, 12915, 205, true
5701, 1566722152847, 12711, 1566722153057, 12921, 210, true
5702, 1566722152848, 12712, 1566722153057, 12921, 209, true
5703, 1566722152849, 12713, 1566722153057, 12921, 208, true
5704, 1566722152856, 12720, 1566722153064, 12928, 208, true
5705, 1566722152857, 12721, 1566722153072, 12936, 215, true
5706, 1566722152857, 12721, 1566722153072, 12936, 215, true
5707, 1566722152857, 12721, 1566722153072, 12936, 215, true
5708, 1566722152857, 12721, 1566722153072, 12936, 215, true
5709, 1566722152858, 12722, 1566722153072, 12936, 214, true
5710, 1566722152858, 12722, 1566722153066, 12930, 208, true
5711, 1566722152858, 12722, 1566722153072, 12936, 214, true
5712, 1566722152861, 12725, 1566722153075, 12939, 214, true
5713, 1566722152863, 12727, 1566722153075, 12939, 212, true
5714, 1566722152865, 12729, 1566722153072, 12936, 207, true
5715, 1566722152866, 12730, 1566722153075, 12939, 209, true
5716, 1566722152866, 12730, 1566722153075, 12939, 209, true
5717, 1566722152867, 12731, 1566722153075, 12939, 208, true
5718, 1566722152868, 12732, 1566722153075, 12939, 207, true
5719, 1566722152868, 12732, 1566722153075, 12939, 207, true
5720, 1566722152869, 12733, 1566722153075, 12939, 206, true
5721, 1566722152872, 12736, 1566722153081, 12945, 209, true
5722, 1566722152872, 12736, 1566722153083, 12947, 211, true
5723, 1566722152873, 12737, 1566722153083, 12947, 210, true
5724, 1566722152873, 12737, 1566722153082, 12946, 209, true
5725, 1566722152875, 12739, 1566722153083, 12947, 208, true
5726, 1566722152876, 12740, 1566722153081, 12945, 205, true
5727, 1566722152878, 12742, 1566722153083, 12947, 205, true
5728, 1566722152879, 12743, 1566722153083, 12947, 204, true
5729, 1566722152879, 12743, 1566722153111, 12975, 232, true
5730, 1566722152880, 12744, 1566722153110, 12974, 230, true
5731, 1566722152881, 12745, 1566722153111, 12975, 230, true
5732, 1566722152882, 12746, 1566722153111, 12975, 229, true
5733, 1566722152882, 12746, 1566722153109, 12973, 227, true
5734, 1566722152883, 12747, 1566722153110, 12974, 227, true
5735, 1566722152885, 12749, 1566722153111, 12975, 226, true
5736, 1566722152886, 12750, 1566722153111, 12975, 225, true
5737, 1566722152888, 12752, 1566722153112, 12976, 224, true
5738, 1566722152889, 12753, 1566722153124, 12988, 235, true
5739, 1566722152890, 12754, 1566722153123, 12987, 233, true
5740, 1566722152891, 12755, 1566722153112, 12976, 221, true
5741, 1566722152892, 12756, 1566722153127, 12991, 235, true
5742, 1566722152893, 12757, 1566722153124, 12988, 231, true
5743, 1566722152894, 12758, 1566722153112, 12976, 218, true
5744, 1566722152894, 12758, 1566722153116, 12980, 222, true
5745, 1566722152895, 12759, 1566722153122, 12986, 227, true
5746, 1566722152897, 12761, 1566722153123, 12987, 226, true
5747, 1566722152898, 12762, 1566722153126, 12990, 228, true
5748, 1566722152899, 12763, 1566722153125, 12989, 226, true
5749, 1566722152900, 12764, 1566722153126, 12990, 226, true
5750, 1566722152901, 12765, 1566722153116, 12980, 215, true
5751, 1566722152903, 12767, 1566722153123, 12987, 220, true
5752, 1566722152904, 12768, 1566722153123, 12987, 219, true
5753, 1566722152905, 12769, 1566722153123, 12987, 218, true
5754, 1566722152906, 12770, 1566722153130, 12994, 224, true
5755, 1566722152907, 12771, 1566722153124, 12988, 217, true
5756, 1566722152908, 12772, 1566722153130, 12994, 222, true
5757, 1566722152909, 12773, 1566722153131, 12995, 222, true
5758, 1566722152913, 12777, 1566722153128, 12992, 215, true
5759, 1566722152914, 12778, 1566722153130, 12994, 216, true
5760, 1566722152914, 12778, 1566722153130, 12994, 216, true
5761, 1566722152915, 12779, 1566722153130, 12994, 215, true
5762, 1566722152916, 12780, 1566722153128, 12992, 212, true
5763, 1566722152920, 12784, 1566722153132, 12996, 212, true
5764, 1566722152920, 12784, 1566722153249, 13113, 329, true
5765, 1566722152920, 12784, 1566722153252, 13116, 332, true
5766, 1566722152921, 12785, 1566722153252, 13116, 331, true
5767, 1566722152921, 12785, 1566722153252, 13116, 331, true
5768, 1566722152922, 12786, 1566722153252, 13116, 330, true
5769, 1566722152923, 12787, 1566722153295, 13159, 372, true
5770, 1566722152923, 12787, 1566722153265, 13129, 342, true
5771, 1566722152924, 12788, 1566722153292, 13156, 368, true
5772, 1566722152924, 12788, 1566722153284, 13148, 360, true
5773, 1566722152924, 12788, 1566722153271, 13135, 347, true
5774, 1566722152924, 12788, 1566722153292, 13156, 368, true
5775, 1566722152925, 12789, 1566722153292, 13156, 367, true
5776, 1566722152925, 12789, 1566722153295, 13159, 370, true
5777, 1566722152926, 12790, 1566722153271, 13135, 345, true
5778, 1566722152926, 12790, 1566722153284, 13148, 358, true
5779, 1566722152926, 12790, 1566722153352, 13216, 426, true
5780, 1566722152927, 12791, 1566722153285, 13149, 358, true
5781, 1566722152927, 12791, 1566722153295, 13159, 368, true
5782, 1566722152927, 12791, 1566722153352, 13216, 425, true
5783, 1566722152928, 12792, 1566722153292, 13156, 364, true
5784, 1566722152928, 12792, 1566722153292, 13156, 364, true
5785, 1566722152928, 12792, 1566722153360, 13224, 432, true
5786, 1566722152928, 12792, 1566722153295, 13159, 367, true
5787, 1566722152929, 12793, 1566722153284, 13148, 355, true
5788, 1566722152929, 12793, 1566722153350, 13214, 421, true
5789, 1566722152929, 12793, 1566722153272, 13136, 343, true
5790, 1566722152929, 12793, 1566722153318, 13182, 389, true
5791, 1566722152930, 12794, 1566722153302, 13166, 372, true
5792, 1566722152930, 12794, 1566722153263, 13127, 333, true
5793, 1566722152930, 12794, 1566722153360, 13224, 430, true
5794, 1566722152931, 12795, 1566722153351, 13215, 420, true
5795, 1566722152931, 12795, 1566722153295, 13159, 364, true
5796, 1566722152932, 12796, 1566722153293, 13157, 361, true
5797, 1566722152932, 12796, 1566722153283, 13147, 351, true
5798, 1566722152932, 12796, 1566722153286, 13150, 354, true
5799, 1566722152932, 12796, 1566722153263, 13127, 331, true
5800, 1566722152933, 12797, 1566722153263, 13127, 330, true
5801, 1566722152933, 12797, 1566722153328, 13192, 395, true
5802, 1566722152934, 12798, 1566722153285, 13149, 351, true
5803, 1566722152934, 12798, 1566722153321, 13185, 387, true
5804, 1566722152935, 12799, 1566722153271, 13135, 336, true
5805, 1566722152935, 12799, 1566722153350, 13214, 415, true
5806, 1566722152935, 12799, 1566722153285, 13149, 350, true
5807, 1566722152935, 12799, 1566722153265, 13129, 330, true
5808, 1566722152936, 12800, 1566722153349, 13213, 413, true
5809, 1566722152937, 12801, 1566722153359, 13223, 422, true
5810, 1566722152937, 12801, 1566722153285, 13149, 348, true
5811, 1566722152938, 12802, 1566722153285, 13149, 347, true
5812, 1566722152938, 12802, 1566722153318, 13182, 380, true
5813, 1566722152939, 12803, 1566722153360, 13224, 421, true
5814, 1566722152939, 12803, 1566722153293, 13157, 354, true
5815, 1566722152939, 12803, 1566722153360, 13224, 421, true
5816, 1566722152940, 12804, 1566722153284, 13148, 344, true
5817, 1566722152940, 12804, 1566722153298, 13162, 358, true
5818, 1566722152940, 12804, 1566722153359, 13223, 419, true
5819, 1566722152940, 12804, 1566722153271, 13135, 331, true
5820, 1566722152941, 12805, 1566722153271, 13135, 330, true
5821, 1566722152942, 12806, 1566722153351, 13215, 409, true
5822, 1566722152942, 12806, 1566722153284, 13148, 342, true
5823, 1566722152943, 12807, 1566722153351, 13215, 408, true
5824, 1566722152944, 12808, 1566722153271, 13135, 327, true
5825, 1566722152944, 12808, 1566722153265, 13129, 321, true
5826, 1566722152945, 12809, 1566722153320, 13184, 375, true
5827, 1566722152946, 12810, 1566722153292, 13156, 346, true
5828, 1566722152946, 12810, 1566722153286, 13150, 340, true
5829, 1566722152946, 12810, 1566722153350, 13214, 404, true
5830, 1566722152947, 12811, 1566722153293, 13157, 346, true
5831, 1566722152948, 12812, 1566722153350, 13214, 402, true
5832, 1566722152948, 12812, 1566722153265, 13129, 317, true
5833, 1566722152949, 12813, 1566722153320, 13184, 371, true
5834, 1566722152950, 12814, 1566722153271, 13135, 321, true
5835, 1566722152950, 12814, 1566722153299, 13163, 349, true
5836, 1566722152951, 12815, 1566722153263, 13127, 312, true
5837, 1566722152951, 12815, 1566722153283, 13147, 332, true
5838, 1566722152951, 12815, 1566722153271, 13135, 320, true
5839, 1566722152951, 12815, 1566722153272, 13136, 321, true
5840, 1566722152952, 12816, 1566722153295, 13159, 343, true
5841, 1566722152952, 12816, 1566722153352, 13216, 400, true
5842, 1566722152952, 12816, 1566722153320, 13184, 368, true
5843, 1566722152952, 12816, 1566722153283, 13147, 331, true
5844, 1566722152953, 12817, 1566722153351, 13215, 398, true
5845, 1566722152954, 12818, 1566722153303, 13167, 349, true
5846, 1566722152955, 12819, 1566722153341, 13205, 386, true
5847, 1566722152955, 12819, 1566722153317, 13181, 362, true
5848, 1566722152956, 12820, 1566722153342, 13206, 386, true
5849, 1566722152956, 12820, 1566722153328, 13192, 372, true
5850, 1566722152956, 12820, 1566722153341, 13205, 385, true
5851, 1566722152956, 12820, 1566722153317, 13181, 361, true
5852, 1566722152956, 12820, 1566722153350, 13214, 394, true
5853, 1566722152956, 12820, 1566722153306, 13170, 350, true
5854, 1566722152956, 12820, 1566722153299, 13163, 343, true
5855, 1566722152957, 12821, 1566722153328, 13192, 371, true
5856, 1566722152957, 12821, 1566722153348, 13212, 391, true
5857, 1566722152957, 12821, 1566722153349, 13213, 392, true
5858, 1566722152957, 12821, 1566722153298, 13162, 341, true
5859, 1566722152957, 12821, 1566722153303, 13167, 346, true
5860, 1566722152957, 12821, 1566722153271, 13135, 314, true
5861, 1566722152958, 12822, 1566722153292, 13156, 334, true
5862, 1566722152958, 12822, 1566722153320, 13184, 362, true
5863, 1566722152958, 12822, 1566722153318, 13182, 360, true
5864, 1566722152959, 12823, 1566722153328, 13192, 369, true
5865, 1566722152960, 12824, 1566722153338, 13202, 378, true
5866, 1566722152960, 12824, 1566722153302, 13166, 342, true
5867, 1566722152961, 12825, 1566722153317, 13181, 356, true
5868, 1566722152961, 12825, 1566722153339, 13203, 378, true
5869, 1566722152963, 12827, 1566722153299, 13163, 336, true
5870, 1566722152965, 12829, 1566722153323, 13187, 358, true
5871, 1566722152967, 12831, 1566722153352, 13216, 385, true
5872, 1566722152967, 12831, 1566722153330, 13194, 363, true
5873, 1566722152968, 12832, 1566722153352, 13216, 384, true
5874, 1566722152968, 12832, 1566722153348, 13212, 380, true
5875, 1566722152968, 12832, 1566722153299, 13163, 331, true
5876, 1566722152969, 12833, 1566722153311, 13175, 342, true
5877, 1566722152969, 12833, 1566722153349, 13213, 380, true
5878, 1566722152969, 12833, 1566722153342, 13206, 373, true
5879, 1566722152971, 12835, 1566722153309, 13173, 338, true
5880, 1566722152972, 12836, 1566722153318, 13182, 346, true
5881, 1566722152972, 12836, 1566722153323, 13187, 351, true
5882, 1566722152973, 12837, 1566722153349, 13213, 376, true
5883, 1566722152974, 12838, 1566722153317, 13181, 343, true
5884, 1566722152974, 12838, 1566722153328, 13192, 354, true
5885, 1566722152974, 12838, 1566722153303, 13167, 329, true
5886, 1566722152974, 12838, 1566722153350, 13214, 376, true
5887, 1566722152975, 12839, 1566722153339, 13203, 364, true
5888, 1566722152975, 12839, 1566722153335, 13199, 360, true
5889, 1566722152975, 12839, 1566722153305, 13169, 330, true
5890, 1566722152976, 12840, 1566722153342, 13206, 366, true
5891, 1566722152976, 12840, 1566722153349, 13213, 373, true
5892, 1566722152976, 12840, 1566722153348, 13212, 372, true
5893, 1566722152977, 12841, 1566722153303, 13167, 326, true
5894, 1566722152978, 12842, 1566722153323, 13187, 345, true
5895, 1566722152979, 12843, 1566722153352, 13216, 373, true
5896, 1566722152979, 12843, 1566722153271, 13135, 292, true
5897, 1566722152980, 12844, 1566722153271, 13135, 291, true
5898, 1566722152980, 12844, 1566722153343, 13207, 363, true
5899, 1566722152981, 12845, 1566722153360, 13224, 379, true
5900, 1566722152982, 12846, 1566722153359, 13223, 377, true
5901, 1566722152982, 12846, 1566722153359, 13223, 377, true
5902, 1566722152982, 12846, 1566722153354, 13218, 372, true
5903, 1566722152982, 12846, 1566722153354, 13218, 372, true
5904, 1566722152982, 12846, 1566722153354, 13218, 372, true
5905, 1566722152983, 12847, 1566722153359, 13223, 376, true
5906, 1566722152983, 12847, 1566722153353, 13217, 370, true
5907, 1566722152983, 12847, 1566722153374, 13238, 391, true
5908, 1566722152983, 12847, 1566722153374, 13238, 391, true
5909, 1566722152983, 12847, 1566722153374, 13238, 391, true
5910, 1566722152983, 12847, 1566722153360, 13224, 377, true
5911, 1566722152984, 12848, 1566722153377, 13241, 393, true
5912, 1566722152984, 12848, 1566722153360, 13224, 376, true
5913, 1566722152984, 12848, 1566722153421, 13285, 437, true
5914, 1566722152984, 12848, 1566722153390, 13254, 406, true
5915, 1566722152984, 12848, 1566722153421, 13285, 437, true
5916, 1566722152984, 12848, 1566722153365, 13229, 381, true
5917, 1566722152985, 12849, 1566722153368, 13232, 383, true
5918, 1566722152985, 12849, 1566722153381, 13245, 396, true
5919, 1566722152985, 12849, 1566722153381, 13245, 396, true
5920, 1566722152985, 12849, 1566722153419, 13283, 434, true
5921, 1566722152986, 12850, 1566722153389, 13253, 403, true
5922, 1566722152986, 12850, 1566722153419, 13283, 433, true
5923, 1566722152987, 12851, 1566722153263, 13127, 276, true
5924, 1566722152988, 12852, 1566722153381, 13245, 393, true
5925, 1566722152988, 12852, 1566722153419, 13283, 431, true
5926, 1566722152989, 12853, 1566722153382, 13246, 393, true
5927, 1566722152990, 12854, 1566722153349, 13213, 359, true
5928, 1566722152991, 12855, 1566722153293, 13157, 302, true
5929, 1566722152991, 12855, 1566722153378, 13242, 387, true
5930, 1566722152992, 12856, 1566722153420, 13284, 428, true
5931, 1566722152992, 12856, 1566722153271, 13135, 279, true
5932, 1566722152993, 12857, 1566722153381, 13245, 388, true
5933, 1566722152993, 12857, 1566722153389, 13253, 396, true
5934, 1566722152994, 12858, 1566722153293, 13157, 299, true
5935, 1566722152995, 12859, 1566722153351, 13215, 356, true
5936, 1566722152996, 12860, 1566722153271, 13135, 275, true
5937, 1566722152996, 12860, 1566722153265, 13129, 269, true
5938, 1566722152996, 12860, 1566722153421, 13285, 425, true
5939, 1566722152996, 12860, 1566722153381, 13245, 385, true
5940, 1566722152997, 12861, 1566722153375, 13239, 378, true
5941, 1566722152997, 12861, 1566722153419, 13283, 422, true
5942, 1566722152998, 12862, 1566722153378, 13242, 380, true
5943, 1566722152998, 12862, 1566722153378, 13242, 380, true
5944, 1566722152999, 12863, 1566722153321, 13185, 322, true
5945, 1566722152999, 12863, 1566722153293, 13157, 294, true
5946, 1566722153000, 12864, 1566722153378, 13242, 378, true
5947, 1566722153001, 12865, 1566722153270, 13134, 269, true
5948, 1566722153001, 12865, 1566722153295, 13159, 294, true
5949, 1566722153002, 12866, 1566722153378, 13242, 376, true
5950, 1566722153003, 12867, 1566722153306, 13170, 303, true
5951, 1566722153004, 12868, 1566722153295, 13159, 291, true
5952, 1566722153004, 12868, 1566722153263, 13127, 259, true
5953, 1566722153005, 12869, 1566722153283, 13147, 278, true
5954, 1566722153006, 12870, 1566722153421, 13285, 415, true
5955, 1566722153007, 12871, 1566722153360, 13224, 353, true
5956, 1566722153007, 12871, 1566722153419, 13283, 412, true
5957, 1566722153008, 12872, 1566722153377, 13241, 369, true
5958, 1566722153009, 12873, 1566722153416, 13280, 407, true
5959, 1566722153009, 12873, 1566722153416, 13280, 407, true
5960, 1566722153010, 12874, 1566722153381, 13245, 371, true
5961, 1566722153010, 12874, 1566722153419, 13283, 409, true
5962, 1566722153011, 12875, 1566722153350, 13214, 339, true
5963, 1566722153011, 12875, 1566722153378, 13242, 367, true
5964, 1566722153012, 12876, 1566722153350, 13214, 338, true
5965, 1566722153013, 12877, 1566722153295, 13159, 282, true
5966, 1566722153014, 12878, 1566722153299, 13163, 285, true
5967, 1566722153014, 12878, 1566722153420, 13284, 406, true
5968, 1566722153015, 12879, 1566722153381, 13245, 366, true
5969, 1566722153015, 12879, 1566722153377, 13241, 362, true
5970, 1566722153016, 12880, 1566722153421, 13285, 405, true
5971, 1566722153016, 12880, 1566722153375, 13239, 359, true
5972, 1566722153017, 12881, 1566722153263, 13127, 246, true
5973, 1566722153017, 12881, 1566722153381, 13245, 364, true
5974, 1566722153018, 12882, 1566722153292, 13156, 274, true
5975, 1566722153018, 12882, 1566722153351, 13215, 333, true
5976, 1566722153019, 12883, 1566722153381, 13245, 362, true
5977, 1566722153020, 12884, 1566722153271, 13135, 251, true
5978, 1566722153020, 12884, 1566722153376, 13240, 356, true
5979, 1566722153022, 12886, 1566722153389, 13253, 367, true
5980, 1566722153022, 12886, 1566722153419, 13283, 397, true
5981, 1566722153023, 12887, 1566722153360, 13224, 337, true
5982, 1566722153024, 12888, 1566722153354, 13218, 330, true
5983, 1566722153024, 12888, 1566722153263, 13127, 239, true
5984, 1566722153025, 12889, 1566722153416, 13280, 391, true
5985, 1566722153025, 12889, 1566722153389, 13253, 364, true
5986, 1566722153026, 12890, 1566722153416, 13280, 390, true
5987, 1566722153026, 12890, 1566722153398, 13262, 372, true
5988, 1566722153027, 12891, 1566722153292, 13156, 265, true
5989, 1566722153027, 12891, 1566722153394, 13258, 367, true
5990, 1566722153029, 12893, 1566722153292, 13156, 263, true
5991, 1566722153029, 12893, 1566722153292, 13156, 263, true
5992, 1566722153030, 12894, 1566722153341, 13205, 311, true
5993, 1566722153030, 12894, 1566722153349, 13213, 319, true
5994, 1566722153030, 12894, 1566722153309, 13173, 279, true
5995, 1566722153030, 12894, 1566722153328, 13192, 298, true
5996, 1566722153031, 12895, 1566722153342, 13206, 311, true
5997, 1566722153031, 12895, 1566722153309, 13173, 278, true
5998, 1566722153032, 12896, 1566722153349, 13213, 317, true
5999, 1566722153033, 12897, 1566722153298, 13162, 265, true
6000, 1566722153033, 12897, 1566722153349, 13213, 316, true
6001, 1566722153033, 12897, 1566722153361, 13225, 328, true
6002, 1566722153033, 12897, 1566722153348, 13212, 315, true
6003, 1566722153034, 12898, 1566722153328, 13192, 294, true
6004, 1566722153034, 12898, 1566722153418, 13282, 384, true
6005, 1566722153034, 12898, 1566722153403, 13267, 369, true
6006, 1566722153035, 12899, 1566722153390, 13254, 355, true
6007, 1566722153035, 12899, 1566722153397, 13261, 362, true
6008, 1566722153035, 12899, 1566722153416, 13280, 381, true
6009, 1566722153035, 12899, 1566722153419, 13283, 384, true
6010, 1566722153035, 12899, 1566722153391, 13255, 356, true
6011, 1566722153036, 12900, 1566722153391, 13255, 355, true
6012, 1566722153192, 13056, 1566722153398, 13262, 206, true
6013, 1566722153195, 13059, 1566722153403, 13267, 208, true
6014, 1566722153197, 13061, 1566722153417, 13281, 220, true
6015, 1566722153199, 13063, 1566722153415, 13279, 216, true
6016, 1566722153201, 13065, 1566722153424, 13288, 223, true
6017, 1566722153202, 13066, 1566722153422, 13286, 220, true
6018, 1566722153205, 13069, 1566722153423, 13287, 218, true
6019, 1566722153207, 13071, 1566722153425, 13289, 218, true
6020, 1566722153209, 13073, 1566722153423, 13287, 214, true
6021, 1566722153211, 13075, 1566722153424, 13288, 213, true
6022, 1566722153213, 13077, 1566722153424, 13288, 211, true
6023, 1566722153217, 13081, 1566722153425, 13289, 208, true
6024, 1566722153219, 13083, 1566722153437, 13301, 218, true
6025, 1566722153222, 13086, 1566722153438, 13302, 216, true
6026, 1566722153225, 13089, 1566722153438, 13302, 213, true
6027, 1566722153226, 13090, 1566722153438, 13302, 212, true
6028, 1566722153228, 13092, 1566722153438, 13302, 210, true
6029, 1566722153230, 13094, 1566722153441, 13305, 211, true
6030, 1566722153231, 13095, 1566722153440, 13304, 209, true
6031, 1566722153234, 13098, 1566722153442, 13306, 208, true
6032, 1566722153239, 13103, 1566722153461, 13325, 222, true
6033, 1566722153243, 13107, 1566722153456, 13320, 213, true
6034, 1566722153245, 13109, 1566722153458, 13322, 213, true
6035, 1566722153246, 13110, 1566722153461, 13325, 215, true
6036, 1566722153254, 13118, 1566722153461, 13325, 207, true
6037, 1566722153256, 13120, 1566722153461, 13325, 205, true
6038, 1566722153258, 13122, 1566722153530, 13394, 272, true
6039, 1566722153259, 13123, 1566722153527, 13391, 268, true
6040, 1566722153259, 13123, 1566722153531, 13395, 272, true
6041, 1566722153259, 13123, 1566722153569, 13433, 310, true
6042, 1566722153322, 13186, 1566722153567, 13431, 245, true
6043, 1566722153332, 13196, 1566722153589, 13453, 257, true
6044, 1566722153333, 13197, 1566722153589, 13453, 256, true
6045, 1566722153333, 13197, 1566722153589, 13453, 256, true
6046, 1566722153333, 13197, 1566722153591, 13455, 258, true
6047, 1566722153336, 13200, 1566722153589, 13453, 253, true
6048, 1566722153371, 13235, 1566722153638, 13502, 267, true
6049, 1566722153429, 13293, 1566722153668, 13532, 239, true
6050, 1566722153436, 13300, 1566722153659, 13523, 223, true
6051, 1566722153446, 13310, 1566722153675, 13539, 229, true
6052, 1566722153446, 13310, 1566722153683, 13547, 237, true
6053, 1566722153447, 13311, 1566722153675, 13539, 228, true
6054, 1566722153447, 13311, 1566722153683, 13547, 236, true
6055, 1566722153448, 13312, 1566722153675, 13539, 227, true
6056, 1566722153448, 13312, 1566722153683, 13547, 235, true
6057, 1566722153448, 13312, 1566722153684, 13548, 236, true
6058, 1566722153449, 13313, 1566722153679, 13543, 230, true
6059, 1566722153450, 13314, 1566722153680, 13544, 230, true
6060, 1566722153450, 13314, 1566722153668, 13532, 218, true
6061, 1566722153450, 13314, 1566722153675, 13539, 225, true
6062, 1566722153450, 13314, 1566722153683, 13547, 233, true
6063, 1566722153451, 13315, 1566722153684, 13548, 233, true
6064, 1566722153451, 13315, 1566722153675, 13539, 224, true
6065, 1566722153451, 13315, 1566722153679, 13543, 228, true
6066, 1566722153452, 13316, 1566722153683, 13547, 231, true
6067, 1566722153453, 13317, 1566722153684, 13548, 231, true
6068, 1566722153453, 13317, 1566722153675, 13539, 222, true
6069, 1566722153454, 13318, 1566722153675, 13539, 221, true
6070, 1566722153454, 13318, 1566722153675, 13539, 221, true
6071, 1566722153454, 13318, 1566722153683, 13547, 229, true
6072, 1566722153455, 13319, 1566722153675, 13539, 220, true
6073, 1566722153456, 13320, 1566722153679, 13543, 223, true
6074, 1566722153457, 13321, 1566722153684, 13548, 227, true
6075, 1566722153458, 13322, 1566722153679, 13543, 221, true
6076, 1566722153462, 13326, 1566722153684, 13548, 222, true
6077, 1566722153462, 13326, 1566722153693, 13557, 231, true
6078, 1566722153463, 13327, 1566722153693, 13557, 230, true
6079, 1566722153463, 13327, 1566722153693, 13557, 230, true
6080, 1566722153463, 13327, 1566722153690, 13554, 227, true
6081, 1566722153464, 13328, 1566722153689, 13553, 225, true
6082, 1566722153464, 13328, 1566722153693, 13557, 229, true
6083, 1566722153465, 13329, 1566722153704, 13568, 239, true
6084, 1566722153466, 13330, 1566722153703, 13567, 237, true
6085, 1566722153466, 13330, 1566722153699, 13563, 233, true
6086, 1566722153466, 13330, 1566722153699, 13563, 233, true
6087, 1566722153467, 13331, 1566722153704, 13568, 237, true
6088, 1566722153471, 13335, 1566722153693, 13557, 222, true
6089, 1566722153472, 13336, 1566722153704, 13568, 232, true
6090, 1566722153473, 13337, 1566722153706, 13570, 233, true
6091, 1566722153477, 13341, 1566722153694, 13558, 217, true
6092, 1566722153478, 13342, 1566722153694, 13558, 216, true
6093, 1566722153478, 13342, 1566722153697, 13561, 219, true
6094, 1566722153479, 13343, 1566722153695, 13559, 216, true
6095, 1566722153479, 13343, 1566722153694, 13558, 215, true
6096, 1566722153480, 13344, 1566722153699, 13563, 219, true
6097, 1566722153480, 13344, 1566722153706, 13570, 226, true
6098, 1566722153481, 13345, 1566722153704, 13568, 223, true
6099, 1566722153481, 13345, 1566722153706, 13570, 225, true
6100, 1566722153482, 13346, 1566722153706, 13570, 224, true
6101, 1566722153483, 13347, 1566722153706, 13570, 223, true
6102, 1566722153483, 13347, 1566722153709, 13573, 226, true
6103, 1566722153486, 13350, 1566722153714, 13578, 228, true
6104, 1566722153488, 13352, 1566722153717, 13581, 229, true
6105, 1566722153489, 13353, 1566722153714, 13578, 225, true
6106, 1566722153490, 13354, 1566722153723, 13587, 233, true
6107, 1566722153491, 13355, 1566722153716, 13580, 225, true
6108, 1566722153491, 13355, 1566722153724, 13588, 233, true
6109, 1566722153492, 13356, 1566722153714, 13578, 222, true
6110, 1566722153493, 13357, 1566722153714, 13578, 221, true
6111, 1566722153494, 13358, 1566722153723, 13587, 229, true
6112, 1566722153494, 13358, 1566722153714, 13578, 220, true
6113, 1566722153494, 13358, 1566722153714, 13578, 220, true
6114, 1566722153494, 13358, 1566722153723, 13587, 229, true
6115, 1566722153495, 13359, 1566722153714, 13578, 219, true
6116, 1566722153496, 13360, 1566722153710, 13574, 214, true
6117, 1566722153496, 13360, 1566722153715, 13579, 219, true
6118, 1566722153496, 13360, 1566722153716, 13580, 220, true
6119, 1566722153497, 13361, 1566722153714, 13578, 217, true
6120, 1566722153497, 13361, 1566722153724, 13588, 227, true
6121, 1566722153498, 13362, 1566722153724, 13588, 226, true
6122, 1566722153499, 13363, 1566722153723, 13587, 224, true
6123, 1566722153499, 13363, 1566722153729, 13593, 230, true
6124, 1566722153500, 13364, 1566722153727, 13591, 227, true
6125, 1566722153502, 13366, 1566722153729, 13593, 227, true
6126, 1566722153503, 13367, 1566722153724, 13588, 221, true
6127, 1566722153503, 13367, 1566722153724, 13588, 221, true
6128, 1566722153504, 13368, 1566722153735, 13599, 231, true
6129, 1566722153504, 13368, 1566722153724, 13588, 220, true
6130, 1566722153505, 13369, 1566722153735, 13599, 230, true
6131, 1566722153505, 13369, 1566722153724, 13588, 219, true
6132, 1566722153505, 13369, 1566722153735, 13599, 230, true
6133, 1566722153506, 13370, 1566722153735, 13599, 229, true
6134, 1566722153506, 13370, 1566722153724, 13588, 218, true
6135, 1566722153507, 13371, 1566722153732, 13596, 225, true
6136, 1566722153507, 13371, 1566722153729, 13593, 222, true
6137, 1566722153508, 13372, 1566722153738, 13602, 230, true
6138, 1566722153508, 13372, 1566722153746, 13610, 238, true
6139, 1566722153508, 13372, 1566722153740, 13604, 232, true
6140, 1566722153509, 13373, 1566722153740, 13604, 231, true
6141, 1566722153514, 13378, 1566722153746, 13610, 232, true
6142, 1566722153514, 13378, 1566722153746, 13610, 232, true
6143, 1566722153514, 13378, 1566722153746, 13610, 232, true
6144, 1566722153515, 13379, 1566722153746, 13610, 231, true
6145, 1566722153525, 13389, 1566722153746, 13610, 221, true
6146, 1566722153526, 13390, 1566722153746, 13610, 220, true
6147, 1566722153527, 13391, 1566722153738, 13602, 211, true
6148, 1566722153529, 13393, 1566722153741, 13605, 212, true
6149, 1566722153529, 13393, 1566722153746, 13610, 217, true
6150, 1566722153531, 13395, 1566722153746, 13610, 215, true
6151, 1566722153531, 13395, 1566722153746, 13610, 215, true
6152, 1566722153532, 13396, 1566722153746, 13610, 214, true
6153, 1566722153532, 13396, 1566722153748, 13612, 216, true
6154, 1566722153532, 13396, 1566722153746, 13610, 214, true
6155, 1566722153533, 13397, 1566722153746, 13610, 213, true
6156, 1566722153535, 13399, 1566722153746, 13610, 211, true
6157, 1566722153541, 13405, 1566722153751, 13615, 210, true
6158, 1566722153542, 13406, 1566722153749, 13613, 207, true
6159, 1566722153544, 13408, 1566722153751, 13615, 207, true
6160, 1566722153545, 13409, 1566722153756, 13620, 211, true
6161, 1566722153547, 13411, 1566722153758, 13622, 211, true
6162, 1566722153551, 13415, 1566722153756, 13620, 205, true
6163, 1566722153552, 13416, 1566722153756, 13620, 204, true
6164, 1566722153554, 13418, 1566722153761, 13625, 207, true
6165, 1566722153554, 13418, 1566722153762, 13626, 208, true
6166, 1566722153555, 13419, 1566722153765, 13629, 210, true
6167, 1566722153555, 13419, 1566722153762, 13626, 207, true
6168, 1566722153556, 13420, 1566722153762, 13626, 206, true
6169, 1566722153557, 13421, 1566722153762, 13626, 205, true
6170, 1566722153559, 13423, 1566722153766, 13630, 207, true
6171, 1566722153559, 13423, 1566722153765, 13629, 206, true
6172, 1566722153560, 13424, 1566722153767, 13631, 207, true
6173, 1566722153560, 13424, 1566722153766, 13630, 206, true
6174, 1566722153560, 13424, 1566722153769, 13633, 209, true
6175, 1566722153564, 13428, 1566722153770, 13634, 206, true
6176, 1566722153565, 13429, 1566722153770, 13634, 205, true
6177, 1566722153567, 13431, 1566722153772, 13636, 205, true
6178, 1566722153570, 13434, 1566722153776, 13640, 206, true
6179, 1566722153571, 13435, 1566722153776, 13640, 205, true
6180, 1566722153571, 13435, 1566722153776, 13640, 205, true
6181, 1566722153572, 13436, 1566722153776, 13640, 204, true
6182, 1566722153573, 13437, 1566722153777, 13641, 204, true
6183, 1566722153574, 13438, 1566722153783, 13647, 209, true
6184, 1566722153575, 13439, 1566722153786, 13650, 211, true
6185, 1566722153576, 13440, 1566722153789, 13653, 213, true
6186, 1566722153581, 13445, 1566722153788, 13652, 207, true
6187, 1566722153582, 13446, 1566722153798, 13662, 216, true
6188, 1566722153586, 13450, 1566722153798, 13662, 212, true
6189, 1566722153590, 13454, 1566722153798, 13662, 208, true
6190, 1566722153591, 13455, 1566722153800, 13664, 209, true
6191, 1566722153592, 13456, 1566722153798, 13662, 206, true
6192, 1566722153595, 13459, 1566722153798, 13662, 203, true
6193, 1566722153596, 13460, 1566722153800, 13664, 204, true
6194, 1566722153598, 13462, 1566722153801, 13665, 203, true
6195, 1566722153599, 13463, 1566722153804, 13668, 205, true
6196, 1566722153603, 13467, 1566722153809, 13673, 206, true
6197, 1566722153604, 13468, 1566722153809, 13673, 205, true
6198, 1566722153605, 13469, 1566722153811, 13675, 206, true
6199, 1566722153607, 13471, 1566722153811, 13675, 204, true
6200, 1566722153607, 13471, 1566722153816, 13680, 209, true
6201, 1566722153608, 13472, 1566722153816, 13680, 208, true
6202, 1566722153609, 13473, 1566722153826, 13690, 217, true
6203, 1566722153610, 13474, 1566722153826, 13690, 216, true
6204, 1566722153611, 13475, 1566722153826, 13690, 215, true
6205, 1566722153612, 13476, 1566722153826, 13690, 214, true
6206, 1566722153613, 13477, 1566722153826, 13690, 213, true
6207, 1566722153616, 13480, 1566722153826, 13690, 210, true
6208, 1566722153617, 13481, 1566722153826, 13690, 209, true
6209, 1566722153618, 13482, 1566722153837, 13701, 219, true
6210, 1566722153619, 13483, 1566722153827, 13691, 208, true
6211, 1566722153619, 13483, 1566722153835, 13699, 216, true
6212, 1566722153620, 13484, 1566722153834, 13698, 214, true
6213, 1566722153621, 13485, 1566722153834, 13698, 213, true
6214, 1566722153621, 13485, 1566722153831, 13695, 210, true
6215, 1566722153621, 13485, 1566722153834, 13698, 213, true
6216, 1566722153622, 13486, 1566722153837, 13701, 215, true
6217, 1566722153622, 13486, 1566722153834, 13698, 212, true
6218, 1566722153622, 13486, 1566722153837, 13701, 215, true
6219, 1566722153625, 13489, 1566722153830, 13694, 205, true
6220, 1566722153627, 13491, 1566722153837, 13701, 210, true
6221, 1566722153628, 13492, 1566722153837, 13701, 209, true
6222, 1566722153631, 13495, 1566722153844, 13708, 213, true
6223, 1566722153632, 13496, 1566722153840, 13704, 208, true
6224, 1566722153633, 13497, 1566722153840, 13704, 207, true
6225, 1566722153633, 13497, 1566722153845, 13709, 212, true
6226, 1566722153640, 13504, 1566722153845, 13709, 205, true
6227, 1566722153642, 13506, 1566722153857, 13721, 215, true
6228, 1566722153643, 13507, 1566722153852, 13716, 209, true
6229, 1566722153643, 13507, 1566722153851, 13715, 208, true
6230, 1566722153646, 13510, 1566722153862, 13726, 216, true
6231, 1566722153646, 13510, 1566722153857, 13721, 211, true
6232, 1566722153646, 13510, 1566722153857, 13721, 211, true
6233, 1566722153647, 13511, 1566722153859, 13723, 212, true
6234, 1566722153647, 13511, 1566722153859, 13723, 212, true
6235, 1566722153647, 13511, 1566722153860, 13724, 213, true
6236, 1566722153648, 13512, 1566722153860, 13724, 212, true
6237, 1566722153648, 13512, 1566722153857, 13721, 209, true
6238, 1566722153649, 13513, 1566722153862, 13726, 213, true
6239, 1566722153650, 13514, 1566722153862, 13726, 212, true
6240, 1566722153660, 13524, 1566722153864, 13728, 204, true
6241, 1566722153661, 13525, 1566722153875, 13739, 214, true
6242, 1566722153662, 13526, 1566722153872, 13736, 210, true
6243, 1566722153663, 13527, 1566722153885, 13749, 222, true
6244, 1566722153663, 13527, 1566722153885, 13749, 222, true
6245, 1566722153664, 13528, 1566722153930, 13794, 266, true
6246, 1566722153664, 13528, 1566722153913, 13777, 249, true
6247, 1566722153665, 13529, 1566722153939, 13803, 274, true
6248, 1566722153665, 13529, 1566722153940, 13804, 275, true
6249, 1566722153666, 13530, 1566722153934, 13798, 268, true
6250, 1566722153669, 13533, 1566722153940, 13804, 271, true
6251, 1566722153669, 13533, 1566722153894, 13758, 225, true
6252, 1566722153669, 13533, 1566722153918, 13782, 249, true
6253, 1566722153674, 13538, 1566722153934, 13798, 260, true
6254, 1566722153676, 13540, 1566722153930, 13794, 254, true
6255, 1566722153676, 13540, 1566722153918, 13782, 242, true
6256, 1566722153677, 13541, 1566722153907, 13771, 230, true
6257, 1566722153685, 13549, 1566722153973, 13837, 288, true
6258, 1566722153685, 13549, 1566722153995, 13859, 310, true
6259, 1566722153686, 13550, 1566722153992, 13856, 306, true
6260, 1566722153686, 13550, 1566722153992, 13856, 306, true
6261, 1566722153686, 13550, 1566722153993, 13857, 307, true
6262, 1566722153686, 13550, 1566722153995, 13859, 309, true
6263, 1566722153686, 13550, 1566722153997, 13861, 311, true
6264, 1566722153687, 13551, 1566722153998, 13862, 311, true
6265, 1566722153696, 13560, 1566722153992, 13856, 296, true
6266, 1566722153699, 13563, 1566722153979, 13843, 280, true
6267, 1566722153700, 13564, 1566722153979, 13843, 279, true
6268, 1566722153701, 13565, 1566722153992, 13856, 291, true
6269, 1566722153710, 13574, 1566722153999, 13863, 289, true
6270, 1566722153711, 13575, 1566722153996, 13860, 285, true
6271, 1566722153718, 13582, 1566722153993, 13857, 275, true
6272, 1566722153718, 13582, 1566722154001, 13865, 283, true
6273, 1566722153719, 13583, 1566722153976, 13840, 257, true
6274, 1566722153723, 13587, 1566722153984, 13848, 261, true
6275, 1566722153724, 13588, 1566722153992, 13856, 268, true
6276, 1566722153729, 13593, 1566722153984, 13848, 255, true
6277, 1566722153736, 13600, 1566722153996, 13860, 260, true
6278, 1566722153736, 13600, 1566722153998, 13862, 262, true
6279, 1566722153738, 13602, 1566722153958, 13822, 220, true
6280, 1566722153738, 13602, 1566722153995, 13859, 257, true
6281, 1566722153745, 13609, 1566722153995, 13859, 250, true
6282, 1566722153751, 13615, 1566722154020, 13884, 269, true
6283, 1566722153752, 13616, 1566722154034, 13898, 282, true
6284, 1566722153752, 13616, 1566722154044, 13908, 292, true
6285, 1566722153752, 13616, 1566722154042, 13906, 290, true
6286, 1566722153752, 13616, 1566722154017, 13881, 265, true
6287, 1566722153753, 13617, 1566722154041, 13905, 288, true
6288, 1566722153757, 13621, 1566722154052, 13916, 295, true
6289, 1566722153762, 13626, 1566722154011, 13875, 249, true
6290, 1566722153763, 13627, 1566722154017, 13881, 254, true
6291, 1566722153763, 13627, 1566722154020, 13884, 257, true
6292, 1566722153768, 13632, 1566722154012, 13876, 244, true
6293, 1566722153769, 13633, 1566722154017, 13881, 248, true
6294, 1566722153771, 13635, 1566722154052, 13916, 281, true
6295, 1566722153772, 13636, 1566722154052, 13916, 280, true
6296, 1566722153773, 13637, 1566722154053, 13917, 280, true
6297, 1566722153773, 13637, 1566722154049, 13913, 276, true
6298, 1566722153774, 13638, 1566722154017, 13881, 243, true
6299, 1566722153774, 13638, 1566722154011, 13875, 237, true
6300, 1566722153776, 13640, 1566722154012, 13876, 236, true
6301, 1566722153777, 13641, 1566722154013, 13877, 236, true
6302, 1566722153778, 13642, 1566722154011, 13875, 233, true
6303, 1566722153778, 13642, 1566722154036, 13900, 258, true
6304, 1566722153778, 13642, 1566722154011, 13875, 233, true
6305, 1566722153779, 13643, 1566722154017, 13881, 238, true
6306, 1566722153780, 13644, 1566722154035, 13899, 255, true
6307, 1566722153780, 13644, 1566722154012, 13876, 232, true
6308, 1566722153786, 13650, 1566722154013, 13877, 227, true
6309, 1566722153790, 13654, 1566722154041, 13905, 251, true
6310, 1566722153792, 13656, 1566722154012, 13876, 220, true
6311, 1566722153793, 13657, 1566722154036, 13900, 243, true
6312, 1566722153794, 13658, 1566722154041, 13905, 247, true
6313, 1566722153794, 13658, 1566722154012, 13876, 218, true
6314, 1566722153795, 13659, 1566722154053, 13917, 258, true
6315, 1566722153796, 13660, 1566722154062, 13926, 266, true
6316, 1566722153799, 13663, 1566722154076, 13940, 277, true
6317, 1566722153800, 13664, 1566722154074, 13938, 274, true
6318, 1566722153801, 13665, 1566722154076, 13940, 275, true
6319, 1566722153801, 13665, 1566722154074, 13938, 273, true
6320, 1566722153801, 13665, 1566722154074, 13938, 273, true
6321, 1566722153802, 13666, 1566722154064, 13928, 262, true
6322, 1566722153802, 13666, 1566722154056, 13920, 254, true
6323, 1566722153803, 13667, 1566722154061, 13925, 258, true
6324, 1566722153806, 13670, 1566722154074, 13938, 268, true
6325, 1566722153811, 13675, 1566722154071, 13935, 260, true
6326, 1566722153818, 13682, 1566722154068, 13932, 250, true
6327, 1566722153819, 13683, 1566722154068, 13932, 249, true
6328, 1566722153819, 13683, 1566722154060, 13924, 241, true
6329, 1566722153819, 13683, 1566722154074, 13938, 255, true
6330, 1566722153820, 13684, 1566722154074, 13938, 254, true
6331, 1566722153820, 13684, 1566722154061, 13925, 241, true
6332, 1566722153821, 13685, 1566722154061, 13925, 240, true
6333, 1566722153822, 13686, 1566722154074, 13938, 252, true
6334, 1566722153823, 13687, 1566722154075, 13939, 252, true
6335, 1566722153827, 13691, 1566722154061, 13925, 234, true
6336, 1566722153828, 13692, 1566722154053, 13917, 225, true
6337, 1566722153828, 13692, 1566722154068, 13932, 240, true
6338, 1566722153828, 13692, 1566722154074, 13938, 246, true
6339, 1566722153829, 13693, 1566722154053, 13917, 224, true
6340, 1566722153831, 13695, 1566722154074, 13938, 243, true
6341, 1566722153833, 13697, 1566722154077, 13941, 244, true
6342, 1566722153837, 13701, 1566722154061, 13925, 224, true
6343, 1566722153837, 13701, 1566722154061, 13925, 224, true
6344, 1566722153838, 13702, 1566722154055, 13919, 217, true
6345, 1566722153838, 13702, 1566722154066, 13930, 228, true
6346, 1566722153839, 13703, 1566722154076, 13940, 237, true
6347, 1566722153840, 13704, 1566722154060, 13924, 220, true
6348, 1566722153841, 13705, 1566722154064, 13928, 223, true
6349, 1566722153841, 13705, 1566722154060, 13924, 219, true
6350, 1566722153842, 13706, 1566722154060, 13924, 218, true
6351, 1566722153843, 13707, 1566722154060, 13924, 217, true
6352, 1566722153846, 13710, 1566722154061, 13925, 215, true
6353, 1566722153852, 13716, 1566722154101, 13965, 249, true
6354, 1566722153855, 13719, 1566722154101, 13965, 246, true
6355, 1566722153860, 13724, 1566722154096, 13960, 236, true
6356, 1566722153860, 13724, 1566722154084, 13948, 224, true
6357, 1566722153861, 13725, 1566722154101, 13965, 240, true
6358, 1566722153861, 13725, 1566722154101, 13965, 240, true
6359, 1566722153864, 13728, 1566722154101, 13965, 237, true
6360, 1566722153865, 13729, 1566722154088, 13952, 223, true
6361, 1566722153865, 13729, 1566722154098, 13962, 233, true
6362, 1566722153866, 13730, 1566722154097, 13961, 231, true
6363, 1566722153868, 13732, 1566722154088, 13952, 220, true
6364, 1566722153869, 13733, 1566722154101, 13965, 232, true
6365, 1566722153870, 13734, 1566722154085, 13949, 215, true
6366, 1566722153871, 13735, 1566722154078, 13942, 207, true
6367, 1566722153872, 13736, 1566722154085, 13949, 213, true
6368, 1566722153873, 13737, 1566722154103, 13967, 230, true
6369, 1566722153874, 13738, 1566722154103, 13967, 229, true
6370, 1566722153878, 13742, 1566722154109, 13973, 231, true
6371, 1566722153879, 13743, 1566722154103, 13967, 224, true
6372, 1566722153879, 13743, 1566722154096, 13960, 217, true
6373, 1566722153880, 13744, 1566722154096, 13960, 216, true
6374, 1566722153881, 13745, 1566722154103, 13967, 222, true
6375, 1566722153881, 13745, 1566722154105, 13969, 224, true
6376, 1566722153885, 13749, 1566722154105, 13969, 220, true
6377, 1566722153886, 13750, 1566722154108, 13972, 222, true
6378, 1566722153886, 13750, 1566722154109, 13973, 223, true
6379, 1566722153889, 13753, 1566722154110, 13974, 221, true
6380, 1566722153890, 13754, 1566722154109, 13973, 219, true
6381, 1566722153891, 13755, 1566722154109, 13973, 218, true
6382, 1566722153891, 13755, 1566722154105, 13969, 214, true
6383, 1566722153892, 13756, 1566722154109, 13973, 217, true
6384, 1566722153894, 13758, 1566722154109, 13973, 215, true
6385, 1566722153895, 13759, 1566722154105, 13969, 210, true
6386, 1566722153896, 13760, 1566722154109, 13973, 213, true
6387, 1566722153897, 13761, 1566722154109, 13973, 212, true
6388, 1566722153898, 13762, 1566722154109, 13973, 211, true
6389, 1566722153903, 13767, 1566722154120, 13984, 217, true
6390, 1566722153903, 13767, 1566722154112, 13976, 209, true
6391, 1566722153904, 13768, 1566722154112, 13976, 208, true
6392, 1566722153904, 13768, 1566722154120, 13984, 216, true
6393, 1566722153905, 13769, 1566722154120, 13984, 215, true
6394, 1566722153907, 13771, 1566722154120, 13984, 213, true
6395, 1566722153909, 13773, 1566722154120, 13984, 211, true
6396, 1566722153909, 13773, 1566722154120, 13984, 211, true
6397, 1566722153911, 13775, 1566722154120, 13984, 209, true
6398, 1566722153952, 13816, 1566722154166, 14030, 214, true
6399, 1566722153952, 13816, 1566722154168, 14032, 216, true
6400, 1566722153952, 13816, 1566722154164, 14028, 212, true
6401, 1566722153953, 13817, 1566722154158, 14022, 205, true
6402, 1566722153953, 13817, 1566722154160, 14024, 207, true
6403, 1566722153955, 13819, 1566722154167, 14031, 212, true
6404, 1566722153955, 13819, 1566722154166, 14030, 211, true
6405, 1566722153958, 13822, 1566722154168, 14032, 210, true
6406, 1566722153959, 13823, 1566722154179, 14043, 220, true
6407, 1566722153959, 13823, 1566722154171, 14035, 212, true
6408, 1566722153960, 13824, 1566722154170, 14034, 210, true
6409, 1566722153960, 13824, 1566722154180, 14044, 220, true
6410, 1566722153961, 13825, 1566722154180, 14044, 219, true
6411, 1566722153961, 13825, 1566722154168, 14032, 207, true
6412, 1566722153961, 13825, 1566722154180, 14044, 219, true
6413, 1566722153962, 13826, 1566722154181, 14045, 219, true
6414, 1566722153962, 13826, 1566722154179, 14043, 217, true
6415, 1566722153962, 13826, 1566722154169, 14033, 207, true
6416, 1566722153962, 13826, 1566722154177, 14041, 215, true
6417, 1566722153963, 13827, 1566722154179, 14043, 216, true
6418, 1566722153963, 13827, 1566722154180, 14044, 217, true
6419, 1566722153964, 13828, 1566722154211, 14075, 247, true
6420, 1566722153964, 13828, 1566722154212, 14076, 248, true
6421, 1566722153965, 13829, 1566722154181, 14045, 216, true
6422, 1566722153966, 13830, 1566722154182, 14046, 216, true
6423, 1566722153967, 13831, 1566722154180, 14044, 213, true
6424, 1566722153968, 13832, 1566722154188, 14052, 220, true
6425, 1566722153969, 13833, 1566722154185, 14049, 216, true
6426, 1566722153970, 13834, 1566722154182, 14046, 212, true
6427, 1566722153979, 13843, 1566722154212, 14076, 233, true
6428, 1566722153987, 13851, 1566722154212, 14076, 225, true
6429, 1566722153987, 13851, 1566722154212, 14076, 225, true
6430, 1566722153987, 13851, 1566722154212, 14076, 225, true
6431, 1566722153988, 13852, 1566722154214, 14078, 226, true
6432, 1566722153988, 13852, 1566722154212, 14076, 224, true
6433, 1566722153988, 13852, 1566722154213, 14077, 225, true
6434, 1566722153989, 13853, 1566722154212, 14076, 223, true
6435, 1566722154006, 13870, 1566722154222, 14086, 216, true
6436, 1566722154006, 13870, 1566722154221, 14085, 215, true
6437, 1566722154007, 13871, 1566722154214, 14078, 207, true
6438, 1566722154007, 13871, 1566722154221, 14085, 214, true
6439, 1566722154007, 13871, 1566722154367, 14231, 360, true
6440, 1566722154007, 13871, 1566722154224, 14088, 217, true
6441, 1566722154018, 13882, 1566722154225, 14089, 207, true
6442, 1566722154021, 13885, 1566722154225, 14089, 204, true
6443, 1566722154022, 13886, 1566722154326, 14190, 304, true
6444, 1566722154022, 13886, 1566722154226, 14090, 204, true
6445, 1566722154023, 13887, 1566722154367, 14231, 344, true
6446, 1566722154023, 13887, 1566722154357, 14221, 334, true
6447, 1566722154023, 13887, 1566722154355, 14219, 332, true
6448, 1566722154024, 13888, 1566722154357, 14221, 333, true
6449, 1566722154025, 13889, 1566722154355, 14219, 330, true
6450, 1566722154026, 13890, 1566722154354, 14218, 328, true
6451, 1566722154027, 13891, 1566722154355, 14219, 328, true
6452, 1566722154028, 13892, 1566722154355, 14219, 327, true
6453, 1566722154029, 13893, 1566722154355, 14219, 326, true
6454, 1566722154029, 13893, 1566722154356, 14220, 327, true
6455, 1566722154031, 13895, 1566722154352, 14216, 321, true
6456, 1566722154032, 13896, 1566722154352, 14216, 320, true
6457, 1566722154033, 13897, 1566722154352, 14216, 319, true
6458, 1566722154036, 13900, 1566722154350, 14214, 314, true
6459, 1566722154037, 13901, 1566722154350, 14214, 313, true
6460, 1566722154037, 13901, 1566722154350, 14214, 313, true
6461, 1566722154038, 13902, 1566722154346, 14210, 308, true
6462, 1566722154038, 13902, 1566722154350, 14214, 312, true
6463, 1566722154043, 13907, 1566722154345, 14209, 302, true
6464, 1566722154044, 13908, 1566722154345, 14209, 301, true
6465, 1566722154044, 13908, 1566722154345, 14209, 301, true
6466, 1566722154045, 13909, 1566722154346, 14210, 301, true
6467, 1566722154045, 13909, 1566722154346, 14210, 301, true
6468, 1566722154046, 13910, 1566722154346, 14210, 300, true
6469, 1566722154046, 13910, 1566722154345, 14209, 299, true
6470, 1566722154047, 13911, 1566722154342, 14206, 295, true
6471, 1566722154054, 13918, 1566722154341, 14205, 287, true
6472, 1566722154054, 13918, 1566722154342, 14206, 288, true
6473, 1566722154069, 13933, 1566722154339, 14203, 270, true
6474, 1566722154080, 13944, 1566722154337, 14201, 257, true
6475, 1566722154081, 13945, 1566722154337, 14201, 256, true
6476, 1566722154082, 13946, 1566722154337, 14201, 255, true
6477, 1566722154082, 13946, 1566722154335, 14199, 253, true
6478, 1566722154083, 13947, 1566722154334, 14198, 251, true
6479, 1566722154086, 13950, 1566722154334, 14198, 248, true
6480, 1566722154086, 13950, 1566722154333, 14197, 247, true
6481, 1566722154091, 13955, 1566722154335, 14199, 244, true
6482, 1566722154091, 13955, 1566722154332, 14196, 241, true
6483, 1566722154091, 13955, 1566722154333, 14197, 242, true
6484, 1566722154092, 13956, 1566722154335, 14199, 243, true
6485, 1566722154093, 13957, 1566722154335, 14199, 242, true
6486, 1566722154093, 13957, 1566722154335, 14199, 242, true
6487, 1566722154094, 13958, 1566722154332, 14196, 238, true
6488, 1566722154115, 13979, 1566722154328, 14192, 213, true
6489, 1566722154116, 13980, 1566722154326, 14190, 210, true
6490, 1566722154116, 13980, 1566722154329, 14193, 213, true
6491, 1566722154117, 13981, 1566722154324, 14188, 207, true
6492, 1566722154121, 13985, 1566722154326, 14190, 205, true
6493, 1566722154121, 13985, 1566722154472, 14336, 351, true
6494, 1566722154122, 13986, 1566722154327, 14191, 205, true
6495, 1566722154123, 13987, 1566722154327, 14191, 204, true
6496, 1566722154124, 13988, 1566722154435, 14299, 311, true
6497, 1566722154124, 13988, 1566722154461, 14325, 337, true
6498, 1566722154126, 13990, 1566722154461, 14325, 335, true
6499, 1566722154127, 13991, 1566722154472, 14336, 345, true
6500, 1566722154128, 13992, 1566722154460, 14324, 332, true
6501, 1566722154129, 13993, 1566722154460, 14324, 331, true
6502, 1566722154129, 13993, 1566722154460, 14324, 331, true
6503, 1566722154131, 13995, 1566722154460, 14324, 329, true
6504, 1566722154131, 13995, 1566722154458, 14322, 327, true
6505, 1566722154132, 13996, 1566722154458, 14322, 326, true
6506, 1566722154132, 13996, 1566722154460, 14324, 328, true
6507, 1566722154133, 13997, 1566722154460, 14324, 327, true
6508, 1566722154136, 14000, 1566722154456, 14320, 320, true
6509, 1566722154136, 14000, 1566722154456, 14320, 320, true
6510, 1566722154137, 14001, 1566722154456, 14320, 319, true
6511, 1566722154137, 14001, 1566722154456, 14320, 319, true
6512, 1566722154138, 14002, 1566722154456, 14320, 318, true
6513, 1566722154139, 14003, 1566722154456, 14320, 317, true
6514, 1566722154141, 14005, 1566722154456, 14320, 315, true
6515, 1566722154143, 14007, 1566722154455, 14319, 312, true
6516, 1566722154149, 14013, 1566722154455, 14319, 306, true
6517, 1566722154152, 14016, 1566722154455, 14319, 303, true
6518, 1566722154154, 14018, 1566722154454, 14318, 300, true
6519, 1566722154155, 14019, 1566722154454, 14318, 299, true
6520, 1566722154155, 14019, 1566722154457, 14321, 302, true
6521, 1566722154158, 14022, 1566722154455, 14319, 297, true
6522, 1566722154159, 14023, 1566722154454, 14318, 295, true
6523, 1566722154160, 14024, 1566722154455, 14319, 295, true
6524, 1566722154161, 14025, 1566722154454, 14318, 293, true
6525, 1566722154162, 14026, 1566722154455, 14319, 293, true
6526, 1566722154162, 14026, 1566722154454, 14318, 292, true
6527, 1566722154162, 14026, 1566722154455, 14319, 293, true
6528, 1566722154162, 14026, 1566722154451, 14315, 289, true
6529, 1566722154169, 14033, 1566722154455, 14319, 286, true
6530, 1566722154169, 14033, 1566722154454, 14318, 285, true
6531, 1566722154170, 14034, 1566722154450, 14314, 280, true
6532, 1566722154171, 14035, 1566722154451, 14315, 280, true
6533, 1566722154172, 14036, 1566722154454, 14318, 282, true
6534, 1566722154172, 14036, 1566722154450, 14314, 278, true
6535, 1566722154173, 14037, 1566722154454, 14318, 281, true
6536, 1566722154173, 14037, 1566722154450, 14314, 277, true
6537, 1566722154174, 14038, 1566722154451, 14315, 277, true
6538, 1566722154174, 14038, 1566722154451, 14315, 277, true
6539, 1566722154174, 14038, 1566722154436, 14300, 262, true
6540, 1566722154175, 14039, 1566722154450, 14314, 275, true
6541, 1566722154175, 14039, 1566722154436, 14300, 261, true
6542, 1566722154175, 14039, 1566722154450, 14314, 275, true
6543, 1566722154184, 14048, 1566722154436, 14300, 252, true
6544, 1566722154185, 14049, 1566722154436, 14300, 251, true
6545, 1566722154185, 14049, 1566722154450, 14314, 265, true
6546, 1566722154186, 14050, 1566722154435, 14299, 249, true
6547, 1566722154186, 14050, 1566722154592, 14456, 406, true
6548, 1566722154189, 14053, 1566722154592, 14456, 403, true
6549, 1566722154190, 14054, 1566722154586, 14450, 396, true
6550, 1566722154190, 14054, 1566722154592, 14456, 402, true
6551, 1566722154190, 14054, 1566722154573, 14437, 383, true
6552, 1566722154191, 14055, 1566722154586, 14450, 395, true
6553, 1566722154191, 14055, 1566722154592, 14456, 401, true
6554, 1566722154192, 14056, 1566722154592, 14456, 400, true
6555, 1566722154192, 14056, 1566722154592, 14456, 400, true
6556, 1566722154192, 14056, 1566722154581, 14445, 389, true
6557, 1566722154193, 14057, 1566722154592, 14456, 399, true
6558, 1566722154193, 14057, 1566722154581, 14445, 388, true
6559, 1566722154193, 14057, 1566722154592, 14456, 399, true
6560, 1566722154194, 14058, 1566722154592, 14456, 398, true
6561, 1566722154194, 14058, 1566722154435, 14299, 241, true
6562, 1566722154195, 14059, 1566722154435, 14299, 240, true
6563, 1566722154196, 14060, 1566722154584, 14448, 388, true
6564, 1566722154196, 14060, 1566722154472, 14336, 276, true
6565, 1566722154197, 14061, 1566722154592, 14456, 395, true
6566, 1566722154197, 14061, 1566722154591, 14455, 394, true
6567, 1566722154197, 14061, 1566722154595, 14459, 398, true
6568, 1566722154198, 14062, 1566722154435, 14299, 237, true
6569, 1566722154199, 14063, 1566722154592, 14456, 393, true
6570, 1566722154199, 14063, 1566722154436, 14300, 237, true
6571, 1566722154200, 14064, 1566722154592, 14456, 392, true
6572, 1566722154200, 14064, 1566722154576, 14440, 376, true
6573, 1566722154201, 14065, 1566722154584, 14448, 383, true
6574, 1566722154201, 14065, 1566722154592, 14456, 391, true
6575, 1566722154201, 14065, 1566722154585, 14449, 384, true
6576, 1566722154201, 14065, 1566722154585, 14449, 384, true
6577, 1566722154202, 14066, 1566722154592, 14456, 390, true
6578, 1566722154202, 14066, 1566722154425, 14289, 223, true
6579, 1566722154202, 14066, 1566722154586, 14450, 384, true
6580, 1566722154203, 14067, 1566722154573, 14437, 370, true
6581, 1566722154203, 14067, 1566722154582, 14446, 379, true
6582, 1566722154203, 14067, 1566722154592, 14456, 389, true
6583, 1566722154204, 14068, 1566722154435, 14299, 231, true
6584, 1566722154204, 14068, 1566722154584, 14448, 380, true
6585, 1566722154204, 14068, 1566722154595, 14459, 391, true
6586, 1566722154205, 14069, 1566722154592, 14456, 387, true
6587, 1566722154205, 14069, 1566722154435, 14299, 230, true
6588, 1566722154205, 14069, 1566722154586, 14450, 381, true
6589, 1566722154206, 14070, 1566722154573, 14437, 367, true
6590, 1566722154206, 14070, 1566722154592, 14456, 386, true
6591, 1566722154206, 14070, 1566722154592, 14456, 386, true
6592, 1566722154207, 14071, 1566722154595, 14459, 388, true
6593, 1566722154208, 14072, 1566722154592, 14456, 384, true
6594, 1566722154208, 14072, 1566722154592, 14456, 384, true
6595, 1566722154208, 14072, 1566722154576, 14440, 368, true
6596, 1566722154208, 14072, 1566722154575, 14439, 367, true
6597, 1566722154209, 14073, 1566722154592, 14456, 383, true
6598, 1566722154223, 14087, 1566722154635, 14499, 412, true
6599, 1566722154226, 14090, 1566722154619, 14483, 393, true
6600, 1566722154227, 14091, 1566722154616, 14480, 389, true
6601, 1566722154227, 14091, 1566722154622, 14486, 395, true
6602, 1566722154228, 14092, 1566722154673, 14537, 445, true
6603, 1566722154228, 14092, 1566722154607, 14471, 379, true
6604, 1566722154228, 14092, 1566722154605, 14469, 377, true
6605, 1566722154229, 14093, 1566722154673, 14537, 444, true
6606, 1566722154237, 14101, 1566722154629, 14493, 392, true
6607, 1566722154242, 14106, 1566722154606, 14470, 364, true
6608, 1566722154243, 14107, 1566722154606, 14470, 363, true
6609, 1566722154244, 14108, 1566722154618, 14482, 374, true
6610, 1566722154271, 14135, 1566722154634, 14498, 363, true
6611, 1566722154272, 14136, 1566722154628, 14492, 356, true
6612, 1566722154273, 14137, 1566722154616, 14480, 343, true
6613, 1566722154273, 14137, 1566722154629, 14493, 356, true
6614, 1566722154274, 14138, 1566722154673, 14537, 399, true
6615, 1566722154274, 14138, 1566722154623, 14487, 349, true
6616, 1566722154274, 14138, 1566722154634, 14498, 360, true
6617, 1566722154275, 14139, 1566722154626, 14490, 351, true
6618, 1566722154275, 14139, 1566722154632, 14496, 357, true
6619, 1566722154275, 14139, 1566722154619, 14483, 344, true
6620, 1566722154275, 14139, 1566722154610, 14474, 335, true
6621, 1566722154276, 14140, 1566722154623, 14487, 347, true
6622, 1566722154276, 14140, 1566722154619, 14483, 343, true
6623, 1566722154276, 14140, 1566722154606, 14470, 330, true
6624, 1566722154276, 14140, 1566722154598, 14462, 322, true
6625, 1566722154277, 14141, 1566722154606, 14470, 329, true
6626, 1566722154277, 14141, 1566722154624, 14488, 347, true
6627, 1566722154278, 14142, 1566722154622, 14486, 344, true
6628, 1566722154278, 14142, 1566722154629, 14493, 351, true
6629, 1566722154279, 14143, 1566722154623, 14487, 344, true
6630, 1566722154279, 14143, 1566722154618, 14482, 339, true
6631, 1566722154280, 14144, 1566722154634, 14498, 354, true
6632, 1566722154280, 14144, 1566722154606, 14470, 326, true
6633, 1566722154281, 14145, 1566722154616, 14480, 335, true
6634, 1566722154281, 14145, 1566722154622, 14486, 341, true
6635, 1566722154282, 14146, 1566722154624, 14488, 342, true
6636, 1566722154283, 14147, 1566722154626, 14490, 343, true
6637, 1566722154284, 14148, 1566722154598, 14462, 314, true
6638, 1566722154284, 14148, 1566722154622, 14486, 338, true
6639, 1566722154285, 14149, 1566722154619, 14483, 334, true
6640, 1566722154285, 14149, 1566722154616, 14480, 331, true
6641, 1566722154285, 14149, 1566722154619, 14483, 334, true
6642, 1566722154286, 14150, 1566722154605, 14469, 319, true
6643, 1566722154286, 14150, 1566722154606, 14470, 320, true
6644, 1566722154286, 14150, 1566722154599, 14463, 313, true
6645, 1566722154286, 14150, 1566722154629, 14493, 343, true
6646, 1566722154287, 14151, 1566722154622, 14486, 335, true
6647, 1566722154287, 14151, 1566722154613, 14477, 326, true
6648, 1566722154287, 14151, 1566722154616, 14480, 329, true
6649, 1566722154287, 14151, 1566722154634, 14498, 347, true
6650, 1566722154288, 14152, 1566722154622, 14486, 334, true
6651, 1566722154288, 14152, 1566722154673, 14537, 385, true
6652, 1566722154288, 14152, 1566722154626, 14490, 338, true
6653, 1566722154289, 14153, 1566722154623, 14487, 334, true
6654, 1566722154289, 14153, 1566722154609, 14473, 320, true
6655, 1566722154289, 14153, 1566722154607, 14471, 318, true
6656, 1566722154290, 14154, 1566722154615, 14479, 325, true
6657, 1566722154290, 14154, 1566722154623, 14487, 333, true
6658, 1566722154290, 14154, 1566722154623, 14487, 333, true
6659, 1566722154291, 14155, 1566722154628, 14492, 337, true
6660, 1566722154291, 14155, 1566722154609, 14473, 318, true
6661, 1566722154291, 14155, 1566722154629, 14493, 338, true
6662, 1566722154291, 14155, 1566722154605, 14469, 314, true
6663, 1566722154292, 14156, 1566722154606, 14470, 314, true
6664, 1566722154292, 14156, 1566722154595, 14459, 303, true
6665, 1566722154292, 14156, 1566722154606, 14470, 314, true
6666, 1566722154293, 14157, 1566722154703, 14567, 410, true
6667, 1566722154293, 14157, 1566722154738, 14602, 445, true
6668, 1566722154293, 14157, 1566722154738, 14602, 445, true
6669, 1566722154294, 14158, 1566722154709, 14573, 415, true
6670, 1566722154294, 14158, 1566722154689, 14553, 395, true
6671, 1566722154294, 14158, 1566722154684, 14548, 390, true
6672, 1566722154294, 14158, 1566722154709, 14573, 415, true
6673, 1566722154295, 14159, 1566722154705, 14569, 410, true
6674, 1566722154295, 14159, 1566722154745, 14609, 450, true
6675, 1566722154295, 14159, 1566722154709, 14573, 414, true
6676, 1566722154295, 14159, 1566722154673, 14537, 378, true
6677, 1566722154296, 14160, 1566722154745, 14609, 449, true
6678, 1566722154296, 14160, 1566722154741, 14605, 445, true
6679, 1566722154297, 14161, 1566722154676, 14540, 379, true
6680, 1566722154297, 14161, 1566722154710, 14574, 413, true
6681, 1566722154298, 14162, 1566722154695, 14559, 397, true
6682, 1566722154298, 14162, 1566722154674, 14538, 376, true
6683, 1566722154299, 14163, 1566722154702, 14566, 403, true
6684, 1566722154299, 14163, 1566722154705, 14569, 406, true
6685, 1566722154300, 14164, 1566722154745, 14609, 445, true
6686, 1566722154300, 14164, 1566722154709, 14573, 409, true
6687, 1566722154300, 14164, 1566722154733, 14597, 433, true
6688, 1566722154301, 14165, 1566722154745, 14609, 444, true
6689, 1566722154301, 14165, 1566722154709, 14573, 408, true
6690, 1566722154301, 14165, 1566722154745, 14609, 444, true
6691, 1566722154301, 14165, 1566722154694, 14558, 393, true
6692, 1566722154302, 14166, 1566722154681, 14545, 379, true
6693, 1566722154302, 14166, 1566722154745, 14609, 443, true
6694, 1566722154302, 14166, 1566722154740, 14604, 438, true
6695, 1566722154303, 14167, 1566722154721, 14585, 418, true
6696, 1566722154303, 14167, 1566722154677, 14541, 374, true
6697, 1566722154303, 14167, 1566722154730, 14594, 427, true
6698, 1566722154304, 14168, 1566722154739, 14603, 435, true
6699, 1566722154304, 14168, 1566722154719, 14583, 415, true
6700, 1566722154304, 14168, 1566722154731, 14595, 427, true
6701, 1566722154304, 14168, 1566722154702, 14566, 398, true
6702, 1566722154305, 14169, 1566722154709, 14573, 404, true
6703, 1566722154305, 14169, 1566722154741, 14605, 436, true
6704, 1566722154305, 14169, 1566722155795, 15659, 1490, true
6705, 1566722154305, 14169, 1566722154738, 14602, 433, true
6706, 1566722154306, 14170, 1566722154744, 14608, 438, true
6707, 1566722154306, 14170, 1566722155768, 15632, 1462, true
6708, 1566722154307, 14171, 1566722155744, 15608, 1437, true
6709, 1566722154307, 14171, 1566722155766, 15630, 1459, true
6710, 1566722154308, 14172, 1566722155794, 15658, 1486, true
6711, 1566722154309, 14173, 1566722155778, 15642, 1469, true
6712, 1566722154309, 14173, 1566722155794, 15658, 1485, true
6713, 1566722154310, 14174, 1566722155767, 15631, 1457, true
6714, 1566722154310, 14174, 1566722155794, 15658, 1484, true
6715, 1566722154310, 14174, 1566722155748, 15612, 1438, true
6716, 1566722154310, 14174, 1566722155795, 15659, 1485, true
6717, 1566722154311, 14175, 1566722155756, 15620, 1445, true
6718, 1566722154311, 14175, 1566722155787, 15651, 1476, true
6719, 1566722154311, 14175, 1566722155748, 15612, 1437, true
6720, 1566722154312, 14176, 1566722155782, 15646, 1470, true
6721, 1566722154312, 14176, 1566722155756, 15620, 1444, true
6722, 1566722154313, 14177, 1566722155795, 15659, 1482, true
6723, 1566722154314, 14178, 1566722155748, 15612, 1434, true
6724, 1566722154314, 14178, 1566722155781, 15645, 1467, true
6725, 1566722154314, 14178, 1566722155795, 15659, 1481, true
6726, 1566722154314, 14178, 1566722155768, 15632, 1454, true
6727, 1566722154315, 14179, 1566722155754, 15618, 1439, true
6728, 1566722154316, 14180, 1566722155755, 15619, 1439, true
6729, 1566722154316, 14180, 1566722155755, 15619, 1439, true
6730, 1566722154317, 14181, 1566722155794, 15658, 1477, true
6731, 1566722154317, 14181, 1566722155755, 15619, 1438, true
6732, 1566722154317, 14181, 1566722155762, 15626, 1445, true
6733, 1566722154317, 14181, 1566722155778, 15642, 1461, true
6734, 1566722154318, 14182, 1566722155782, 15646, 1464, true
6735, 1566722154318, 14182, 1566722155782, 15646, 1464, true
6736, 1566722154319, 14183, 1566722155756, 15620, 1437, true
6737, 1566722154319, 14183, 1566722155755, 15619, 1436, true
6738, 1566722154319, 14183, 1566722155760, 15624, 1441, true
6739, 1566722154319, 14183, 1566722155795, 15659, 1476, true
6740, 1566722154320, 14184, 1566722155796, 15660, 1476, true
6741, 1566722154359, 14223, 1566722154618, 14482, 259, true
6742, 1566722154360, 14224, 1566722154618, 14482, 258, true
6743, 1566722154360, 14224, 1566722154607, 14471, 247, true
6744, 1566722154361, 14225, 1566722154632, 14496, 271, true
6745, 1566722154361, 14225, 1566722154626, 14490, 265, true
6746, 1566722154361, 14225, 1566722154745, 14609, 384, true
6747, 1566722154362, 14226, 1566722154745, 14609, 383, true
6748, 1566722154362, 14226, 1566722154705, 14569, 343, true
6749, 1566722154363, 14227, 1566722154709, 14573, 346, true
6750, 1566722154363, 14227, 1566722154737, 14601, 374, true
6751, 1566722154364, 14228, 1566722154730, 14594, 366, true
6752, 1566722154368, 14232, 1566722154738, 14602, 370, true
6753, 1566722154369, 14233, 1566722154744, 14608, 375, true
6754, 1566722154369, 14233, 1566722154677, 14541, 308, true
6755, 1566722154370, 14234, 1566722154746, 14610, 376, true
6756, 1566722154371, 14235, 1566722154745, 14609, 374, true
6757, 1566722154373, 14237, 1566722154681, 14545, 308, true
6758, 1566722154374, 14238, 1566722154744, 14608, 370, true
6759, 1566722154376, 14240, 1566722154709, 14573, 333, true
6760, 1566722154377, 14241, 1566722154744, 14608, 367, true
6761, 1566722154387, 14251, 1566722154745, 14609, 358, true
6762, 1566722154387, 14251, 1566722154744, 14608, 357, true
6763, 1566722154388, 14252, 1566722154746, 14610, 358, true
6764, 1566722154388, 14252, 1566722154745, 14609, 357, true
6765, 1566722154389, 14253, 1566722154745, 14609, 356, true
6766, 1566722154390, 14254, 1566722154678, 14542, 288, true
6767, 1566722154391, 14255, 1566722154709, 14573, 318, true
6768, 1566722154399, 14263, 1566722154734, 14598, 335, true
6769, 1566722154399, 14263, 1566722154720, 14584, 321, true
6770, 1566722154400, 14264, 1566722154741, 14605, 341, true
6771, 1566722154400, 14264, 1566722154678, 14542, 278, true
6772, 1566722154401, 14265, 1566722154744, 14608, 343, true
6773, 1566722154402, 14266, 1566722154683, 14547, 281, true
6774, 1566722154403, 14267, 1566722154677, 14541, 274, true
6775, 1566722154406, 14270, 1566722154710, 14574, 304, true
6776, 1566722154409, 14273, 1566722154740, 14604, 331, true
6777, 1566722154530, 14394, 1566722154739, 14603, 209, true
6778, 1566722154531, 14395, 1566722154739, 14603, 208, true
6779, 1566722154531, 14395, 1566722154737, 14601, 206, true
6780, 1566722154532, 14396, 1566722154738, 14602, 206, true
6781, 1566722154533, 14397, 1566722154737, 14601, 204, true
6782, 1566722154535, 14399, 1566722154744, 14608, 209, true
6783, 1566722154535, 14399, 1566722154743, 14607, 208, true
6784, 1566722154536, 14400, 1566722154743, 14607, 207, true
6785, 1566722154536, 14400, 1566722154753, 14617, 217, true
6786, 1566722154537, 14401, 1566722154751, 14615, 214, true
6787, 1566722154538, 14402, 1566722154751, 14615, 213, true
6788, 1566722154538, 14402, 1566722154753, 14617, 215, true
6789, 1566722154538, 14402, 1566722154747, 14611, 209, true
6790, 1566722154539, 14403, 1566722154758, 14622, 219, true
6791, 1566722154539, 14403, 1566722154751, 14615, 212, true
6792, 1566722154540, 14404, 1566722154753, 14617, 213, true
6793, 1566722154540, 14404, 1566722154758, 14622, 218, true
6794, 1566722154541, 14405, 1566722154757, 14621, 216, true
6795, 1566722154542, 14406, 1566722154753, 14617, 211, true
6796, 1566722154542, 14406, 1566722154750, 14614, 208, true
6797, 1566722154543, 14407, 1566722154753, 14617, 210, true
6798, 1566722154550, 14414, 1566722154764, 14628, 214, true
6799, 1566722154551, 14415, 1566722154759, 14623, 208, true
6800, 1566722154552, 14416, 1566722154779, 14643, 227, true
6801, 1566722154552, 14416, 1566722154764, 14628, 212, true
6802, 1566722154553, 14417, 1566722154779, 14643, 226, true
6803, 1566722154554, 14418, 1566722154765, 14629, 211, true
6804, 1566722154554, 14418, 1566722154765, 14629, 211, true
6805, 1566722154554, 14418, 1566722154776, 14640, 222, true
6806, 1566722154555, 14419, 1566722154764, 14628, 209, true
6807, 1566722154555, 14419, 1566722154779, 14643, 224, true
6808, 1566722154556, 14420, 1566722154779, 14643, 223, true
6809, 1566722154556, 14420, 1566722154780, 14644, 224, true
6810, 1566722154556, 14420, 1566722154779, 14643, 223, true
6811, 1566722154557, 14421, 1566722154779, 14643, 222, true
6812, 1566722154558, 14422, 1566722154775, 14639, 217, true
6813, 1566722154559, 14423, 1566722154776, 14640, 217, true
6814, 1566722154559, 14423, 1566722154784, 14648, 225, true
6815, 1566722154559, 14423, 1566722154784, 14648, 225, true
6816, 1566722154560, 14424, 1566722154781, 14645, 221, true
6817, 1566722154561, 14425, 1566722154775, 14639, 214, true
6818, 1566722154561, 14425, 1566722154781, 14645, 220, true
6819, 1566722154562, 14426, 1566722154784, 14648, 222, true
6820, 1566722154563, 14427, 1566722154779, 14643, 216, true
6821, 1566722154564, 14428, 1566722154780, 14644, 216, true
6822, 1566722154564, 14428, 1566722154776, 14640, 212, true
6823, 1566722154565, 14429, 1566722154781, 14645, 216, true
6824, 1566722154576, 14440, 1566722155069, 14933, 493, true
6825, 1566722154644, 14508, 1566722155072, 14936, 428, true
6826, 1566722154645, 14509, 1566722155069, 14933, 424, true
6827, 1566722154645, 14509, 1566722155069, 14933, 424, true
6828, 1566722154645, 14509, 1566722155075, 14939, 430, true
6829, 1566722154689, 14553, 1566722155073, 14937, 384, true
6830, 1566722154690, 14554, 1566722155073, 14937, 383, true
6831, 1566722154691, 14555, 1566722155073, 14937, 382, true
6832, 1566722154691, 14555, 1566722155073, 14937, 382, true
6833, 1566722154692, 14556, 1566722155073, 14937, 381, true
6834, 1566722154703, 14567, 1566722155073, 14937, 370, true
6835, 1566722154718, 14582, 1566722155073, 14937, 355, true
6836, 1566722154719, 14583, 1566722155073, 14937, 354, true
6837, 1566722154721, 14585, 1566722155073, 14937, 352, true
6838, 1566722154721, 14585, 1566722155073, 14937, 352, true
6839, 1566722154722, 14586, 1566722155073, 14937, 351, true
6840, 1566722154722, 14586, 1566722155073, 14937, 351, true
6841, 1566722154722, 14586, 1566722155073, 14937, 351, true
6842, 1566722154723, 14587, 1566722155073, 14937, 350, true
6843, 1566722154723, 14587, 1566722155073, 14937, 350, true
6844, 1566722154723, 14587, 1566722155074, 14938, 351, true
6845, 1566722154723, 14587, 1566722155074, 14938, 351, true
6846, 1566722154724, 14588, 1566722155073, 14937, 349, true
6847, 1566722154724, 14588, 1566722155073, 14937, 349, true
6848, 1566722154724, 14588, 1566722155074, 14938, 350, true
6849, 1566722154724, 14588, 1566722155074, 14938, 350, true
6850, 1566722154724, 14588, 1566722155074, 14938, 350, true
6851, 1566722154724, 14588, 1566722155074, 14938, 350, true
6852, 1566722154724, 14588, 1566722155074, 14938, 350, true
6853, 1566722154725, 14589, 1566722155073, 14937, 348, true
6854, 1566722154725, 14589, 1566722155074, 14938, 349, true
6855, 1566722154725, 14589, 1566722155074, 14938, 349, true
6856, 1566722154725, 14589, 1566722155073, 14937, 348, true
6857, 1566722154726, 14590, 1566722155073, 14937, 347, true
6858, 1566722154727, 14591, 1566722155074, 14938, 347, true
6859, 1566722154727, 14591, 1566722155075, 14939, 348, true
6860, 1566722154728, 14592, 1566722155073, 14937, 345, true
6861, 1566722154773, 14637, 1566722155074, 14938, 301, true
6862, 1566722154776, 14640, 1566722155074, 14938, 298, true
6863, 1566722154789, 14653, 1566722155075, 14939, 286, true
6864, 1566722154789, 14653, 1566722155075, 14939, 286, true
6865, 1566722154790, 14654, 1566722155075, 14939, 285, true
6866, 1566722154791, 14655, 1566722155075, 14939, 284, true
6867, 1566722154791, 14655, 1566722155075, 14939, 284, true
6868, 1566722154792, 14656, 1566722155075, 14939, 283, true
6869, 1566722154792, 14656, 1566722155075, 14939, 283, true
6870, 1566722154792, 14656, 1566722155075, 14939, 283, true
6871, 1566722154792, 14656, 1566722155075, 14939, 283, true
6872, 1566722154793, 14657, 1566722155075, 14939, 282, true
6873, 1566722154795, 14659, 1566722155075, 14939, 280, true
6874, 1566722154797, 14661, 1566722155075, 14939, 278, true
6875, 1566722154798, 14662, 1566722155068, 14932, 270, true
6876, 1566722154799, 14663, 1566722155067, 14931, 268, true
6877, 1566722154799, 14663, 1566722155068, 14932, 269, true
6878, 1566722154800, 14664, 1566722155067, 14931, 267, true
6879, 1566722154801, 14665, 1566722155067, 14931, 266, true
6880, 1566722154802, 14666, 1566722155067, 14931, 265, true
6881, 1566722154803, 14667, 1566722155067, 14931, 264, true
6882, 1566722154803, 14667, 1566722155067, 14931, 264, true
6883, 1566722154803, 14667, 1566722155067, 14931, 264, true
6884, 1566722154804, 14668, 1566722155067, 14931, 263, true
6885, 1566722154804, 14668, 1566722155067, 14931, 263, true
6886, 1566722154804, 14668, 1566722155067, 14931, 263, true
6887, 1566722154805, 14669, 1566722155096, 14960, 291, true
6888, 1566722154806, 14670, 1566722155094, 14958, 288, true
6889, 1566722154806, 14670, 1566722155098, 14962, 292, true
6890, 1566722154807, 14671, 1566722155095, 14959, 288, true
6891, 1566722154807, 14671, 1566722155098, 14962, 291, true
6892, 1566722154808, 14672, 1566722155098, 14962, 290, true
6893, 1566722154808, 14672, 1566722155098, 14962, 290, true
6894, 1566722154808, 14672, 1566722155119, 14983, 311, true
6895, 1566722154809, 14673, 1566722155098, 14962, 289, true
6896, 1566722154809, 14673, 1566722155094, 14958, 285, true
6897, 1566722154809, 14673, 1566722155095, 14959, 286, true
6898, 1566722154809, 14673, 1566722155101, 14965, 292, true
6899, 1566722154810, 14674, 1566722155095, 14959, 285, true
6900, 1566722154810, 14674, 1566722155094, 14958, 284, true
6901, 1566722154810, 14674, 1566722155092, 14956, 282, true
6902, 1566722154811, 14675, 1566722155098, 14962, 287, true
6903, 1566722154812, 14676, 1566722155093, 14957, 281, true
6904, 1566722154812, 14676, 1566722155098, 14962, 286, true
6905, 1566722154813, 14677, 1566722155098, 14962, 285, true
6906, 1566722154815, 14679, 1566722155182, 15046, 367, true
6907, 1566722154815, 14679, 1566722155176, 15040, 361, true
6908, 1566722154816, 14680, 1566722155177, 15041, 361, true
6909, 1566722154816, 14680, 1566722155165, 15029, 349, true
6910, 1566722154816, 14680, 1566722155175, 15039, 359, true
6911, 1566722154817, 14681, 1566722155093, 14957, 276, true
6912, 1566722154817, 14681, 1566722155188, 15052, 371, true
6913, 1566722154817, 14681, 1566722155189, 15053, 372, true
6914, 1566722154817, 14681, 1566722155187, 15051, 370, true
6915, 1566722154818, 14682, 1566722155166, 15030, 348, true
6916, 1566722154818, 14682, 1566722155187, 15051, 369, true
6917, 1566722154818, 14682, 1566722155164, 15028, 346, true
6918, 1566722154818, 14682, 1566722155188, 15052, 370, true
6919, 1566722154819, 14683, 1566722155188, 15052, 369, true
6920, 1566722154819, 14683, 1566722155177, 15041, 358, true
6921, 1566722154819, 14683, 1566722155188, 15052, 369, true
6922, 1566722154819, 14683, 1566722155181, 15045, 362, true
6923, 1566722154820, 14684, 1566722155178, 15042, 358, true
6924, 1566722154820, 14684, 1566722155158, 15022, 338, true
6925, 1566722154820, 14684, 1566722155160, 15024, 340, true
6926, 1566722154820, 14684, 1566722155178, 15042, 358, true
6927, 1566722154821, 14685, 1566722155182, 15046, 361, true
6928, 1566722154821, 14685, 1566722155160, 15024, 339, true
6929, 1566722154821, 14685, 1566722155189, 15053, 368, true
6930, 1566722154822, 14686, 1566722155158, 15022, 336, true
6931, 1566722154822, 14686, 1566722155167, 15031, 345, true
6932, 1566722154823, 14687, 1566722155177, 15041, 354, true
6933, 1566722154823, 14687, 1566722155181, 15045, 358, true
6934, 1566722154823, 14687, 1566722155188, 15052, 365, true
6935, 1566722154823, 14687, 1566722155159, 15023, 336, true
6936, 1566722154824, 14688, 1566722155161, 15025, 337, true
6937, 1566722154824, 14688, 1566722155167, 15031, 343, true
6938, 1566722154824, 14688, 1566722155188, 15052, 364, true
6939, 1566722154825, 14689, 1566722155163, 15027, 338, true
6940, 1566722154825, 14689, 1566722155178, 15042, 353, true
6941, 1566722154825, 14689, 1566722155175, 15039, 350, true
6942, 1566722154826, 14690, 1566722155139, 15003, 313, true
6943, 1566722154826, 14690, 1566722155179, 15043, 353, true
6944, 1566722154826, 14690, 1566722155177, 15041, 351, true
6945, 1566722154826, 14690, 1566722155177, 15041, 351, true
6946, 1566722154827, 14691, 1566722155164, 15028, 337, true
6947, 1566722154827, 14691, 1566722155179, 15043, 352, true
6948, 1566722154827, 14691, 1566722155180, 15044, 353, true
6949, 1566722154827, 14691, 1566722155179, 15043, 352, true
6950, 1566722154828, 14692, 1566722155167, 15031, 339, true
6951, 1566722154828, 14692, 1566722155180, 15044, 352, true
6952, 1566722154828, 14692, 1566722155182, 15046, 354, true
6953, 1566722154829, 14693, 1566722155164, 15028, 335, true
6954, 1566722154829, 14693, 1566722155189, 15053, 360, true
6955, 1566722154830, 14694, 1566722155177, 15041, 347, true
6956, 1566722154830, 14694, 1566722155188, 15052, 358, true
6957, 1566722154831, 14695, 1566722155182, 15046, 351, true
6958, 1566722154831, 14695, 1566722155187, 15051, 356, true
6959, 1566722154831, 14695, 1566722155176, 15040, 345, true
6960, 1566722154832, 14696, 1566722155178, 15042, 346, true
6961, 1566722154832, 14696, 1566722155161, 15025, 329, true
6962, 1566722154832, 14696, 1566722155159, 15023, 327, true
6963, 1566722154832, 14696, 1566722155181, 15045, 349, true
6964, 1566722154833, 14697, 1566722155167, 15031, 334, true
6965, 1566722154833, 14697, 1566722155179, 15043, 346, true
6966, 1566722154834, 14698, 1566722155181, 15045, 347, true
6967, 1566722154834, 14698, 1566722155163, 15027, 329, true
6968, 1566722154834, 14698, 1566722155179, 15043, 345, true
6969, 1566722154835, 14699, 1566722155181, 15045, 346, true
6970, 1566722154835, 14699, 1566722155178, 15042, 343, true
6971, 1566722154835, 14699, 1566722155177, 15041, 342, true
6972, 1566722154836, 14700, 1566722155167, 15031, 331, true
6973, 1566722154836, 14700, 1566722155181, 15045, 345, true
6974, 1566722154836, 14700, 1566722155188, 15052, 352, true
6975, 1566722154837, 14701, 1566722155164, 15028, 327, true
6976, 1566722154838, 14702, 1566722155159, 15023, 321, true
6977, 1566722154838, 14702, 1566722155192, 15056, 354, true
6978, 1566722154838, 14702, 1566722155187, 15051, 349, true
6979, 1566722154838, 14702, 1566722155187, 15051, 349, true
6980, 1566722154839, 14703, 1566722155188, 15052, 349, true
6981, 1566722154839, 14703, 1566722155180, 15044, 341, true
6982, 1566722154839, 14703, 1566722155177, 15041, 338, true
6983, 1566722154839, 14703, 1566722155179, 15043, 340, true
6984, 1566722154840, 14704, 1566722155165, 15029, 325, true
6985, 1566722154840, 14704, 1566722155158, 15022, 318, true
6986, 1566722154840, 14704, 1566722155189, 15053, 349, true
6987, 1566722154840, 14704, 1566722155176, 15040, 336, true
6988, 1566722154841, 14705, 1566722155181, 15045, 340, true
6989, 1566722154841, 14705, 1566722155176, 15040, 335, true
6990, 1566722154841, 14705, 1566722155178, 15042, 337, true
6991, 1566722154842, 14706, 1566722155164, 15028, 322, true
6992, 1566722154842, 14706, 1566722155158, 15022, 316, true
6993, 1566722154842, 14706, 1566722155178, 15042, 336, true
6994, 1566722154842, 14706, 1566722155180, 15044, 338, true
6995, 1566722154843, 14707, 1566722155182, 15046, 339, true
6996, 1566722154843, 14707, 1566722155177, 15041, 334, true
6997, 1566722154843, 14707, 1566722155188, 15052, 345, true
6998, 1566722154844, 14708, 1566722155180, 15044, 336, true
6999, 1566722154844, 14708, 1566722155159, 15023, 315, true
7000, 1566722154845, 14709, 1566722155181, 15045, 336, true
7001, 1566722154845, 14709, 1566722155187, 15051, 342, true
7002, 1566722154846, 14710, 1566722155175, 15039, 329, true
7003, 1566722154846, 14710, 1566722155176, 15040, 330, true
7004, 1566722154846, 14710, 1566722155188, 15052, 342, true
7005, 1566722154847, 14711, 1566722155182, 15046, 335, true
7006, 1566722154847, 14711, 1566722155167, 15031, 320, true
7007, 1566722154847, 14711, 1566722155182, 15046, 335, true
7008, 1566722154847, 14711, 1566722155175, 15039, 328, true
7009, 1566722154848, 14712, 1566722155182, 15046, 334, true
7010, 1566722154849, 14713, 1566722155178, 15042, 329, true
7011, 1566722154849, 14713, 1566722155189, 15053, 340, true
7012, 1566722154849, 14713, 1566722155179, 15043, 330, true
7013, 1566722154849, 14713, 1566722155179, 15043, 330, true
7014, 1566722154850, 14714, 1566722155187, 15051, 337, true
7015, 1566722154850, 14714, 1566722155180, 15044, 330, true
7016, 1566722154850, 14714, 1566722155179, 15043, 329, true
7017, 1566722154851, 14715, 1566722155158, 15022, 307, true
7018, 1566722154851, 14715, 1566722155181, 15045, 330, true
7019, 1566722154851, 14715, 1566722155188, 15052, 337, true
7020, 1566722154852, 14716, 1566722155159, 15023, 307, true
7021, 1566722154852, 14716, 1566722155142, 15006, 290, true
7022, 1566722154852, 14716, 1566722155189, 15053, 337, true
7023, 1566722154853, 14717, 1566722155187, 15051, 334, true
7024, 1566722154853, 14717, 1566722155159, 15023, 306, true
7025, 1566722154853, 14717, 1566722155180, 15044, 327, true
7026, 1566722154854, 14718, 1566722155188, 15052, 334, true
7027, 1566722154854, 14718, 1566722155176, 15040, 322, true
7028, 1566722154854, 14718, 1566722155188, 15052, 334, true
7029, 1566722154855, 14719, 1566722155175, 15039, 320, true
7030, 1566722154855, 14719, 1566722155165, 15029, 310, true
7031, 1566722154855, 14719, 1566722155160, 15024, 305, true
7032, 1566722154855, 14719, 1566722155180, 15044, 325, true
7033, 1566722154856, 14720, 1566722155167, 15031, 311, true
7034, 1566722154856, 14720, 1566722155157, 15021, 301, true
7035, 1566722154856, 14720, 1566722155193, 15057, 337, true
7036, 1566722154857, 14721, 1566722155157, 15021, 300, true
7037, 1566722154857, 14721, 1566722155158, 15022, 301, true
7038, 1566722154857, 14721, 1566722155158, 15022, 301, true
7039, 1566722154857, 14721, 1566722155158, 15022, 301, true
7040, 1566722154858, 14722, 1566722155158, 15022, 300, true
7041, 1566722154858, 14722, 1566722155296, 15160, 438, true
7042, 1566722154858, 14722, 1566722155296, 15160, 438, true
7043, 1566722154858, 14722, 1566722155295, 15159, 437, true
7044, 1566722154859, 14723, 1566722155296, 15160, 437, true
7045, 1566722155069, 14933, 1566722155296, 15160, 227, true
7046, 1566722155072, 14936, 1566722155296, 15160, 224, true
7047, 1566722155072, 14936, 1566722155296, 15160, 224, true
7048, 1566722155070, 14934, 1566722155296, 15160, 226, true
7049, 1566722155070, 14934, 1566722155296, 15160, 226, true
7050, 1566722155069, 14933, 1566722155296, 15160, 227, true
7051, 1566722155083, 14947, 1566722155296, 15160, 213, true
7052, 1566722155083, 14947, 1566722155296, 15160, 213, true
7053, 1566722155084, 14948, 1566722155295, 15159, 211, true
7054, 1566722155085, 14949, 1566722155296, 15160, 211, true
7055, 1566722155085, 14949, 1566722155296, 15160, 211, true
7056, 1566722155085, 14949, 1566722155297, 15161, 212, true
7057, 1566722155086, 14950, 1566722155295, 15159, 209, true
7058, 1566722155086, 14950, 1566722155296, 15160, 210, true
7059, 1566722155087, 14951, 1566722155296, 15160, 209, true
7060, 1566722155088, 14952, 1566722155312, 15176, 224, true
7061, 1566722155089, 14953, 1566722155299, 15163, 210, true
7062, 1566722155090, 14954, 1566722155300, 15164, 210, true
7063, 1566722155090, 14954, 1566722155312, 15176, 222, true
7064, 1566722155099, 14963, 1566722155311, 15175, 212, true
7065, 1566722155100, 14964, 1566722155311, 15175, 211, true
7066, 1566722155103, 14967, 1566722155311, 15175, 208, true
7067, 1566722155103, 14967, 1566722155312, 15176, 209, true
7068, 1566722155103, 14967, 1566722155312, 15176, 209, true
7069, 1566722155104, 14968, 1566722155312, 15176, 208, true
7070, 1566722155104, 14968, 1566722155312, 15176, 208, true
7071, 1566722155105, 14969, 1566722155312, 15176, 207, true
7072, 1566722155107, 14971, 1566722155319, 15183, 212, true
7073, 1566722155108, 14972, 1566722155312, 15176, 204, true
7074, 1566722155110, 14974, 1566722155318, 15182, 208, true
7075, 1566722155111, 14975, 1566722155318, 15182, 207, true
7076, 1566722155113, 14977, 1566722155318, 15182, 205, true
7077, 1566722155114, 14978, 1566722155320, 15184, 206, true
7078, 1566722155116, 14980, 1566722155320, 15184, 204, true
7079, 1566722155117, 14981, 1566722155330, 15194, 213, true
7080, 1566722155119, 14983, 1566722155322, 15186, 203, true
7081, 1566722155120, 14984, 1566722155330, 15194, 210, true
7082, 1566722155122, 14986, 1566722155331, 15195, 209, true
7083, 1566722155122, 14986, 1566722155330, 15194, 208, true
7084, 1566722155122, 14986, 1566722155331, 15195, 209, true
7085, 1566722155123, 14987, 1566722155330, 15194, 207, true
7086, 1566722155123, 14987, 1566722155335, 15199, 212, true
7087, 1566722155124, 14988, 1566722155334, 15198, 210, true
7088, 1566722155125, 14989, 1566722155339, 15203, 214, true
7089, 1566722155125, 14989, 1566722155335, 15199, 210, true
7090, 1566722155126, 14990, 1566722155334, 15198, 208, true
7091, 1566722155127, 14991, 1566722155334, 15198, 207, true
7092, 1566722155129, 14993, 1566722155339, 15203, 210, true
7093, 1566722155130, 14994, 1566722155339, 15203, 209, true
7094, 1566722155130, 14994, 1566722155339, 15203, 209, true
7095, 1566722155131, 14995, 1566722155339, 15203, 208, true
7096, 1566722155131, 14995, 1566722155339, 15203, 208, true
7097, 1566722155131, 14995, 1566722155339, 15203, 208, true
7098, 1566722155132, 14996, 1566722155399, 15263, 267, true
7099, 1566722155132, 14996, 1566722155402, 15266, 270, true
7100, 1566722155132, 14996, 1566722155399, 15263, 267, true
7101, 1566722155134, 14998, 1566722155339, 15203, 205, true
7102, 1566722155135, 14999, 1566722155402, 15266, 267, true
7103, 1566722155135, 14999, 1566722155402, 15266, 267, true
7104, 1566722155136, 15000, 1566722155402, 15266, 266, true
7105, 1566722155136, 15000, 1566722155402, 15266, 266, true
7106, 1566722155137, 15001, 1566722155402, 15266, 265, true
7107, 1566722155138, 15002, 1566722155402, 15266, 264, true
7108, 1566722155138, 15002, 1566722155402, 15266, 264, true
7109, 1566722155139, 15003, 1566722155343, 15207, 204, true
7110, 1566722155202, 15066, 1566722155414, 15278, 212, true
7111, 1566722155203, 15067, 1566722155416, 15280, 213, true
7112, 1566722155204, 15068, 1566722155425, 15289, 221, true
7113, 1566722155204, 15068, 1566722155425, 15289, 221, true
7114, 1566722155204, 15068, 1566722155425, 15289, 221, true
7115, 1566722155205, 15069, 1566722155425, 15289, 220, true
7116, 1566722155206, 15070, 1566722155425, 15289, 219, true
7117, 1566722155206, 15070, 1566722155425, 15289, 219, true
7118, 1566722155219, 15083, 1566722155486, 15350, 267, true
7119, 1566722155220, 15084, 1566722155485, 15349, 265, true
7120, 1566722155221, 15085, 1566722155487, 15351, 266, true
7121, 1566722155221, 15085, 1566722155486, 15350, 265, true
7122, 1566722155221, 15085, 1566722155486, 15350, 265, true
7123, 1566722155222, 15086, 1566722155487, 15351, 265, true
7124, 1566722155222, 15086, 1566722155487, 15351, 265, true
7125, 1566722155222, 15086, 1566722155487, 15351, 265, true
7126, 1566722155223, 15087, 1566722155486, 15350, 263, true
7127, 1566722155223, 15087, 1566722155486, 15350, 263, true
7128, 1566722155223, 15087, 1566722155487, 15351, 264, true
7129, 1566722155224, 15088, 1566722155486, 15350, 262, true
7130, 1566722155224, 15088, 1566722155487, 15351, 263, true
7131, 1566722155224, 15088, 1566722155487, 15351, 263, true
7132, 1566722155225, 15089, 1566722155487, 15351, 262, true
7133, 1566722155225, 15089, 1566722155487, 15351, 262, true
7134, 1566722155225, 15089, 1566722155486, 15350, 261, true
7135, 1566722155225, 15089, 1566722155486, 15350, 261, true
7136, 1566722155231, 15095, 1566722155487, 15351, 256, true
7137, 1566722155233, 15097, 1566722155487, 15351, 254, true
7138, 1566722155235, 15099, 1566722155488, 15352, 253, true
7139, 1566722155237, 15101, 1566722155488, 15352, 251, true
7140, 1566722155239, 15103, 1566722155488, 15352, 249, true
7141, 1566722155240, 15104, 1566722155488, 15352, 248, true
7142, 1566722155241, 15105, 1566722155488, 15352, 247, true
7143, 1566722155242, 15106, 1566722155488, 15352, 246, true
7144, 1566722155243, 15107, 1566722155488, 15352, 245, true
7145, 1566722155244, 15108, 1566722155488, 15352, 244, true
7146, 1566722155244, 15108, 1566722155488, 15352, 244, true
7147, 1566722155245, 15109, 1566722155489, 15353, 244, true
7148, 1566722155245, 15109, 1566722155489, 15353, 244, true
7149, 1566722155246, 15110, 1566722155489, 15353, 243, true
7150, 1566722155246, 15110, 1566722155489, 15353, 243, true
7151, 1566722155246, 15110, 1566722155490, 15354, 244, true
7152, 1566722155247, 15111, 1566722155490, 15354, 243, true
7153, 1566722155248, 15112, 1566722155490, 15354, 242, true
7154, 1566722155249, 15113, 1566722155490, 15354, 241, true
7155, 1566722155249, 15113, 1566722155491, 15355, 242, true
7156, 1566722155252, 15116, 1566722155491, 15355, 239, true
7157, 1566722155252, 15116, 1566722155491, 15355, 239, true
7158, 1566722155253, 15117, 1566722155491, 15355, 238, true
7159, 1566722155253, 15117, 1566722155491, 15355, 238, true
7160, 1566722155254, 15118, 1566722155491, 15355, 237, true
7161, 1566722155255, 15119, 1566722155491, 15355, 236, true
7162, 1566722155256, 15120, 1566722155491, 15355, 235, true
7163, 1566722155256, 15120, 1566722155491, 15355, 235, true
7164, 1566722155257, 15121, 1566722155492, 15356, 235, true
7165, 1566722155257, 15121, 1566722155492, 15356, 235, true
7166, 1566722155258, 15122, 1566722155492, 15356, 234, true
7167, 1566722155258, 15122, 1566722155492, 15356, 234, true
7168, 1566722155258, 15122, 1566722155492, 15356, 234, true
7169, 1566722155259, 15123, 1566722155492, 15356, 233, true
7170, 1566722155260, 15124, 1566722155492, 15356, 232, true
7171, 1566722155260, 15124, 1566722155492, 15356, 232, true
7172, 1566722155261, 15125, 1566722155492, 15356, 231, true
7173, 1566722155265, 15129, 1566722155493, 15357, 228, true
7174, 1566722155265, 15129, 1566722155492, 15356, 227, true
7175, 1566722155267, 15131, 1566722155493, 15357, 226, true
7176, 1566722155267, 15131, 1566722155493, 15357, 226, true
7177, 1566722155269, 15133, 1566722155493, 15357, 224, true
7178, 1566722155269, 15133, 1566722155493, 15357, 224, true
7179, 1566722155269, 15133, 1566722155493, 15357, 224, true
7180, 1566722155270, 15134, 1566722155493, 15357, 223, true
7181, 1566722155271, 15135, 1566722155493, 15357, 222, true
7182, 1566722155271, 15135, 1566722155493, 15357, 222, true
7183, 1566722155272, 15136, 1566722155493, 15357, 221, true
7184, 1566722155273, 15137, 1566722155494, 15358, 221, true
7185, 1566722155274, 15138, 1566722155496, 15360, 222, true
7186, 1566722155274, 15138, 1566722155494, 15358, 220, true
7187, 1566722155276, 15140, 1566722155497, 15361, 221, true
7188, 1566722155276, 15140, 1566722155497, 15361, 221, true
7189, 1566722155277, 15141, 1566722155494, 15358, 217, true
7190, 1566722155277, 15141, 1566722155494, 15358, 217, true
7191, 1566722155278, 15142, 1566722155497, 15361, 219, true
7192, 1566722155279, 15143, 1566722155497, 15361, 218, true
7193, 1566722155280, 15144, 1566722155497, 15361, 217, true
7194, 1566722155281, 15145, 1566722155497, 15361, 216, true
7195, 1566722155281, 15145, 1566722155497, 15361, 216, true
7196, 1566722155282, 15146, 1566722155497, 15361, 215, true
7197, 1566722155283, 15147, 1566722155497, 15361, 214, true
7198, 1566722155284, 15148, 1566722155497, 15361, 213, true
7199, 1566722155285, 15149, 1566722155497, 15361, 212, true
7200, 1566722155285, 15149, 1566722155505, 15369, 220, true
7201, 1566722155286, 15150, 1566722155506, 15370, 220, true
7202, 1566722155287, 15151, 1566722155507, 15371, 220, true
7203, 1566722155327, 15191, 1566722155540, 15404, 213, true
7204, 1566722155327, 15191, 1566722155545, 15409, 218, true
7205, 1566722155344, 15208, 1566722155552, 15416, 208, true
7206, 1566722155345, 15209, 1566722155554, 15418, 209, true
7207, 1566722155347, 15211, 1566722155553, 15417, 206, true
7208, 1566722155348, 15212, 1566722155553, 15417, 205, true
7209, 1566722155349, 15213, 1566722155554, 15418, 205, true
7210, 1566722155350, 15214, 1566722155558, 15422, 208, true
7211, 1566722155353, 15217, 1566722155558, 15422, 205, true
7212, 1566722155354, 15218, 1566722155562, 15426, 208, true
7213, 1566722155357, 15221, 1566722155562, 15426, 205, true
7214, 1566722155358, 15222, 1566722155564, 15428, 206, true
7215, 1566722155358, 15222, 1566722155568, 15432, 210, true
7216, 1566722155359, 15223, 1566722155564, 15428, 205, true
7217, 1566722155360, 15224, 1566722155569, 15433, 209, true
7218, 1566722155360, 15224, 1566722155567, 15431, 207, true
7219, 1566722155362, 15226, 1566722155569, 15433, 207, true
7220, 1566722155368, 15232, 1566722155602, 15466, 234, true
7221, 1566722155368, 15232, 1566722155601, 15465, 233, true
7222, 1566722155368, 15232, 1566722155573, 15437, 205, true
7223, 1566722155369, 15233, 1566722155601, 15465, 232, true
7224, 1566722155369, 15233, 1566722155601, 15465, 232, true
7225, 1566722155370, 15234, 1566722155601, 15465, 231, true
7226, 1566722155374, 15238, 1566722155610, 15474, 236, true
7227, 1566722155376, 15240, 1566722155598, 15462, 222, true
7228, 1566722155379, 15243, 1566722155610, 15474, 231, true
7229, 1566722155381, 15245, 1566722155610, 15474, 229, true
7230, 1566722155383, 15247, 1566722155610, 15474, 227, true
7231, 1566722155383, 15247, 1566722155610, 15474, 227, true
7232, 1566722155384, 15248, 1566722155598, 15462, 214, true
7233, 1566722155385, 15249, 1566722155603, 15467, 218, true
7234, 1566722155387, 15251, 1566722155610, 15474, 223, true
7235, 1566722155388, 15252, 1566722155603, 15467, 215, true
7236, 1566722155388, 15252, 1566722155611, 15475, 223, true
7237, 1566722155389, 15253, 1566722155610, 15474, 221, true
7238, 1566722155389, 15253, 1566722155602, 15466, 213, true
7239, 1566722155389, 15253, 1566722155603, 15467, 214, true
7240, 1566722155390, 15254, 1566722155603, 15467, 213, true
7241, 1566722155390, 15254, 1566722155604, 15468, 214, true
7242, 1566722155390, 15254, 1566722155612, 15476, 222, true
7243, 1566722155391, 15255, 1566722155611, 15475, 220, true
7244, 1566722155392, 15256, 1566722155611, 15475, 219, true
7245, 1566722155409, 15273, 1566722155613, 15477, 204, true
7246, 1566722155411, 15275, 1566722155618, 15482, 207, true
7247, 1566722155411, 15275, 1566722155618, 15482, 207, true
7248, 1566722155411, 15275, 1566722155620, 15484, 209, true
7249, 1566722155411, 15275, 1566722155615, 15479, 204, true
7250, 1566722155412, 15276, 1566722155620, 15484, 208, true
7251, 1566722155414, 15278, 1566722155629, 15493, 215, true
7252, 1566722155414, 15278, 1566722155685, 15549, 271, true
7253, 1566722155415, 15279, 1566722155632, 15496, 217, true
7254, 1566722155416, 15280, 1566722155716, 15580, 300, true
7255, 1566722155417, 15281, 1566722155731, 15595, 314, true
7256, 1566722155417, 15281, 1566722155738, 15602, 321, true
7257, 1566722155417, 15281, 1566722155716, 15580, 299, true
7258, 1566722155418, 15282, 1566722155721, 15585, 303, true
7259, 1566722155418, 15282, 1566722155731, 15595, 313, true
7260, 1566722155418, 15282, 1566722155738, 15602, 320, true
7261, 1566722155418, 15282, 1566722155724, 15588, 306, true
7262, 1566722155419, 15283, 1566722155741, 15605, 322, true
7263, 1566722155419, 15283, 1566722155731, 15595, 312, true
7264, 1566722155419, 15283, 1566722155741, 15605, 322, true
7265, 1566722155420, 15284, 1566722155721, 15585, 301, true
7266, 1566722155426, 15290, 1566722155716, 15580, 290, true
7267, 1566722155426, 15290, 1566722155741, 15605, 315, true
7268, 1566722155427, 15291, 1566722155725, 15589, 298, true
7269, 1566722155427, 15291, 1566722155721, 15585, 294, true
7270, 1566722155427, 15291, 1566722155728, 15592, 301, true
7271, 1566722155428, 15292, 1566722155728, 15592, 300, true
7272, 1566722155429, 15293, 1566722155720, 15584, 291, true
7273, 1566722155429, 15293, 1566722155716, 15580, 287, true
7274, 1566722155430, 15294, 1566722155723, 15587, 293, true
7275, 1566722155431, 15295, 1566722155721, 15585, 290, true
7276, 1566722155432, 15296, 1566722155741, 15605, 309, true
7277, 1566722155432, 15296, 1566722155731, 15595, 299, true
7278, 1566722155433, 15297, 1566722155728, 15592, 295, true
7279, 1566722155434, 15298, 1566722155721, 15585, 287, true
7280, 1566722155434, 15298, 1566722155732, 15596, 298, true
7281, 1566722155435, 15299, 1566722155724, 15588, 289, true
7282, 1566722155436, 15300, 1566722155732, 15596, 296, true
7283, 1566722155438, 15302, 1566722155741, 15605, 303, true
7284, 1566722155439, 15303, 1566722155738, 15602, 299, true
7285, 1566722155440, 15304, 1566722155723, 15587, 283, true
7286, 1566722155440, 15304, 1566722155724, 15588, 284, true
7287, 1566722155441, 15305, 1566722155738, 15602, 297, true
7288, 1566722155441, 15305, 1566722155728, 15592, 287, true
7289, 1566722155442, 15306, 1566722155723, 15587, 281, true
7290, 1566722155444, 15308, 1566722155729, 15593, 285, true
7291, 1566722155445, 15309, 1566722155741, 15605, 296, true
7292, 1566722155446, 15310, 1566722155736, 15600, 290, true
7293, 1566722155447, 15311, 1566722155738, 15602, 291, true
7294, 1566722155447, 15311, 1566722155729, 15593, 282, true
7295, 1566722155448, 15312, 1566722155723, 15587, 275, true
7296, 1566722155448, 15312, 1566722155741, 15605, 293, true
7297, 1566722155449, 15313, 1566722155716, 15580, 267, true
7298, 1566722155450, 15314, 1566722155716, 15580, 266, true
7299, 1566722155450, 15314, 1566722155715, 15579, 265, true
7300, 1566722155450, 15314, 1566722155767, 15631, 317, true
7301, 1566722155450, 15314, 1566722155756, 15620, 306, true
7302, 1566722155451, 15315, 1566722155795, 15659, 344, true
7303, 1566722155451, 15315, 1566722155762, 15626, 311, true
7304, 1566722155452, 15316, 1566722155755, 15619, 303, true
7305, 1566722155452, 15316, 1566722155748, 15612, 296, true
7306, 1566722155453, 15317, 1566722155759, 15623, 306, true
7307, 1566722155453, 15317, 1566722155795, 15659, 342, true
7308, 1566722155453, 15317, 1566722155767, 15631, 314, true
7309, 1566722155454, 15318, 1566722155760, 15624, 306, true
7310, 1566722155454, 15318, 1566722155781, 15645, 327, true
7311, 1566722155454, 15318, 1566722155755, 15619, 301, true
7312, 1566722155454, 15318, 1566722155760, 15624, 306, true
7313, 1566722155455, 15319, 1566722155747, 15611, 292, true
7314, 1566722155455, 15319, 1566722155755, 15619, 300, true
7315, 1566722155455, 15319, 1566722155760, 15624, 305, true
7316, 1566722155455, 15319, 1566722155794, 15658, 339, true
7317, 1566722155456, 15320, 1566722155756, 15620, 300, true
7318, 1566722155456, 15320, 1566722155748, 15612, 292, true
7319, 1566722155457, 15321, 1566722155759, 15623, 302, true
7320, 1566722155457, 15321, 1566722155794, 15658, 337, true
7321, 1566722155458, 15322, 1566722155760, 15624, 302, true
7322, 1566722155458, 15322, 1566722155794, 15658, 336, true
7323, 1566722155458, 15322, 1566722155767, 15631, 309, true
7324, 1566722155458, 15322, 1566722155760, 15624, 302, true
7325, 1566722155459, 15323, 1566722155754, 15618, 295, true
7326, 1566722155460, 15324, 1566722155776, 15640, 316, true
7327, 1566722155461, 15325, 1566722155795, 15659, 334, true
7328, 1566722155462, 15326, 1566722155755, 15619, 293, true
7329, 1566722155462, 15326, 1566722155782, 15646, 320, true
7330, 1566722155463, 15327, 1566722155756, 15620, 293, true
7331, 1566722155463, 15327, 1566722155756, 15620, 293, true
7332, 1566722155464, 15328, 1566722155760, 15624, 296, true
7333, 1566722155464, 15328, 1566722155794, 15658, 330, true
7334, 1566722155464, 15328, 1566722155747, 15611, 283, true
7335, 1566722155465, 15329, 1566722155762, 15626, 297, true
7336, 1566722155466, 15330, 1566722155795, 15659, 329, true
7337, 1566722155469, 15333, 1566722155748, 15612, 279, true
7338, 1566722155470, 15334, 1566722155794, 15658, 324, true
7339, 1566722155470, 15334, 1566722155767, 15631, 297, true
7340, 1566722155470, 15334, 1566722155781, 15645, 311, true
7341, 1566722155470, 15334, 1566722155755, 15619, 285, true
7342, 1566722155513, 15377, 1566722155760, 15624, 247, true
7343, 1566722155513, 15377, 1566722155794, 15658, 281, true
7344, 1566722155514, 15378, 1566722155762, 15626, 248, true
7345, 1566722155516, 15380, 1566722155760, 15624, 244, true
7346, 1566722155517, 15381, 1566722155767, 15631, 250, true
7347, 1566722155518, 15382, 1566722155748, 15612, 230, true
7348, 1566722155519, 15383, 1566722155768, 15632, 249, true
7349, 1566722155519, 15383, 1566722155778, 15642, 259, true
7350, 1566722155519, 15383, 1566722155794, 15658, 275, true
7351, 1566722155526, 15390, 1566722155760, 15624, 234, true
7352, 1566722155531, 15395, 1566722155767, 15631, 236, true
7353, 1566722155532, 15396, 1566722155767, 15631, 235, true
7354, 1566722155532, 15396, 1566722155755, 15619, 223, true
7355, 1566722155532, 15396, 1566722155781, 15645, 249, true
7356, 1566722155533, 15397, 1566722155768, 15632, 235, true
7357, 1566722155534, 15398, 1566722155756, 15620, 222, true
7358, 1566722155535, 15399, 1566722155795, 15659, 260, true
7359, 1566722155535, 15399, 1566722155767, 15631, 232, true
7360, 1566722155538, 15402, 1566722155787, 15651, 249, true
7361, 1566722155539, 15403, 1566722155788, 15652, 249, true
7362, 1566722155540, 15404, 1566722155788, 15652, 248, true
7363, 1566722155541, 15405, 1566722155788, 15652, 247, true
7364, 1566722155541, 15405, 1566722155788, 15652, 247, true
7365, 1566722155542, 15406, 1566722155782, 15646, 240, true
7366, 1566722155545, 15409, 1566722155788, 15652, 243, true
7367, 1566722155554, 15418, 1566722155782, 15646, 228, true
7368, 1566722155558, 15422, 1566722155787, 15651, 229, true
7369, 1566722155574, 15438, 1566722155788, 15652, 214, true
7370, 1566722155580, 15444, 1566722155788, 15652, 208, true
7371, 1566722155580, 15444, 1566722155789, 15653, 209, true
7372, 1566722155580, 15444, 1566722155788, 15652, 208, true
7373, 1566722155581, 15445, 1566722155788, 15652, 207, true
7374, 1566722155581, 15445, 1566722155789, 15653, 208, true
7375, 1566722155582, 15446, 1566722155790, 15654, 208, true
7376, 1566722155583, 15447, 1566722155789, 15653, 206, true
7377, 1566722155584, 15448, 1566722155793, 15657, 209, true
7378, 1566722155585, 15449, 1566722155793, 15657, 208, true
7379, 1566722155586, 15450, 1566722155790, 15654, 204, true
7380, 1566722155587, 15451, 1566722155800, 15664, 213, true
7381, 1566722155588, 15452, 1566722155798, 15662, 210, true
7382, 1566722155588, 15452, 1566722155793, 15657, 205, true
7383, 1566722155589, 15453, 1566722155793, 15657, 204, true
7384, 1566722155590, 15454, 1566722155801, 15665, 211, true
7385, 1566722155591, 15455, 1566722155802, 15666, 211, true
7386, 1566722155591, 15455, 1566722155822, 15686, 231, true
7387, 1566722155592, 15456, 1566722155822, 15686, 230, true
7388, 1566722155593, 15457, 1566722155810, 15674, 217, true
7389, 1566722155594, 15458, 1566722155810, 15674, 216, true
7390, 1566722155594, 15458, 1566722155822, 15686, 228, true
7391, 1566722155595, 15459, 1566722155815, 15679, 220, true
7392, 1566722155595, 15459, 1566722155802, 15666, 207, true
7393, 1566722155595, 15459, 1566722155831, 15695, 236, true
7394, 1566722155596, 15460, 1566722155829, 15693, 233, true
7395, 1566722155596, 15460, 1566722155831, 15695, 235, true
7396, 1566722155596, 15460, 1566722155832, 15696, 236, true
7397, 1566722155597, 15461, 1566722155831, 15695, 234, true
7398, 1566722155599, 15463, 1566722155831, 15695, 232, true
7399, 1566722155601, 15465, 1566722155831, 15695, 230, true
7400, 1566722155613, 15477, 1566722155831, 15695, 218, true
7401, 1566722155614, 15478, 1566722155829, 15693, 215, true
7402, 1566722155615, 15479, 1566722155831, 15695, 216, true
7403, 1566722155615, 15479, 1566722155831, 15695, 216, true
7404, 1566722155615, 15479, 1566722155828, 15692, 213, true
7405, 1566722155616, 15480, 1566722155828, 15692, 212, true
7406, 1566722155627, 15491, 1566722155845, 15709, 218, true
7407, 1566722155628, 15492, 1566722155835, 15699, 207, true
7408, 1566722155628, 15492, 1566722155835, 15699, 207, true
7409, 1566722155628, 15492, 1566722155832, 15696, 204, true
7410, 1566722155630, 15494, 1566722155845, 15709, 215, true
7411, 1566722155630, 15494, 1566722155851, 15715, 221, true
7412, 1566722155632, 15496, 1566722155851, 15715, 219, true
7413, 1566722155635, 15499, 1566722155845, 15709, 210, true
7414, 1566722155637, 15501, 1566722155851, 15715, 214, true
7415, 1566722155638, 15502, 1566722155852, 15716, 214, true
7416, 1566722155639, 15503, 1566722155845, 15709, 206, true
7417, 1566722155640, 15504, 1566722155851, 15715, 211, true
7418, 1566722155640, 15504, 1566722155852, 15716, 212, true
7419, 1566722155640, 15504, 1566722155846, 15710, 206, true
7420, 1566722155641, 15505, 1566722155851, 15715, 210, true
7421, 1566722155641, 15505, 1566722155846, 15710, 205, true
7422, 1566722155645, 15509, 1566722155854, 15718, 209, true
7423, 1566722155646, 15510, 1566722155870, 15734, 224, true
7424, 1566722155647, 15511, 1566722155884, 15748, 237, true
7425, 1566722155648, 15512, 1566722155884, 15748, 236, true
7426, 1566722155649, 15513, 1566722155894, 15758, 245, true
7427, 1566722155651, 15515, 1566722155888, 15752, 237, true
7428, 1566722155652, 15516, 1566722155886, 15750, 234, true
7429, 1566722155653, 15517, 1566722155888, 15752, 235, true
7430, 1566722155653, 15517, 1566722155891, 15755, 238, true
7431, 1566722155654, 15518, 1566722155884, 15748, 230, true
7432, 1566722155654, 15518, 1566722155888, 15752, 234, true
7433, 1566722155656, 15520, 1566722155870, 15734, 214, true
7434, 1566722155657, 15521, 1566722155884, 15748, 227, true
7435, 1566722155658, 15522, 1566722155897, 15761, 239, true
7436, 1566722155664, 15528, 1566722155870, 15734, 206, true
7437, 1566722155667, 15531, 1566722155874, 15738, 207, true
7438, 1566722155669, 15533, 1566722155874, 15738, 205, true
7439, 1566722155671, 15535, 1566722155888, 15752, 217, true
7440, 1566722155672, 15536, 1566722155879, 15743, 207, true
7441, 1566722155673, 15537, 1566722155896, 15760, 223, true
7442, 1566722155674, 15538, 1566722155898, 15762, 224, true
7443, 1566722155674, 15538, 1566722155892, 15756, 218, true
7444, 1566722155674, 15538, 1566722155894, 15758, 220, true
7445, 1566722155674, 15538, 1566722155903, 15767, 229, true
7446, 1566722155675, 15539, 1566722155888, 15752, 213, true
7447, 1566722155677, 15541, 1566722155892, 15756, 215, true
7448, 1566722155679, 15543, 1566722155900, 15764, 221, true
7449, 1566722155680, 15544, 1566722155897, 15761, 217, true
7450, 1566722155681, 15545, 1566722155897, 15761, 216, true
7451, 1566722155686, 15550, 1566722155911, 15775, 225, true
7452, 1566722155687, 15551, 1566722155905, 15769, 218, true
7453, 1566722155688, 15552, 1566722155906, 15770, 218, true
7454, 1566722155688, 15552, 1566722155911, 15775, 223, true
7455, 1566722155689, 15553, 1566722155903, 15767, 214, true
7456, 1566722155690, 15554, 1566722155905, 15769, 215, true
7457, 1566722155691, 15555, 1566722155911, 15775, 220, true
7458, 1566722155692, 15556, 1566722155905, 15769, 213, true
7459, 1566722155692, 15556, 1566722155905, 15769, 213, true
7460, 1566722155695, 15559, 1566722155912, 15776, 217, true
7461, 1566722155696, 15560, 1566722155911, 15775, 215, true
7462, 1566722155697, 15561, 1566722155912, 15776, 215, true
7463, 1566722155697, 15561, 1566722155913, 15777, 216, true
7464, 1566722155701, 15565, 1566722155915, 15779, 214, true
7465, 1566722155703, 15567, 1566722155915, 15779, 212, true
7466, 1566722155704, 15568, 1566722155915, 15779, 211, true
7467, 1566722155705, 15569, 1566722155916, 15780, 211, true
7468, 1566722155708, 15572, 1566722155915, 15779, 207, true
7469, 1566722155709, 15573, 1566722155915, 15779, 206, true
7470, 1566722155709, 15573, 1566722155915, 15779, 206, true
7471, 1566722155711, 15575, 1566722155930, 15794, 219, true
7472, 1566722155712, 15576, 1566722155930, 15794, 218, true
7473, 1566722155717, 15581, 1566722155930, 15794, 213, true
7474, 1566722155825, 15689, 1566722156042, 15906, 217, true
7475, 1566722155837, 15701, 1566722156045, 15909, 208, true
7476, 1566722155838, 15702, 1566722156045, 15909, 207, true
7477, 1566722155838, 15702, 1566722156045, 15909, 207, true
7478, 1566722155839, 15703, 1566722156042, 15906, 203, true
7479, 1566722155839, 15703, 1566722156045, 15909, 206, true
7480, 1566722155839, 15703, 1566722156045, 15909, 206, true
7481, 1566722155842, 15706, 1566722156070, 15934, 228, true
7482, 1566722155847, 15711, 1566722156072, 15936, 225, true
7483, 1566722155847, 15711, 1566722156072, 15936, 225, true
7484, 1566722155848, 15712, 1566722156073, 15937, 225, true
7485, 1566722155848, 15712, 1566722156070, 15934, 222, true
7486, 1566722155848, 15712, 1566722156072, 15936, 224, true
7487, 1566722155849, 15713, 1566722156070, 15934, 221, true
7488, 1566722155855, 15719, 1566722156070, 15934, 215, true
7489, 1566722155855, 15719, 1566722156070, 15934, 215, true
7490, 1566722155855, 15719, 1566722156070, 15934, 215, true
7491, 1566722155856, 15720, 1566722156069, 15933, 213, true
7492, 1566722155856, 15720, 1566722156070, 15934, 214, true
7493, 1566722155859, 15723, 1566722156070, 15934, 211, true
7494, 1566722155860, 15724, 1566722156069, 15933, 209, true
7495, 1566722155862, 15726, 1566722156073, 15937, 211, true
7496, 1566722155864, 15728, 1566722156075, 15939, 211, true
7497, 1566722155864, 15728, 1566722156074, 15938, 210, true
7498, 1566722155865, 15729, 1566722156074, 15938, 209, true
7499, 1566722155865, 15729, 1566722156081, 15945, 216, true
7500, 1566722155866, 15730, 1566722156073, 15937, 207, true
7501, 1566722155867, 15731, 1566722156075, 15939, 208, true
7502, 1566722155872, 15736, 1566722156079, 15943, 207, true
7503, 1566722155872, 15736, 1566722156080, 15944, 208, true
7504, 1566722155875, 15739, 1566722156086, 15950, 211, true
7505, 1566722155875, 15739, 1566722156080, 15944, 205, true
7506, 1566722155876, 15740, 1566722156082, 15946, 206, true
7507, 1566722155876, 15740, 1566722156082, 15946, 206, true
7508, 1566722155879, 15743, 1566722156085, 15949, 206, true
7509, 1566722155880, 15744, 1566722156086, 15950, 206, true
7510, 1566722155881, 15745, 1566722156088, 15952, 207, true
7511, 1566722155889, 15753, 1566722156131, 15995, 242, true
7512, 1566722155889, 15753, 1566722156134, 15998, 245, true
7513, 1566722155889, 15753, 1566722156137, 16001, 248, true
7514, 1566722155889, 15753, 1566722156151, 16015, 262, true
7515, 1566722155890, 15754, 1566722156130, 15994, 240, true
7516, 1566722155890, 15754, 1566722156151, 16015, 261, true
7517, 1566722155891, 15755, 1566722156139, 16003, 248, true
7518, 1566722155891, 15755, 1566722156134, 15998, 243, true
7519, 1566722155892, 15756, 1566722156151, 16015, 259, true
7520, 1566722155893, 15757, 1566722156157, 16021, 264, true
7521, 1566722155894, 15758, 1566722156130, 15994, 236, true
7522, 1566722155894, 15758, 1566722156152, 16016, 258, true
7523, 1566722155895, 15759, 1566722156136, 16000, 241, true
7524, 1566722155895, 15759, 1566722156158, 16022, 263, true
7525, 1566722155897, 15761, 1566722156151, 16015, 254, true
7526, 1566722155897, 15761, 1566722156151, 16015, 254, true
7527, 1566722155898, 15762, 1566722156158, 16022, 260, true
7528, 1566722155898, 15762, 1566722156138, 16002, 240, true
7529, 1566722155899, 15763, 1566722156157, 16021, 258, true
7530, 1566722155900, 15764, 1566722156152, 16016, 252, true
7531, 1566722155901, 15765, 1566722156136, 16000, 235, true
7532, 1566722155902, 15766, 1566722156151, 16015, 249, true
7533, 1566722155902, 15766, 1566722156136, 16000, 234, true
7534, 1566722155903, 15767, 1566722156157, 16021, 254, true
7535, 1566722155904, 15768, 1566722156151, 16015, 247, true
7536, 1566722155904, 15768, 1566722156157, 16021, 253, true
7537, 1566722155905, 15769, 1566722156158, 16022, 253, true
7538, 1566722155906, 15770, 1566722156157, 16021, 251, true
7539, 1566722155906, 15770, 1566722156158, 16022, 252, true
7540, 1566722155910, 15774, 1566722156151, 16015, 241, true
7541, 1566722155911, 15775, 1566722156149, 16013, 238, true
7542, 1566722155912, 15776, 1566722156149, 16013, 237, true
7543, 1566722155912, 15776, 1566722156151, 16015, 239, true
7544, 1566722155913, 15777, 1566722156139, 16003, 226, true
7545, 1566722155922, 15786, 1566722156137, 16001, 215, true
7546, 1566722155934, 15798, 1566722156148, 16012, 214, true
7547, 1566722155937, 15801, 1566722156158, 16022, 221, true
7548, 1566722155937, 15801, 1566722156158, 16022, 221, true
7549, 1566722155938, 15802, 1566722156158, 16022, 220, true
7550, 1566722155938, 15802, 1566722156158, 16022, 220, true
7551, 1566722155938, 15802, 1566722156158, 16022, 220, true
7552, 1566722155939, 15803, 1566722156157, 16021, 218, true
7553, 1566722155940, 15804, 1566722156210, 16074, 270, true
7554, 1566722155940, 15804, 1566722156249, 16113, 309, true
7555, 1566722155941, 15805, 1566722156222, 16086, 281, true
7556, 1566722155942, 15806, 1566722156222, 16086, 280, true
7557, 1566722155943, 15807, 1566722156222, 16086, 279, true
7558, 1566722155943, 15807, 1566722156222, 16086, 279, true
7559, 1566722155944, 15808, 1566722156269, 16133, 325, true
7560, 1566722155944, 15808, 1566722156252, 16116, 308, true
7561, 1566722155945, 15809, 1566722156226, 16090, 281, true
7562, 1566722155945, 15809, 1566722156215, 16079, 270, true
7563, 1566722155945, 15809, 1566722156158, 16022, 213, true
7564, 1566722155945, 15809, 1566722156244, 16108, 299, true
7565, 1566722155945, 15809, 1566722156210, 16074, 265, true
7566, 1566722155947, 15811, 1566722156222, 16086, 275, true
7567, 1566722155948, 15812, 1566722156243, 16107, 295, true
7568, 1566722155949, 15813, 1566722156248, 16112, 299, true
7569, 1566722155949, 15813, 1566722156270, 16134, 321, true
7570, 1566722155951, 15815, 1566722156222, 16086, 271, true
7571, 1566722155952, 15816, 1566722156224, 16088, 272, true
7572, 1566722155953, 15817, 1566722156248, 16112, 295, true
7573, 1566722155953, 15817, 1566722156244, 16108, 291, true
7574, 1566722155954, 15818, 1566722156247, 16111, 293, true
7575, 1566722155955, 15819, 1566722156226, 16090, 271, true
7576, 1566722155955, 15819, 1566722156231, 16095, 276, true
7577, 1566722155956, 15820, 1566722156226, 16090, 270, true
7578, 1566722155957, 15821, 1566722156252, 16116, 295, true
7579, 1566722155957, 15821, 1566722156270, 16134, 313, true
7580, 1566722155958, 15822, 1566722156224, 16088, 266, true
7581, 1566722155958, 15822, 1566722156233, 16097, 275, true
7582, 1566722155959, 15823, 1566722156244, 16108, 285, true
7583, 1566722155960, 15824, 1566722156237, 16101, 277, true
7584, 1566722155960, 15824, 1566722156237, 16101, 277, true
7585, 1566722155961, 15825, 1566722156222, 16086, 261, true
7586, 1566722155961, 15825, 1566722156237, 16101, 276, true
7587, 1566722155963, 15827, 1566722156244, 16108, 281, true
7588, 1566722155964, 15828, 1566722156233, 16097, 269, true
7589, 1566722155965, 15829, 1566722156252, 16116, 287, true
7590, 1566722155965, 15829, 1566722156237, 16101, 272, true
7591, 1566722155966, 15830, 1566722156223, 16087, 257, true
7592, 1566722155966, 15830, 1566722156237, 16101, 271, true
7593, 1566722155967, 15831, 1566722156231, 16095, 264, true
7594, 1566722155967, 15831, 1566722156237, 16101, 270, true
7595, 1566722155967, 15831, 1566722156252, 16116, 285, true
7596, 1566722155967, 15831, 1566722156244, 16108, 277, true
7597, 1566722155968, 15832, 1566722156243, 16107, 275, true
7598, 1566722155968, 15832, 1566722156223, 16087, 255, true
7599, 1566722155968, 15832, 1566722156223, 16087, 255, true
7600, 1566722155969, 15833, 1566722156237, 16101, 268, true
7601, 1566722155969, 15833, 1566722156226, 16090, 257, true
7602, 1566722155969, 15833, 1566722156227, 16091, 258, true
7603, 1566722155969, 15833, 1566722156252, 16116, 283, true
7604, 1566722155970, 15834, 1566722156223, 16087, 253, true
7605, 1566722155970, 15834, 1566722156237, 16101, 267, true
7606, 1566722155970, 15834, 1566722156237, 16101, 267, true
7607, 1566722155971, 15835, 1566722156244, 16108, 273, true
7608, 1566722155971, 15835, 1566722156224, 16088, 253, true
7609, 1566722155972, 15836, 1566722156223, 16087, 251, true
7610, 1566722155972, 15836, 1566722156233, 16097, 261, true
7611, 1566722155972, 15836, 1566722156254, 16118, 282, true
7612, 1566722155973, 15837, 1566722156231, 16095, 258, true
7613, 1566722155973, 15837, 1566722156226, 16090, 253, true
7614, 1566722155973, 15837, 1566722156237, 16101, 264, true
7615, 1566722155973, 15837, 1566722156222, 16086, 249, true
7616, 1566722155974, 15838, 1566722156244, 16108, 270, true
7617, 1566722155974, 15838, 1566722156244, 16108, 270, true
7618, 1566722155974, 15838, 1566722156233, 16097, 259, true
7619, 1566722155974, 15838, 1566722156247, 16111, 273, true
7620, 1566722155975, 15839, 1566722156252, 16116, 277, true
7621, 1566722155975, 15839, 1566722156237, 16101, 262, true
7622, 1566722155975, 15839, 1566722156243, 16107, 268, true
7623, 1566722155975, 15839, 1566722156239, 16103, 264, true
7624, 1566722155976, 15840, 1566722156244, 16108, 268, true
7625, 1566722155976, 15840, 1566722156249, 16113, 273, true
7626, 1566722155976, 15840, 1566722156238, 16102, 262, true
7627, 1566722155977, 15841, 1566722156231, 16095, 254, true
7628, 1566722155977, 15841, 1566722156237, 16101, 260, true
7629, 1566722155978, 15842, 1566722156250, 16114, 272, true
7630, 1566722155978, 15842, 1566722156252, 16116, 274, true
7631, 1566722155978, 15842, 1566722156231, 16095, 253, true
7632, 1566722155979, 15843, 1566722156237, 16101, 258, true
7633, 1566722155979, 15843, 1566722156231, 16095, 252, true
7634, 1566722155979, 15843, 1566722156237, 16101, 258, true
7635, 1566722155980, 15844, 1566722156227, 16091, 247, true
7636, 1566722155980, 15844, 1566722156233, 16097, 253, true
7637, 1566722155980, 15844, 1566722156226, 16090, 246, true
7638, 1566722155980, 15844, 1566722156233, 16097, 253, true
7639, 1566722155981, 15845, 1566722156226, 16090, 245, true
7640, 1566722155981, 15845, 1566722156231, 16095, 250, true
7641, 1566722155982, 15846, 1566722156222, 16086, 240, true
7642, 1566722155982, 15846, 1566722156222, 16086, 240, true
7643, 1566722155982, 15846, 1566722156254, 16118, 272, true
7644, 1566722155982, 15846, 1566722156226, 16090, 244, true
7645, 1566722155983, 15847, 1566722156244, 16108, 261, true
7646, 1566722155983, 15847, 1566722156254, 16118, 271, true
7647, 1566722155984, 15848, 1566722156270, 16134, 286, true
7648, 1566722155984, 15848, 1566722156244, 16108, 260, true
7649, 1566722155984, 15848, 1566722156244, 16108, 260, true
7650, 1566722155984, 15848, 1566722156268, 16132, 284, true
7651, 1566722155985, 15849, 1566722156263, 16127, 278, true
7652, 1566722155985, 15849, 1566722156268, 16132, 283, true
7653, 1566722155985, 15849, 1566722156268, 16132, 283, true
7654, 1566722155985, 15849, 1566722156269, 16133, 284, true
7655, 1566722155986, 15850, 1566722156252, 16116, 266, true
7656, 1566722155986, 15850, 1566722156244, 16108, 258, true
7657, 1566722155986, 15850, 1566722156270, 16134, 284, true
7658, 1566722155987, 15851, 1566722156252, 16116, 265, true
7659, 1566722155987, 15851, 1566722156240, 16104, 253, true
7660, 1566722155987, 15851, 1566722156254, 16118, 267, true
7661, 1566722155987, 15851, 1566722156270, 16134, 283, true
7662, 1566722155988, 15852, 1566722156270, 16134, 282, true
7663, 1566722155988, 15852, 1566722156270, 16134, 282, true
7664, 1566722155988, 15852, 1566722156269, 16133, 281, true
7665, 1566722155989, 15853, 1566722156270, 16134, 281, true
7666, 1566722155989, 15853, 1566722156269, 16133, 280, true
7667, 1566722155989, 15853, 1566722156268, 16132, 279, true
7668, 1566722155989, 15853, 1566722156270, 16134, 281, true
7669, 1566722155990, 15854, 1566722156270, 16134, 280, true
7670, 1566722155990, 15854, 1566722156269, 16133, 279, true
7671, 1566722155990, 15854, 1566722156269, 16133, 279, true
7672, 1566722155990, 15854, 1566722156276, 16140, 286, true
7673, 1566722155991, 15855, 1566722156268, 16132, 277, true
7674, 1566722155991, 15855, 1566722156269, 16133, 278, true
7675, 1566722155991, 15855, 1566722156270, 16134, 279, true
7676, 1566722155991, 15855, 1566722156269, 16133, 278, true
7677, 1566722155992, 15856, 1566722156263, 16127, 271, true
7678, 1566722155992, 15856, 1566722156268, 16132, 276, true
7679, 1566722155992, 15856, 1566722156276, 16140, 284, true
7680, 1566722155992, 15856, 1566722156270, 16134, 278, true
7681, 1566722155993, 15857, 1566722156276, 16140, 283, true
7682, 1566722155993, 15857, 1566722156276, 16140, 283, true
7683, 1566722155993, 15857, 1566722156275, 16139, 282, true
7684, 1566722155994, 15858, 1566722156276, 16140, 282, true
7685, 1566722155994, 15858, 1566722156276, 16140, 282, true
7686, 1566722155994, 15858, 1566722156277, 16141, 283, true
7687, 1566722155994, 15858, 1566722156270, 16134, 276, true
7688, 1566722155995, 15859, 1566722156271, 16135, 276, true
7689, 1566722155995, 15859, 1566722156270, 16134, 275, true
7690, 1566722155995, 15859, 1566722156276, 16140, 281, true
7691, 1566722155995, 15859, 1566722156377, 16241, 382, true
7692, 1566722155996, 15860, 1566722156381, 16245, 385, true
7693, 1566722155996, 15860, 1566722156384, 16248, 388, true
7694, 1566722155996, 15860, 1566722156381, 16245, 385, true
7695, 1566722155996, 15860, 1566722156378, 16242, 382, true
7696, 1566722155996, 15860, 1566722156388, 16252, 392, true
7697, 1566722155996, 15860, 1566722156387, 16251, 391, true
7698, 1566722155997, 15861, 1566722156380, 16244, 383, true
7699, 1566722155997, 15861, 1566722156377, 16241, 380, true
7700, 1566722155997, 15861, 1566722156388, 16252, 391, true
7701, 1566722155997, 15861, 1566722156383, 16247, 386, true
7702, 1566722155997, 15861, 1566722156387, 16251, 390, true
7703, 1566722155997, 15861, 1566722156377, 16241, 380, true
7704, 1566722155998, 15862, 1566722156387, 16251, 389, true
7705, 1566722155998, 15862, 1566722156380, 16244, 382, true
7706, 1566722155998, 15862, 1566722156387, 16251, 389, true
7707, 1566722155998, 15862, 1566722156408, 16272, 410, true
7708, 1566722155998, 15862, 1566722156408, 16272, 410, true
7709, 1566722155998, 15862, 1566722156407, 16271, 409, true
7710, 1566722155999, 15863, 1566722156414, 16278, 415, true
7711, 1566722155999, 15863, 1566722156414, 16278, 415, true
7712, 1566722155999, 15863, 1566722156393, 16257, 394, true
7713, 1566722155999, 15863, 1566722156380, 16244, 381, true
7714, 1566722155999, 15863, 1566722156407, 16271, 408, true
7715, 1566722155999, 15863, 1566722156415, 16279, 416, true
7716, 1566722156000, 15864, 1566722156413, 16277, 413, true
7717, 1566722156000, 15864, 1566722156403, 16267, 403, true
7718, 1566722156000, 15864, 1566722156407, 16271, 407, true
7719, 1566722156000, 15864, 1566722156407, 16271, 407, true
7720, 1566722156000, 15864, 1566722156415, 16279, 415, true
7721, 1566722156000, 15864, 1566722156414, 16278, 414, true
7722, 1566722156000, 15864, 1566722156408, 16272, 408, true
7723, 1566722156001, 15865, 1566722156407, 16271, 406, true
7724, 1566722156001, 15865, 1566722156414, 16278, 413, true
7725, 1566722156001, 15865, 1566722156406, 16270, 405, true
7726, 1566722156001, 15865, 1566722156395, 16259, 394, true
7727, 1566722156001, 15865, 1566722156396, 16260, 395, true
7728, 1566722156001, 15865, 1566722156415, 16279, 414, true
7729, 1566722156002, 15866, 1566722156408, 16272, 406, true
7730, 1566722156002, 15866, 1566722156396, 16260, 394, true
7731, 1566722156002, 15866, 1566722156396, 16260, 394, true
7732, 1566722156002, 15866, 1566722156390, 16254, 388, true
7733, 1566722156002, 15866, 1566722156390, 16254, 388, true
7734, 1566722156002, 15866, 1566722156396, 16260, 394, true
7735, 1566722156003, 15867, 1566722156396, 16260, 393, true
7736, 1566722156003, 15867, 1566722156414, 16278, 411, true
7737, 1566722156003, 15867, 1566722156407, 16271, 404, true
7738, 1566722156003, 15867, 1566722156414, 16278, 411, true
7739, 1566722156003, 15867, 1566722156414, 16278, 411, true
7740, 1566722156003, 15867, 1566722156390, 16254, 387, true
7741, 1566722156004, 15868, 1566722156414, 16278, 410, true
7742, 1566722156004, 15868, 1566722156415, 16279, 411, true
7743, 1566722156004, 15868, 1566722156408, 16272, 404, true
7744, 1566722156004, 15868, 1566722156393, 16257, 389, true
7745, 1566722156004, 15868, 1566722156407, 16271, 403, true
7746, 1566722156004, 15868, 1566722156396, 16260, 392, true
7747, 1566722156004, 15868, 1566722156403, 16267, 399, true
7748, 1566722156005, 15869, 1566722156414, 16278, 409, true
7749, 1566722156005, 15869, 1566722156414, 16278, 409, true
7750, 1566722156005, 15869, 1566722156414, 16278, 409, true
7751, 1566722156005, 15869, 1566722156407, 16271, 402, true
7752, 1566722156005, 15869, 1566722156408, 16272, 403, true
7753, 1566722156005, 15869, 1566722156392, 16256, 387, true
7754, 1566722156006, 15870, 1566722156408, 16272, 402, true
7755, 1566722156006, 15870, 1566722156410, 16274, 404, true
7756, 1566722156006, 15870, 1566722156409, 16273, 403, true
7757, 1566722156006, 15870, 1566722156414, 16278, 408, true
7758, 1566722156018, 15882, 1566722156271, 16135, 253, true
7759, 1566722156021, 15885, 1566722156277, 16141, 256, true
7760, 1566722156022, 15886, 1566722156276, 16140, 254, true
7761, 1566722156024, 15888, 1566722156275, 16139, 251, true
7762, 1566722156026, 15890, 1566722156271, 16135, 245, true
7763, 1566722156028, 15892, 1566722156276, 16140, 248, true
7764, 1566722156031, 15895, 1566722156277, 16141, 246, true
7765, 1566722156032, 15896, 1566722156270, 16134, 238, true
7766, 1566722156033, 15897, 1566722156269, 16133, 236, true
7767, 1566722156035, 15899, 1566722156272, 16136, 237, true
7768, 1566722156036, 15900, 1566722156271, 16135, 235, true
7769, 1566722156064, 15928, 1566722156277, 16141, 213, true
7770, 1566722156065, 15929, 1566722156277, 16141, 212, true
7771, 1566722156088, 15952, 1566722156292, 16156, 204, true
7772, 1566722156090, 15954, 1566722156293, 16157, 203, true
7773, 1566722156091, 15955, 1566722156298, 16162, 207, true
7774, 1566722156092, 15956, 1566722156302, 16166, 210, true
7775, 1566722156093, 15957, 1566722156298, 16162, 205, true
7776, 1566722156094, 15958, 1566722156298, 16162, 204, true
7777, 1566722156095, 15959, 1566722156303, 16167, 208, true
7778, 1566722156097, 15961, 1566722156303, 16167, 206, true
7779, 1566722156099, 15963, 1566722156303, 16167, 204, true
7780, 1566722156101, 15965, 1566722156304, 16168, 203, true
7781, 1566722156102, 15966, 1566722156306, 16170, 204, true
7782, 1566722156104, 15968, 1566722156307, 16171, 203, true
7783, 1566722156106, 15970, 1566722156308, 16172, 202, true
7784, 1566722156107, 15971, 1566722156312, 16176, 205, true
7785, 1566722156109, 15973, 1566722156315, 16179, 206, true
7786, 1566722156111, 15975, 1566722156329, 16193, 218, true
7787, 1566722156113, 15977, 1566722156329, 16193, 216, true
7788, 1566722156114, 15978, 1566722156332, 16196, 218, true
7789, 1566722156167, 16031, 1566722156386, 16250, 219, true
7790, 1566722156167, 16031, 1566722156384, 16248, 217, true
7791, 1566722156168, 16032, 1566722156379, 16243, 211, true
7792, 1566722156168, 16032, 1566722156384, 16248, 216, true
7793, 1566722156172, 16036, 1566722156390, 16254, 218, true
7794, 1566722156185, 16049, 1566722156413, 16277, 228, true
7795, 1566722156186, 16050, 1566722156413, 16277, 227, true
7796, 1566722156186, 16050, 1566722156409, 16273, 223, true
7797, 1566722156198, 16062, 1566722156410, 16274, 212, true
7798, 1566722156200, 16064, 1566722156413, 16277, 213, true
7799, 1566722156201, 16065, 1566722156410, 16274, 209, true
7800, 1566722156202, 16066, 1566722156413, 16277, 211, true
7801, 1566722156207, 16071, 1566722156413, 16277, 206, true
7802, 1566722156209, 16073, 1566722156416, 16280, 207, true
7803, 1566722156211, 16075, 1566722156416, 16280, 205, true
7804, 1566722156211, 16075, 1566722156416, 16280, 205, true
7805, 1566722156213, 16077, 1566722156418, 16282, 205, true
7806, 1566722156213, 16077, 1566722156423, 16287, 210, true
7807, 1566722156213, 16077, 1566722156434, 16298, 221, true
7808, 1566722156214, 16078, 1566722156423, 16287, 209, true
7809, 1566722156215, 16079, 1566722156431, 16295, 216, true
7810, 1566722156215, 16079, 1566722156511, 16375, 296, true
7811, 1566722156216, 16080, 1566722156518, 16382, 302, true
7812, 1566722156257, 16121, 1566722156532, 16396, 275, true
7813, 1566722156257, 16121, 1566722156517, 16381, 260, true
7814, 1566722156258, 16122, 1566722156532, 16396, 274, true
7815, 1566722156258, 16122, 1566722156512, 16376, 254, true
7816, 1566722156258, 16122, 1566722156518, 16382, 260, true
7817, 1566722156258, 16122, 1566722156533, 16397, 275, true
7818, 1566722156269, 16133, 1566722156510, 16374, 241, true
7819, 1566722156282, 16146, 1566722156536, 16400, 254, true
7820, 1566722156282, 16146, 1566722156533, 16397, 251, true
7821, 1566722156283, 16147, 1566722156533, 16397, 250, true
7822, 1566722156283, 16147, 1566722156536, 16400, 253, true
7823, 1566722156283, 16147, 1566722156533, 16397, 250, true
7824, 1566722156284, 16148, 1566722156536, 16400, 252, true
7825, 1566722156284, 16148, 1566722156533, 16397, 249, true
7826, 1566722156285, 16149, 1566722156533, 16397, 248, true
7827, 1566722156286, 16150, 1566722156533, 16397, 247, true
7828, 1566722156286, 16150, 1566722156532, 16396, 246, true
7829, 1566722156287, 16151, 1566722156533, 16397, 246, true
7830, 1566722156287, 16151, 1566722156533, 16397, 246, true
7831, 1566722156287, 16151, 1566722156533, 16397, 246, true
7832, 1566722156288, 16152, 1566722156533, 16397, 245, true
7833, 1566722156295, 16159, 1566722156532, 16396, 237, true
7834, 1566722156310, 16174, 1566722156532, 16396, 222, true
7835, 1566722156317, 16181, 1566722156533, 16397, 216, true
7836, 1566722156318, 16182, 1566722156533, 16397, 215, true
7837, 1566722156318, 16182, 1566722156532, 16396, 214, true
7838, 1566722156318, 16182, 1566722156536, 16400, 218, true
7839, 1566722156324, 16188, 1566722156533, 16397, 209, true
7840, 1566722156326, 16190, 1566722156533, 16397, 207, true
7841, 1566722156328, 16192, 1566722156537, 16401, 209, true
7842, 1566722156330, 16194, 1566722156536, 16400, 206, true
7843, 1566722156330, 16194, 1566722156536, 16400, 206, true
7844, 1566722156334, 16198, 1566722156537, 16401, 203, true
7845, 1566722156335, 16199, 1566722156539, 16403, 204, true
7846, 1566722156336, 16200, 1566722156540, 16404, 204, true
7847, 1566722156336, 16200, 1566722156541, 16405, 205, true
7848, 1566722156337, 16201, 1566722156543, 16407, 206, true
7849, 1566722156338, 16202, 1566722156541, 16405, 203, true
7850, 1566722156339, 16203, 1566722156543, 16407, 204, true
7851, 1566722156340, 16204, 1566722156546, 16410, 206, true
7852, 1566722156340, 16204, 1566722156544, 16408, 204, true
7853, 1566722156341, 16205, 1566722156546, 16410, 205, true
7854, 1566722156342, 16206, 1566722156549, 16413, 207, true
7855, 1566722156343, 16207, 1566722156549, 16413, 206, true
7856, 1566722156345, 16209, 1566722156553, 16417, 208, true
7857, 1566722156345, 16209, 1566722156549, 16413, 204, true
7858, 1566722156345, 16209, 1566722156549, 16413, 204, true
7859, 1566722156346, 16210, 1566722156553, 16417, 207, true
7860, 1566722156346, 16210, 1566722156553, 16417, 207, true
7861, 1566722156347, 16211, 1566722156554, 16418, 207, true
7862, 1566722156348, 16212, 1566722156554, 16418, 206, true
7863, 1566722156348, 16212, 1566722156559, 16423, 211, true
7864, 1566722156349, 16213, 1566722156559, 16423, 210, true
7865, 1566722156350, 16214, 1566722156559, 16423, 209, true
7866, 1566722156351, 16215, 1566722156558, 16422, 207, true
7867, 1566722156351, 16215, 1566722156560, 16424, 209, true
7868, 1566722156352, 16216, 1566722156559, 16423, 207, true
7869, 1566722156353, 16217, 1566722156560, 16424, 207, true
7870, 1566722156353, 16217, 1566722156560, 16424, 207, true
7871, 1566722156353, 16217, 1566722156565, 16429, 212, true
7872, 1566722156355, 16219, 1566722156575, 16439, 220, true
7873, 1566722156355, 16219, 1566722156575, 16439, 220, true
7874, 1566722156356, 16220, 1566722156565, 16429, 209, true
7875, 1566722156357, 16221, 1566722156575, 16439, 218, true
7876, 1566722156358, 16222, 1566722156575, 16439, 217, true
7877, 1566722156358, 16222, 1566722156575, 16439, 217, true
7878, 1566722156359, 16223, 1566722156575, 16439, 216, true
7879, 1566722156359, 16223, 1566722156566, 16430, 207, true
7880, 1566722156360, 16224, 1566722156575, 16439, 215, true
7881, 1566722156360, 16224, 1566722156575, 16439, 215, true
7882, 1566722156360, 16224, 1566722156575, 16439, 215, true
7883, 1566722156361, 16225, 1566722156575, 16439, 214, true
7884, 1566722156361, 16225, 1566722156575, 16439, 214, true
7885, 1566722156362, 16226, 1566722156575, 16439, 213, true
7886, 1566722156362, 16226, 1566722156575, 16439, 213, true
7887, 1566722156365, 16229, 1566722156574, 16438, 209, true
7888, 1566722156368, 16232, 1566722156579, 16443, 211, true
7889, 1566722156368, 16232, 1566722156578, 16442, 210, true
7890, 1566722156369, 16233, 1566722156579, 16443, 210, true
7891, 1566722156370, 16234, 1566722156579, 16443, 209, true
7892, 1566722156370, 16234, 1566722156574, 16438, 204, true
7893, 1566722156371, 16235, 1566722156577, 16441, 206, true
7894, 1566722156372, 16236, 1566722156579, 16443, 207, true
7895, 1566722156373, 16237, 1566722156579, 16443, 206, true
7896, 1566722156374, 16238, 1566722156579, 16443, 205, true
7897, 1566722156375, 16239, 1566722156584, 16448, 209, true
7898, 1566722156380, 16244, 1566722156588, 16452, 208, true
7899, 1566722156383, 16247, 1566722156591, 16455, 208, true
7900, 1566722156391, 16255, 1566722156623, 16487, 232, true
7901, 1566722156419, 16283, 1566722156640, 16504, 221, true
7902, 1566722156419, 16283, 1566722156640, 16504, 221, true
7903, 1566722156420, 16284, 1566722156640, 16504, 220, true
7904, 1566722156420, 16284, 1566722156640, 16504, 220, true
7905, 1566722156421, 16285, 1566722156640, 16504, 219, true
7906, 1566722156421, 16285, 1566722156640, 16504, 219, true
7907, 1566722156424, 16288, 1566722156640, 16504, 216, true
7908, 1566722156425, 16289, 1566722156639, 16503, 214, true
7909, 1566722156438, 16302, 1566722156642, 16506, 204, true
7910, 1566722156440, 16304, 1566722156644, 16508, 204, true
7911, 1566722156441, 16305, 1566722156644, 16508, 203, true
7912, 1566722156443, 16307, 1566722156651, 16515, 208, true
7913, 1566722156443, 16307, 1566722156651, 16515, 208, true
7914, 1566722156444, 16308, 1566722156657, 16521, 213, true
7915, 1566722156446, 16310, 1566722156652, 16516, 206, true
7916, 1566722156446, 16310, 1566722156651, 16515, 205, true
7917, 1566722156447, 16311, 1566722156656, 16520, 209, true
7918, 1566722156448, 16312, 1566722156674, 16538, 226, true
7919, 1566722156448, 16312, 1566722156668, 16532, 220, true
7920, 1566722156449, 16313, 1566722156665, 16529, 216, true
7921, 1566722156450, 16314, 1566722156664, 16528, 214, true
7922, 1566722156451, 16315, 1566722156665, 16529, 214, true
7923, 1566722156451, 16315, 1566722156668, 16532, 217, true
7924, 1566722156451, 16315, 1566722156664, 16528, 213, true
7925, 1566722156452, 16316, 1566722156665, 16529, 213, true
7926, 1566722156453, 16317, 1566722156660, 16524, 207, true
7927, 1566722156457, 16321, 1566722156668, 16532, 211, true
7928, 1566722156458, 16322, 1566722156676, 16540, 218, true
7929, 1566722156458, 16322, 1566722156674, 16538, 216, true
7930, 1566722156459, 16323, 1566722156674, 16538, 215, true
7931, 1566722156460, 16324, 1566722156676, 16540, 216, true
7932, 1566722156460, 16324, 1566722156676, 16540, 216, true
7933, 1566722156460, 16324, 1566722156675, 16539, 215, true
7934, 1566722156461, 16325, 1566722156674, 16538, 213, true
7935, 1566722156461, 16325, 1566722156674, 16538, 213, true
7936, 1566722156461, 16325, 1566722156674, 16538, 213, true
7937, 1566722156462, 16326, 1566722156673, 16537, 211, true
7938, 1566722156463, 16327, 1566722156673, 16537, 210, true
7939, 1566722156464, 16328, 1566722156676, 16540, 212, true
7940, 1566722156468, 16332, 1566722156732, 16596, 264, true
7941, 1566722156469, 16333, 1566722156682, 16546, 213, true
7942, 1566722156470, 16334, 1566722156742, 16606, 272, true
7943, 1566722156471, 16335, 1566722156793, 16657, 322, true
7944, 1566722156471, 16335, 1566722156793, 16657, 322, true
7945, 1566722156472, 16336, 1566722156813, 16677, 341, true
7946, 1566722156472, 16336, 1566722156793, 16657, 321, true
7947, 1566722156473, 16337, 1566722156797, 16661, 324, true
7948, 1566722156473, 16337, 1566722156782, 16646, 309, true
7949, 1566722156473, 16337, 1566722156811, 16675, 338, true
7950, 1566722156474, 16338, 1566722156797, 16661, 323, true
7951, 1566722156474, 16338, 1566722156792, 16656, 318, true
7952, 1566722156474, 16338, 1566722156789, 16653, 315, true
7953, 1566722156475, 16339, 1566722156754, 16618, 279, true
7954, 1566722156475, 16339, 1566722156794, 16658, 319, true
7955, 1566722156476, 16340, 1566722156773, 16637, 297, true
7956, 1566722156476, 16340, 1566722156753, 16617, 277, true
7957, 1566722156477, 16341, 1566722156769, 16633, 292, true
7958, 1566722156477, 16341, 1566722156811, 16675, 334, true
7959, 1566722156477, 16341, 1566722156761, 16625, 284, true
7960, 1566722156478, 16342, 1566722156768, 16632, 290, true
7961, 1566722156478, 16342, 1566722156793, 16657, 315, true
7962, 1566722156478, 16342, 1566722156789, 16653, 311, true
7963, 1566722156478, 16342, 1566722156768, 16632, 290, true
7964, 1566722156479, 16343, 1566722156805, 16669, 326, true
7965, 1566722156479, 16343, 1566722156789, 16653, 310, true
7966, 1566722156479, 16343, 1566722156812, 16676, 333, true
7967, 1566722156479, 16343, 1566722156769, 16633, 290, true
7968, 1566722156480, 16344, 1566722156794, 16658, 314, true
7969, 1566722156480, 16344, 1566722156782, 16646, 302, true
7970, 1566722156480, 16344, 1566722156782, 16646, 302, true
7971, 1566722156481, 16345, 1566722156813, 16677, 332, true
7972, 1566722156481, 16345, 1566722156810, 16674, 329, true
7973, 1566722156481, 16345, 1566722156768, 16632, 287, true
7974, 1566722156481, 16345, 1566722156812, 16676, 331, true
7975, 1566722156482, 16346, 1566722156770, 16634, 288, true
7976, 1566722156482, 16346, 1566722156812, 16676, 330, true
7977, 1566722156482, 16346, 1566722156769, 16633, 287, true
7978, 1566722156482, 16346, 1566722156786, 16650, 304, true
7979, 1566722156483, 16347, 1566722156787, 16651, 304, true
7980, 1566722156483, 16347, 1566722156779, 16643, 296, true
7981, 1566722156483, 16347, 1566722156779, 16643, 296, true
7982, 1566722156484, 16348, 1566722156794, 16658, 310, true
7983, 1566722156484, 16348, 1566722156812, 16676, 328, true
7984, 1566722156484, 16348, 1566722156782, 16646, 298, true
7985, 1566722156484, 16348, 1566722156811, 16675, 327, true
7986, 1566722156485, 16349, 1566722156782, 16646, 297, true
7987, 1566722156485, 16349, 1566722156823, 16687, 338, true
7988, 1566722156485, 16349, 1566722156813, 16677, 328, true
7989, 1566722156485, 16349, 1566722156794, 16658, 309, true
7990, 1566722156486, 16350, 1566722156824, 16688, 338, true
7991, 1566722156486, 16350, 1566722156811, 16675, 325, true
7992, 1566722156486, 16350, 1566722156811, 16675, 325, true
7993, 1566722156487, 16351, 1566722156812, 16676, 325, true
7994, 1566722156487, 16351, 1566722156813, 16677, 326, true
7995, 1566722156488, 16352, 1566722156782, 16646, 294, true
7996, 1566722156488, 16352, 1566722156811, 16675, 323, true
7997, 1566722156488, 16352, 1566722156782, 16646, 294, true
7998, 1566722156488, 16352, 1566722156823, 16687, 335, true
7999, 1566722156489, 16353, 1566722156810, 16674, 321, true
8000, 1566722156489, 16353, 1566722156786, 16650, 297, true
8001, 1566722156489, 16353, 1566722156793, 16657, 304, true
8002, 1566722156489, 16353, 1566722156813, 16677, 324, true
8003, 1566722156490, 16354, 1566722156823, 16687, 333, true
8004, 1566722156490, 16354, 1566722156760, 16624, 270, true
8005, 1566722156491, 16355, 1566722156793, 16657, 302, true
8006, 1566722156491, 16355, 1566722156797, 16661, 306, true
8007, 1566722156491, 16355, 1566722156794, 16658, 303, true
8008, 1566722156491, 16355, 1566722156769, 16633, 278, true
8009, 1566722156492, 16356, 1566722156817, 16681, 325, true
8010, 1566722156492, 16356, 1566722156761, 16625, 269, true
8011, 1566722156492, 16356, 1566722156813, 16677, 321, true
8012, 1566722156492, 16356, 1566722156810, 16674, 318, true
8013, 1566722156493, 16357, 1566722156800, 16664, 307, true
8014, 1566722156493, 16357, 1566722156787, 16651, 294, true
8015, 1566722156493, 16357, 1566722156800, 16664, 307, true
8016, 1566722156493, 16357, 1566722156768, 16632, 275, true
8017, 1566722156494, 16358, 1566722156813, 16677, 319, true
8018, 1566722156494, 16358, 1566722156815, 16679, 321, true
8019, 1566722156494, 16358, 1566722156812, 16676, 318, true
8020, 1566722156494, 16358, 1566722156812, 16676, 318, true
8021, 1566722156495, 16359, 1566722156812, 16676, 317, true
8022, 1566722156495, 16359, 1566722156761, 16625, 266, true
8023, 1566722156496, 16360, 1566722156782, 16646, 286, true
8024, 1566722156496, 16360, 1566722156814, 16678, 318, true
8025, 1566722156496, 16360, 1566722156811, 16675, 315, true
8026, 1566722156497, 16361, 1566722156769, 16633, 272, true
8027, 1566722156497, 16361, 1566722156817, 16681, 320, true
8028, 1566722156497, 16361, 1566722156800, 16664, 303, true
8029, 1566722156498, 16362, 1566722156768, 16632, 270, true
8030, 1566722156498, 16362, 1566722156817, 16681, 319, true
8031, 1566722156498, 16362, 1566722156814, 16678, 316, true
8032, 1566722156498, 16362, 1566722156800, 16664, 302, true
8033, 1566722156499, 16363, 1566722156823, 16687, 324, true
8034, 1566722156499, 16363, 1566722156813, 16677, 314, true
8035, 1566722156499, 16363, 1566722156789, 16653, 290, true
8036, 1566722156499, 16363, 1566722156794, 16658, 295, true
8037, 1566722156500, 16364, 1566722156801, 16665, 301, true
8038, 1566722156500, 16364, 1566722156789, 16653, 289, true
8039, 1566722156500, 16364, 1566722156823, 16687, 323, true
8040, 1566722156500, 16364, 1566722156797, 16661, 297, true
8041, 1566722156501, 16365, 1566722156797, 16661, 296, true
8042, 1566722156501, 16365, 1566722156804, 16668, 303, true
8043, 1566722156501, 16365, 1566722156793, 16657, 292, true
8044, 1566722156502, 16366, 1566722156768, 16632, 266, true
8045, 1566722156502, 16366, 1566722156823, 16687, 321, true
8046, 1566722156503, 16367, 1566722156770, 16634, 267, true
8047, 1566722156503, 16367, 1566722156824, 16688, 321, true
8048, 1566722156503, 16367, 1566722156813, 16677, 310, true
8049, 1566722156503, 16367, 1566722156800, 16664, 297, true
8050, 1566722156504, 16368, 1566722156840, 16704, 336, true
8051, 1566722156504, 16368, 1566722156841, 16705, 337, true
8052, 1566722156504, 16368, 1566722156841, 16705, 337, true
8053, 1566722156504, 16368, 1566722156841, 16705, 337, true
8054, 1566722156504, 16368, 1566722156840, 16704, 336, true
8055, 1566722156505, 16369, 1566722156828, 16692, 323, true
8056, 1566722156505, 16369, 1566722156841, 16705, 336, true
8057, 1566722156505, 16369, 1566722156841, 16705, 336, true
8058, 1566722156505, 16369, 1566722156841, 16705, 336, true
8059, 1566722156505, 16369, 1566722156839, 16703, 334, true
8060, 1566722156505, 16369, 1566722156840, 16704, 335, true
8061, 1566722156505, 16369, 1566722156840, 16704, 335, true
8062, 1566722156506, 16370, 1566722156831, 16695, 325, true
8063, 1566722156506, 16370, 1566722156845, 16709, 339, true
8064, 1566722156506, 16370, 1566722156843, 16707, 337, true
8065, 1566722156506, 16370, 1566722156843, 16707, 337, true
8066, 1566722156506, 16370, 1566722156841, 16705, 335, true
8067, 1566722156506, 16370, 1566722156841, 16705, 335, true
8068, 1566722156507, 16371, 1566722156841, 16705, 334, true
8069, 1566722156507, 16371, 1566722156844, 16708, 337, true
8070, 1566722156507, 16371, 1566722156845, 16709, 338, true
8071, 1566722156507, 16371, 1566722156842, 16706, 335, true
8072, 1566722156507, 16371, 1566722156842, 16706, 335, true
8073, 1566722156507, 16371, 1566722156842, 16706, 335, true
8074, 1566722156508, 16372, 1566722156845, 16709, 337, true
8075, 1566722156508, 16372, 1566722156849, 16713, 341, true
8076, 1566722156508, 16372, 1566722156849, 16713, 341, true
8077, 1566722156508, 16372, 1566722156845, 16709, 337, true
8078, 1566722156508, 16372, 1566722156842, 16706, 334, true
8079, 1566722156508, 16372, 1566722156845, 16709, 337, true
8080, 1566722156509, 16373, 1566722156842, 16706, 333, true
8081, 1566722156509, 16373, 1566722156849, 16713, 340, true
8082, 1566722156509, 16373, 1566722156849, 16713, 340, true
8083, 1566722156510, 16374, 1566722156781, 16645, 271, true
8084, 1566722156511, 16375, 1566722156845, 16709, 334, true
8085, 1566722156511, 16375, 1566722156789, 16653, 278, true
8086, 1566722156512, 16376, 1566722156793, 16657, 281, true
8087, 1566722156512, 16376, 1566722156814, 16678, 302, true
8088, 1566722156512, 16376, 1566722156789, 16653, 277, true
8089, 1566722156512, 16376, 1566722156849, 16713, 337, true
8090, 1566722156513, 16377, 1566722156849, 16713, 336, true
8091, 1566722156513, 16377, 1566722156849, 16713, 336, true
8092, 1566722156513, 16377, 1566722156851, 16715, 338, true
8093, 1566722156513, 16377, 1566722156853, 16717, 340, true
8094, 1566722156514, 16378, 1566722156850, 16714, 336, true
8095, 1566722156514, 16378, 1566722156810, 16674, 296, true
8096, 1566722156514, 16378, 1566722156823, 16687, 309, true
8097, 1566722156515, 16379, 1566722156748, 16612, 233, true
8098, 1566722156515, 16379, 1566722156797, 16661, 282, true
8099, 1566722156515, 16379, 1566722156796, 16660, 281, true
8100, 1566722156518, 16382, 1566722156814, 16678, 296, true
8101, 1566722156519, 16383, 1566722156823, 16687, 304, true
8102, 1566722156519, 16383, 1566722156801, 16665, 282, true
8103, 1566722156519, 16383, 1566722156805, 16669, 286, true
8104, 1566722156520, 16384, 1566722156813, 16677, 293, true
8105, 1566722156521, 16385, 1566722156794, 16658, 273, true
8106, 1566722156521, 16385, 1566722156769, 16633, 248, true
8107, 1566722156521, 16385, 1566722156800, 16664, 279, true
8108, 1566722156522, 16386, 1566722156812, 16676, 290, true
8109, 1566722156522, 16386, 1566722156811, 16675, 289, true
8110, 1566722156522, 16386, 1566722156817, 16681, 295, true
8111, 1566722156523, 16387, 1566722156823, 16687, 300, true
8112, 1566722156524, 16388, 1566722156817, 16681, 293, true
8113, 1566722156525, 16389, 1566722156817, 16681, 292, true
8114, 1566722156525, 16389, 1566722156822, 16686, 297, true
8115, 1566722156525, 16389, 1566722156817, 16681, 292, true
8116, 1566722156526, 16390, 1566722156817, 16681, 291, true
8117, 1566722156526, 16390, 1566722156822, 16686, 296, true
8118, 1566722156526, 16390, 1566722156824, 16688, 298, true
8119, 1566722156527, 16391, 1566722156824, 16688, 297, true
8120, 1566722156616, 16480, 1566722156824, 16688, 208, true
8121, 1566722156618, 16482, 1566722156824, 16688, 206, true
8122, 1566722156619, 16483, 1566722156824, 16688, 205, true
8123, 1566722156620, 16484, 1566722156824, 16688, 204, true
8124, 1566722156653, 16517, 1566722156856, 16720, 203, true
8125, 1566722156655, 16519, 1566722156858, 16722, 203, true
8126, 1566722156657, 16521, 1566722156865, 16729, 208, true
8127, 1566722156658, 16522, 1566722156869, 16733, 211, true
8128, 1566722156660, 16524, 1566722156864, 16728, 204, true
8129, 1566722156665, 16529, 1566722156882, 16746, 217, true
8130, 1566722156666, 16530, 1566722156886, 16750, 220, true
8131, 1566722156666, 16530, 1566722156884, 16748, 218, true
8132, 1566722156668, 16532, 1566722156903, 16767, 235, true
8133, 1566722156669, 16533, 1566722156882, 16746, 213, true
8134, 1566722156669, 16533, 1566722156873, 16737, 204, true
8135, 1566722156669, 16533, 1566722156885, 16749, 216, true
8136, 1566722156670, 16534, 1566722156925, 16789, 255, true
8137, 1566722156670, 16534, 1566722156924, 16788, 254, true
8138, 1566722156678, 16542, 1566722156896, 16760, 218, true
8139, 1566722156679, 16543, 1566722156903, 16767, 224, true
8140, 1566722156679, 16543, 1566722156898, 16762, 219, true
8141, 1566722156680, 16544, 1566722156903, 16767, 223, true
8142, 1566722156680, 16544, 1566722156924, 16788, 244, true
8143, 1566722156681, 16545, 1566722156924, 16788, 243, true
8144, 1566722156684, 16548, 1566722156953, 16817, 269, true
8145, 1566722156684, 16548, 1566722156955, 16819, 271, true
8146, 1566722156686, 16550, 1566722156961, 16825, 275, true
8147, 1566722156687, 16551, 1566722156961, 16825, 274, true
8148, 1566722156687, 16551, 1566722156938, 16802, 251, true
8149, 1566722156688, 16552, 1566722156957, 16821, 269, true
8150, 1566722156688, 16552, 1566722156930, 16794, 242, true
8151, 1566722156689, 16553, 1566722156953, 16817, 264, true
8152, 1566722156690, 16554, 1566722156956, 16820, 266, true
8153, 1566722156692, 16556, 1566722156950, 16814, 258, true
8154, 1566722156693, 16557, 1566722156945, 16809, 252, true
8155, 1566722156694, 16558, 1566722156938, 16802, 244, true
8156, 1566722156696, 16560, 1566722156951, 16815, 255, true
8157, 1566722156698, 16562, 1566722156953, 16817, 255, true
8158, 1566722156700, 16564, 1566722156956, 16820, 256, true
8159, 1566722156701, 16565, 1566722156935, 16799, 234, true
8160, 1566722156702, 16566, 1566722156925, 16789, 223, true
8161, 1566722156703, 16567, 1566722156947, 16811, 244, true
8162, 1566722156704, 16568, 1566722156957, 16821, 253, true
8163, 1566722156704, 16568, 1566722156932, 16796, 228, true
8164, 1566722156705, 16569, 1566722156950, 16814, 245, true
8165, 1566722156706, 16570, 1566722156956, 16820, 250, true
8166, 1566722156707, 16571, 1566722156956, 16820, 249, true
8167, 1566722156707, 16571, 1566722156928, 16792, 221, true
8168, 1566722156708, 16572, 1566722156957, 16821, 249, true
8169, 1566722156709, 16573, 1566722156955, 16819, 246, true
8170, 1566722156710, 16574, 1566722156961, 16825, 251, true
8171, 1566722156711, 16575, 1566722156957, 16821, 246, true
8172, 1566722156714, 16578, 1566722156940, 16804, 226, true
8173, 1566722156714, 16578, 1566722156930, 16794, 216, true
8174, 1566722156715, 16579, 1566722156951, 16815, 236, true
8175, 1566722156715, 16579, 1566722156956, 16820, 241, true
8176, 1566722156716, 16580, 1566722156955, 16819, 239, true
8177, 1566722156717, 16581, 1566722156946, 16810, 229, true
8178, 1566722156717, 16581, 1566722156950, 16814, 233, true
8179, 1566722156718, 16582, 1566722156961, 16825, 243, true
8180, 1566722156718, 16582, 1566722156938, 16802, 220, true
8181, 1566722156719, 16583, 1566722156947, 16811, 228, true
8182, 1566722156719, 16583, 1566722156953, 16817, 234, true
8183, 1566722156720, 16584, 1566722156993, 16857, 273, true
8184, 1566722156720, 16584, 1566722156971, 16835, 251, true
8185, 1566722156720, 16584, 1566722156977, 16841, 257, true
8186, 1566722156721, 16585, 1566722157029, 16893, 308, true
8187, 1566722156721, 16585, 1566722156981, 16845, 260, true
8188, 1566722156722, 16586, 1566722157029, 16893, 307, true
8189, 1566722156723, 16587, 1566722156992, 16856, 269, true
8190, 1566722156723, 16587, 1566722157031, 16895, 308, true
8191, 1566722156723, 16587, 1566722157029, 16893, 306, true
8192, 1566722156724, 16588, 1566722157036, 16900, 312, true
8193, 1566722156725, 16589, 1566722156992, 16856, 267, true
8194, 1566722156726, 16590, 1566722156981, 16845, 255, true
8195, 1566722156727, 16591, 1566722157032, 16896, 305, true
8196, 1566722156728, 16592, 1566722156989, 16853, 261, true
8197, 1566722156729, 16593, 1566722157030, 16894, 301, true
8198, 1566722156730, 16594, 1566722157028, 16892, 298, true
8199, 1566722156733, 16597, 1566722157037, 16901, 304, true
8200, 1566722156734, 16598, 1566722157036, 16900, 302, true
8201, 1566722156735, 16599, 1566722156981, 16845, 246, true
8202, 1566722156736, 16600, 1566722156990, 16854, 254, true
8203, 1566722156737, 16601, 1566722156993, 16857, 256, true
8204, 1566722156739, 16603, 1566722157004, 16868, 265, true
8205, 1566722156740, 16604, 1566722156981, 16845, 241, true
8206, 1566722156741, 16605, 1566722156991, 16855, 250, true
8207, 1566722156742, 16606, 1566722157032, 16896, 290, true
8208, 1566722156744, 16608, 1566722157028, 16892, 284, true
8209, 1566722156744, 16608, 1566722156992, 16856, 248, true
8210, 1566722156745, 16609, 1566722156992, 16856, 247, true
8211, 1566722156745, 16609, 1566722157036, 16900, 291, true
8212, 1566722156757, 16621, 1566722156975, 16839, 218, true
8213, 1566722156757, 16621, 1566722156981, 16845, 224, true
8214, 1566722156760, 16624, 1566722156975, 16839, 215, true
8215, 1566722156761, 16625, 1566722157037, 16901, 276, true
8216, 1566722156762, 16626, 1566722157040, 16904, 278, true
8217, 1566722156762, 16626, 1566722157048, 16912, 286, true
8218, 1566722156762, 16626, 1566722157037, 16901, 275, true
8219, 1566722156762, 16626, 1566722157048, 16912, 286, true
8220, 1566722156763, 16627, 1566722157039, 16903, 276, true
8221, 1566722156763, 16627, 1566722157039, 16903, 276, true
8222, 1566722156770, 16634, 1566722157044, 16908, 274, true
8223, 1566722156771, 16635, 1566722157044, 16908, 273, true
8224, 1566722156771, 16635, 1566722157037, 16901, 266, true
8225, 1566722156772, 16636, 1566722157038, 16902, 266, true
8226, 1566722156774, 16638, 1566722157048, 16912, 274, true
8227, 1566722156774, 16638, 1566722157049, 16913, 275, true
8228, 1566722156775, 16639, 1566722157051, 16915, 276, true
8229, 1566722156775, 16639, 1566722157058, 16922, 283, true
8230, 1566722156776, 16640, 1566722157037, 16901, 261, true
8231, 1566722156777, 16641, 1566722157043, 16907, 266, true
8232, 1566722156879, 16743, 1566722157084, 16948, 205, true
8233, 1566722156880, 16744, 1566722157084, 16948, 204, true
8234, 1566722156883, 16747, 1566722157089, 16953, 206, true
8235, 1566722156887, 16751, 1566722157091, 16955, 204, true
8236, 1566722156888, 16752, 1566722157091, 16955, 203, true
8237, 1566722156889, 16753, 1566722157093, 16957, 204, true
8238, 1566722156890, 16754, 1566722157093, 16957, 203, true
8239, 1566722156891, 16755, 1566722157094, 16958, 203, true
8240, 1566722156892, 16756, 1566722157098, 16962, 206, true
8241, 1566722156893, 16757, 1566722157098, 16962, 205, true
8242, 1566722156894, 16758, 1566722157098, 16962, 204, true
8243, 1566722156896, 16760, 1566722157099, 16963, 203, true
8244, 1566722156898, 16762, 1566722157101, 16965, 203, true
8245, 1566722156899, 16763, 1566722157102, 16966, 203, true
8246, 1566722156901, 16765, 1566722157104, 16968, 203, true
8247, 1566722156903, 16767, 1566722157106, 16970, 203, true
8248, 1566722156905, 16769, 1566722157107, 16971, 202, true
8249, 1566722156906, 16770, 1566722157109, 16973, 203, true
8250, 1566722156907, 16771, 1566722157110, 16974, 203, true
8251, 1566722156909, 16773, 1566722157111, 16975, 202, true
8252, 1566722156910, 16774, 1566722157116, 16980, 206, true
8253, 1566722156911, 16775, 1566722157119, 16983, 208, true
8254, 1566722156913, 16777, 1566722157116, 16980, 203, true
8255, 1566722156914, 16778, 1566722157121, 16985, 207, true
8256, 1566722156914, 16778, 1566722157120, 16984, 206, true
8257, 1566722156914, 16778, 1566722157119, 16983, 205, true
8258, 1566722156915, 16779, 1566722157128, 16992, 213, true
8259, 1566722156915, 16779, 1566722157133, 16997, 218, true
8260, 1566722156916, 16780, 1566722157135, 16999, 219, true
8261, 1566722156917, 16781, 1566722157128, 16992, 211, true
8262, 1566722156917, 16781, 1566722157131, 16995, 214, true
8263, 1566722156917, 16781, 1566722157133, 16997, 216, true
8264, 1566722156918, 16782, 1566722157125, 16989, 207, true
8265, 1566722156918, 16782, 1566722157122, 16986, 204, true
8266, 1566722156918, 16782, 1566722157130, 16994, 212, true
8267, 1566722156919, 16783, 1566722157135, 16999, 216, true
8268, 1566722156920, 16784, 1566722157135, 16999, 215, true
8269, 1566722156920, 16784, 1566722157136, 17000, 216, true
8270, 1566722156921, 16785, 1566722157135, 16999, 214, true
8271, 1566722156922, 16786, 1566722157135, 16999, 213, true
8272, 1566722156926, 16790, 1566722157135, 16999, 209, true
8273, 1566722156926, 16790, 1566722157137, 17001, 211, true
8274, 1566722156939, 16803, 1566722157153, 17017, 214, true
8275, 1566722156939, 16803, 1566722157153, 17017, 214, true
8276, 1566722156939, 16803, 1566722157153, 17017, 214, true
8277, 1566722156940, 16804, 1566722157152, 17016, 212, true
8278, 1566722156940, 16804, 1566722157153, 17017, 213, true
8279, 1566722156941, 16805, 1566722157153, 17017, 212, true
8280, 1566722156941, 16805, 1566722157164, 17028, 223, true
8281, 1566722156942, 16806, 1566722157169, 17033, 227, true
8282, 1566722156943, 16807, 1566722157153, 17017, 210, true
8283, 1566722156947, 16811, 1566722157166, 17030, 219, true
8284, 1566722156958, 16822, 1566722157185, 17049, 227, true
8285, 1566722156959, 16823, 1566722157185, 17049, 226, true
8286, 1566722156959, 16823, 1566722157178, 17042, 219, true
8287, 1566722156961, 16825, 1566722157186, 17050, 225, true
8288, 1566722156962, 16826, 1566722157199, 17063, 237, true
8289, 1566722156962, 16826, 1566722157197, 17061, 235, true
8290, 1566722156963, 16827, 1566722157206, 17070, 243, true
8291, 1566722156963, 16827, 1566722157199, 17063, 236, true
8292, 1566722156963, 16827, 1566722157193, 17057, 230, true
8293, 1566722156964, 16828, 1566722157198, 17062, 234, true
8294, 1566722156964, 16828, 1566722157195, 17059, 231, true
8295, 1566722156965, 16829, 1566722157195, 17059, 230, true
8296, 1566722156965, 16829, 1566722157193, 17057, 228, true
8297, 1566722156966, 16830, 1566722157197, 17061, 231, true
8298, 1566722156966, 16830, 1566722157192, 17056, 226, true
8299, 1566722156967, 16831, 1566722157189, 17053, 222, true
8300, 1566722156968, 16832, 1566722157188, 17052, 220, true
8301, 1566722156969, 16833, 1566722157190, 17054, 221, true
8302, 1566722156969, 16833, 1566722157193, 17057, 224, true
8303, 1566722156971, 16835, 1566722157197, 17061, 226, true
8304, 1566722156972, 16836, 1566722157193, 17057, 221, true
8305, 1566722156972, 16836, 1566722157197, 17061, 225, true
8306, 1566722156973, 16837, 1566722157192, 17056, 219, true
8307, 1566722156974, 16838, 1566722157195, 17059, 221, true
8308, 1566722156975, 16839, 1566722157193, 17057, 218, true
8309, 1566722156976, 16840, 1566722157193, 17057, 217, true
8310, 1566722156977, 16841, 1566722157188, 17052, 211, true
8311, 1566722156978, 16842, 1566722157190, 17054, 212, true
8312, 1566722156978, 16842, 1566722157195, 17059, 217, true
8313, 1566722156978, 16842, 1566722157193, 17057, 215, true
8314, 1566722156982, 16846, 1566722157206, 17070, 224, true
8315, 1566722156982, 16846, 1566722157201, 17065, 219, true
8316, 1566722156983, 16847, 1566722157206, 17070, 223, true
8317, 1566722156983, 16847, 1566722157205, 17069, 222, true
8318, 1566722156984, 16848, 1566722157206, 17070, 222, true
8319, 1566722156987, 16851, 1566722157206, 17070, 219, true
8320, 1566722156994, 16858, 1566722157206, 17070, 212, true
8321, 1566722156994, 16858, 1566722157206, 17070, 212, true
8322, 1566722156994, 16858, 1566722157206, 17070, 212, true
8323, 1566722156996, 16860, 1566722157206, 17070, 210, true
8324, 1566722156997, 16861, 1566722157210, 17074, 213, true
8325, 1566722156997, 16861, 1566722157210, 17074, 213, true
8326, 1566722156998, 16862, 1566722157210, 17074, 212, true
8327, 1566722157002, 16866, 1566722157210, 17074, 208, true
8328, 1566722157002, 16866, 1566722157210, 17074, 208, true
8329, 1566722157003, 16867, 1566722157210, 17074, 207, true
8330, 1566722157005, 16869, 1566722157210, 17074, 205, true
8331, 1566722157006, 16870, 1566722157210, 17074, 204, true
8332, 1566722157008, 16872, 1566722157215, 17079, 207, true
8333, 1566722157008, 16872, 1566722157215, 17079, 207, true
8334, 1566722157008, 16872, 1566722157215, 17079, 207, true
8335, 1566722157009, 16873, 1566722157219, 17083, 210, true
8336, 1566722157009, 16873, 1566722157223, 17087, 214, true
8337, 1566722157010, 16874, 1566722157228, 17092, 218, true
8338, 1566722157011, 16875, 1566722157228, 17092, 217, true
8339, 1566722157012, 16876, 1566722157228, 17092, 216, true
8340, 1566722157013, 16877, 1566722157228, 17092, 215, true
8341, 1566722157014, 16878, 1566722157228, 17092, 214, true
8342, 1566722157014, 16878, 1566722157228, 17092, 214, true
8343, 1566722157015, 16879, 1566722157228, 17092, 213, true
8344, 1566722157015, 16879, 1566722157228, 17092, 213, true
8345, 1566722157016, 16880, 1566722157228, 17092, 212, true
8346, 1566722157016, 16880, 1566722157228, 17092, 212, true
8347, 1566722157018, 16882, 1566722157240, 17104, 222, true
8348, 1566722157018, 16882, 1566722157244, 17108, 226, true
8349, 1566722157018, 16882, 1566722157248, 17112, 230, true
8350, 1566722157018, 16882, 1566722157244, 17108, 226, true
8351, 1566722157019, 16883, 1566722157236, 17100, 217, true
8352, 1566722157020, 16884, 1566722157249, 17113, 229, true
8353, 1566722157021, 16885, 1566722157248, 17112, 227, true
8354, 1566722157021, 16885, 1566722157249, 17113, 228, true
8355, 1566722157022, 16886, 1566722157246, 17110, 224, true
8356, 1566722157022, 16886, 1566722157247, 17111, 225, true
8357, 1566722157023, 16887, 1566722157230, 17094, 207, true
8358, 1566722157024, 16888, 1566722157241, 17105, 217, true
8359, 1566722157025, 16889, 1566722157249, 17113, 224, true
8360, 1566722157026, 16890, 1566722157254, 17118, 228, true
8361, 1566722157030, 16894, 1566722157253, 17117, 223, true
8362, 1566722157033, 16897, 1566722157249, 17113, 216, true
8363, 1566722157049, 16913, 1566722157254, 17118, 205, true
8364, 1566722157052, 16916, 1566722157255, 17119, 203, true
8365, 1566722157053, 16917, 1566722157258, 17122, 205, true
8366, 1566722157054, 16918, 1566722157258, 17122, 204, true
8367, 1566722157055, 16919, 1566722157258, 17122, 203, true
8368, 1566722157055, 16919, 1566722157264, 17128, 209, true
8369, 1566722157056, 16920, 1566722157264, 17128, 208, true
8370, 1566722157058, 16922, 1566722157264, 17128, 206, true
8371, 1566722157059, 16923, 1566722157264, 17128, 205, true
8372, 1566722157060, 16924, 1566722157264, 17128, 204, true
8373, 1566722157061, 16925, 1566722157269, 17133, 208, true
8374, 1566722157062, 16926, 1566722157272, 17136, 210, true
8375, 1566722157063, 16927, 1566722157272, 17136, 209, true
8376, 1566722157064, 16928, 1566722157272, 17136, 208, true
8377, 1566722157065, 16929, 1566722157271, 17135, 206, true
8378, 1566722157065, 16929, 1566722157276, 17140, 211, true
8379, 1566722157066, 16930, 1566722157276, 17140, 210, true
8380, 1566722157068, 16932, 1566722157273, 17137, 205, true
8381, 1566722157069, 16933, 1566722157276, 17140, 207, true
8382, 1566722157073, 16937, 1566722157280, 17144, 207, true
8383, 1566722157073, 16937, 1566722157279, 17143, 206, true
8384, 1566722157073, 16937, 1566722157279, 17143, 206, true
8385, 1566722157074, 16938, 1566722157280, 17144, 206, true
8386, 1566722157074, 16938, 1566722157281, 17145, 207, true
8387, 1566722157075, 16939, 1566722157287, 17151, 212, true
8388, 1566722157076, 16940, 1566722157286, 17150, 210, true
8389, 1566722157077, 16941, 1566722157286, 17150, 209, true
8390, 1566722157078, 16942, 1566722157285, 17149, 207, true
8391, 1566722157079, 16943, 1566722157285, 17149, 206, true
8392, 1566722157080, 16944, 1566722157285, 17149, 205, true
8393, 1566722157081, 16945, 1566722157290, 17154, 209, true
8394, 1566722157082, 16946, 1566722157290, 17154, 208, true
8395, 1566722157084, 16948, 1566722157290, 17154, 206, true
8396, 1566722157087, 16951, 1566722157299, 17163, 212, true
8397, 1566722157094, 16958, 1566722157299, 17163, 205, true
8398, 1566722157096, 16960, 1566722157304, 17168, 208, true
8399, 1566722157104, 16968, 1566722157308, 17172, 204, true
8400, 1566722157107, 16971, 1566722157313, 17177, 206, true
8401, 1566722157107, 16971, 1566722157311, 17175, 204, true
8402, 1566722157108, 16972, 1566722157313, 17177, 205, true
8403, 1566722157111, 16975, 1566722157317, 17181, 206, true
8404, 1566722157112, 16976, 1566722157317, 17181, 205, true
8405, 1566722157112, 16976, 1566722157317, 17181, 205, true
8406, 1566722157113, 16977, 1566722157317, 17181, 204, true
8407, 1566722157114, 16978, 1566722157320, 17184, 206, true
8408, 1566722157114, 16978, 1566722157327, 17191, 213, true
8409, 1566722157114, 16978, 1566722157323, 17187, 209, true
8410, 1566722157123, 16987, 1566722157329, 17193, 206, true
8411, 1566722157125, 16989, 1566722157328, 17192, 203, true
8412, 1566722157127, 16991, 1566722157334, 17198, 207, true
8413, 1566722157131, 16995, 1566722157338, 17202, 207, true
8414, 1566722157138, 17002, 1566722157342, 17206, 204, true
8415, 1566722157139, 17003, 1566722157342, 17206, 203, true
8416, 1566722157140, 17004, 1566722157349, 17213, 209, true
8417, 1566722157141, 17005, 1566722157349, 17213, 208, true
8418, 1566722157142, 17006, 1566722157350, 17214, 208, true
8419, 1566722157143, 17007, 1566722157351, 17215, 208, true
8420, 1566722157154, 17018, 1566722157360, 17224, 206, true
8421, 1566722157155, 17019, 1566722157361, 17225, 206, true
8422, 1566722157156, 17020, 1566722157361, 17225, 205, true
8423, 1566722157157, 17021, 1566722157361, 17225, 204, true
8424, 1566722157158, 17022, 1566722157365, 17229, 207, true
8425, 1566722157159, 17023, 1566722157370, 17234, 211, true
8426, 1566722157162, 17026, 1566722157372, 17236, 210, true
8427, 1566722157165, 17029, 1566722157371, 17235, 206, true
8428, 1566722157165, 17029, 1566722157373, 17237, 208, true
8429, 1566722157165, 17029, 1566722157373, 17237, 208, true
8430, 1566722157166, 17030, 1566722157373, 17237, 207, true
8431, 1566722157167, 17031, 1566722157373, 17237, 206, true
8432, 1566722157170, 17034, 1566722157379, 17243, 209, true
8433, 1566722157170, 17034, 1566722157385, 17249, 215, true
8434, 1566722157171, 17035, 1566722157404, 17268, 233, true
8435, 1566722157171, 17035, 1566722157406, 17270, 235, true
8436, 1566722157171, 17035, 1566722157406, 17270, 235, true
8437, 1566722157172, 17036, 1566722157390, 17254, 218, true
8438, 1566722157173, 17037, 1566722157401, 17265, 228, true
8439, 1566722157173, 17037, 1566722157385, 17249, 212, true
8440, 1566722157174, 17038, 1566722157408, 17272, 234, true
8441, 1566722157174, 17038, 1566722157402, 17266, 228, true
8442, 1566722157174, 17038, 1566722157427, 17291, 253, true
8443, 1566722157175, 17039, 1566722157425, 17289, 250, true
8444, 1566722157175, 17039, 1566722157425, 17289, 250, true
8445, 1566722157176, 17040, 1566722157425, 17289, 249, true
8446, 1566722157176, 17040, 1566722157405, 17269, 229, true
8447, 1566722157176, 17040, 1566722157426, 17290, 250, true
8448, 1566722157178, 17042, 1566722157425, 17289, 247, true
8449, 1566722157179, 17043, 1566722157418, 17282, 239, true
8450, 1566722157180, 17044, 1566722157430, 17294, 250, true
8451, 1566722157180, 17044, 1566722157425, 17289, 245, true
8452, 1566722157181, 17045, 1566722157425, 17289, 244, true
8453, 1566722157181, 17045, 1566722157424, 17288, 243, true
8454, 1566722157181, 17045, 1566722157425, 17289, 244, true
8455, 1566722157182, 17046, 1566722157425, 17289, 243, true
8456, 1566722157186, 17050, 1566722157429, 17293, 243, true
8457, 1566722157186, 17050, 1566722157430, 17294, 244, true
8458, 1566722157201, 17065, 1566722157449, 17313, 248, true
8459, 1566722157202, 17066, 1566722157449, 17313, 247, true
8460, 1566722157211, 17075, 1566722157440, 17304, 229, true
8461, 1566722157211, 17075, 1566722157437, 17301, 226, true
8462, 1566722157212, 17076, 1566722157433, 17297, 221, true
8463, 1566722157216, 17080, 1566722157433, 17297, 217, true
8464, 1566722157217, 17081, 1566722157440, 17304, 223, true
8465, 1566722157217, 17081, 1566722157440, 17304, 223, true
8466, 1566722157218, 17082, 1566722157449, 17313, 231, true
8467, 1566722157219, 17083, 1566722157451, 17315, 232, true
8468, 1566722157220, 17084, 1566722157440, 17304, 220, true
8469, 1566722157220, 17084, 1566722157450, 17314, 230, true
8470, 1566722157221, 17085, 1566722157434, 17298, 213, true
8471, 1566722157229, 17093, 1566722157459, 17323, 230, true
8472, 1566722157231, 17095, 1566722157454, 17318, 223, true
8473, 1566722157231, 17095, 1566722157466, 17330, 235, true
8474, 1566722157232, 17096, 1566722157450, 17314, 218, true
8475, 1566722157232, 17096, 1566722157453, 17317, 221, true
8476, 1566722157233, 17097, 1566722157451, 17315, 218, true
8477, 1566722157234, 17098, 1566722157466, 17330, 232, true
8478, 1566722157234, 17098, 1566722157458, 17322, 224, true
8479, 1566722157236, 17100, 1566722157453, 17317, 217, true
8480, 1566722157237, 17101, 1566722157466, 17330, 229, true
8481, 1566722157238, 17102, 1566722157453, 17317, 215, true
8482, 1566722157239, 17103, 1566722157455, 17319, 216, true
8483, 1566722157241, 17105, 1566722157454, 17318, 213, true
8484, 1566722157241, 17105, 1566722157459, 17323, 218, true
8485, 1566722157244, 17108, 1566722157475, 17339, 231, true
8486, 1566722157245, 17109, 1566722157480, 17344, 235, true
8487, 1566722157254, 17118, 1566722157480, 17344, 226, true
8488, 1566722157254, 17118, 1566722157467, 17331, 213, true
8489, 1566722157254, 17118, 1566722157480, 17344, 226, true
8490, 1566722157255, 17119, 1566722157469, 17333, 214, true
8491, 1566722157256, 17120, 1566722157466, 17330, 210, true
8492, 1566722157257, 17121, 1566722157473, 17337, 216, true
8493, 1566722157261, 17125, 1566722157484, 17348, 223, true
8494, 1566722157261, 17125, 1566722157484, 17348, 223, true
8495, 1566722157262, 17126, 1566722157495, 17359, 233, true
8496, 1566722157264, 17128, 1566722157490, 17354, 226, true
8497, 1566722157265, 17129, 1566722157485, 17349, 220, true
8498, 1566722157265, 17129, 1566722157495, 17359, 230, true
8499, 1566722157265, 17129, 1566722157487, 17351, 222, true
8500, 1566722157265, 17129, 1566722157488, 17352, 223, true
8501, 1566722157266, 17130, 1566722157494, 17358, 228, true
8502, 1566722157267, 17131, 1566722157488, 17352, 221, true
8503, 1566722157267, 17131, 1566722157495, 17359, 228, true
8504, 1566722157273, 17137, 1566722157484, 17348, 211, true
8505, 1566722157274, 17138, 1566722157495, 17359, 221, true
8506, 1566722157276, 17140, 1566722157495, 17359, 219, true
8507, 1566722157276, 17140, 1566722157498, 17362, 222, true
8508, 1566722157277, 17141, 1566722157498, 17362, 221, true
8509, 1566722157277, 17141, 1566722157494, 17358, 217, true
8510, 1566722157277, 17141, 1566722157498, 17362, 221, true
8511, 1566722157277, 17141, 1566722157505, 17369, 228, true
8512, 1566722157277, 17141, 1566722157515, 17379, 238, true
8513, 1566722157279, 17143, 1566722157506, 17370, 227, true
8514, 1566722157282, 17146, 1566722157498, 17362, 216, true
8515, 1566722157283, 17147, 1566722157506, 17370, 223, true
8516, 1566722157287, 17151, 1566722157505, 17369, 218, true
8517, 1566722157294, 17158, 1566722157514, 17378, 220, true
8518, 1566722157295, 17159, 1566722157507, 17371, 212, true
8519, 1566722157295, 17159, 1566722157515, 17379, 220, true
8520, 1566722157296, 17160, 1566722157514, 17378, 218, true
8521, 1566722157299, 17163, 1566722157505, 17369, 206, true
8522, 1566722157301, 17165, 1566722157515, 17379, 214, true
8523, 1566722157301, 17165, 1566722157509, 17373, 208, true
8524, 1566722157302, 17166, 1566722157515, 17379, 213, true
8525, 1566722157304, 17168, 1566722157515, 17379, 211, true
8526, 1566722157305, 17169, 1566722157515, 17379, 210, true
8527, 1566722157305, 17169, 1566722157515, 17379, 210, true
8528, 1566722157305, 17169, 1566722157516, 17380, 211, true
8529, 1566722157306, 17170, 1566722157515, 17379, 209, true
8530, 1566722157307, 17171, 1566722157515, 17379, 208, true
8531, 1566722157307, 17171, 1566722157516, 17380, 209, true
8532, 1566722157310, 17174, 1566722157518, 17382, 208, true
8533, 1566722157310, 17174, 1566722157518, 17382, 208, true
8534, 1566722157310, 17174, 1566722157519, 17383, 209, true
8535, 1566722157311, 17175, 1566722157518, 17382, 207, true
8536, 1566722157314, 17178, 1566722157518, 17382, 204, true
8537, 1566722157315, 17179, 1566722157526, 17390, 211, true
8538, 1566722157315, 17179, 1566722157526, 17390, 211, true
8539, 1566722157318, 17182, 1566722157530, 17394, 212, true
8540, 1566722157319, 17183, 1566722157530, 17394, 211, true
8541, 1566722157319, 17183, 1566722157530, 17394, 211, true
8542, 1566722157319, 17183, 1566722157529, 17393, 210, true
8543, 1566722157322, 17186, 1566722157530, 17394, 208, true
8544, 1566722157322, 17186, 1566722157534, 17398, 212, true
8545, 1566722157323, 17187, 1566722157530, 17394, 207, true
8546, 1566722157324, 17188, 1566722157529, 17393, 205, true
8547, 1566722157324, 17188, 1566722157532, 17396, 208, true
8548, 1566722157325, 17189, 1566722157532, 17396, 207, true
8549, 1566722157326, 17190, 1566722157532, 17396, 206, true
8550, 1566722157330, 17194, 1566722157533, 17397, 203, true
8551, 1566722157330, 17194, 1566722157533, 17397, 203, true
8552, 1566722157331, 17195, 1566722157538, 17402, 207, true
8553, 1566722157332, 17196, 1566722157538, 17402, 206, true
8554, 1566722157333, 17197, 1566722157538, 17402, 205, true
8555, 1566722157334, 17198, 1566722157542, 17406, 208, true
8556, 1566722157334, 17198, 1566722157540, 17404, 206, true
8557, 1566722157335, 17199, 1566722157541, 17405, 206, true
8558, 1566722157336, 17200, 1566722157543, 17407, 207, true
8559, 1566722157339, 17203, 1566722157545, 17409, 206, true
8560, 1566722157339, 17203, 1566722157545, 17409, 206, true
8561, 1566722157342, 17206, 1566722157551, 17415, 209, true
8562, 1566722157343, 17207, 1566722157546, 17410, 203, true
8563, 1566722157344, 17208, 1566722157551, 17415, 207, true
8564, 1566722157345, 17209, 1566722157551, 17415, 206, true
8565, 1566722157345, 17209, 1566722157558, 17422, 213, true
8566, 1566722157346, 17210, 1566722157557, 17421, 211, true
8567, 1566722157346, 17210, 1566722157555, 17419, 209, true
8568, 1566722157346, 17210, 1566722157557, 17421, 211, true
8569, 1566722157347, 17211, 1566722157558, 17422, 211, true
8570, 1566722157351, 17215, 1566722157558, 17422, 207, true
8571, 1566722157354, 17218, 1566722157560, 17424, 206, true
8572, 1566722157354, 17218, 1566722157558, 17422, 204, true
8573, 1566722157354, 17218, 1566722157560, 17424, 206, true
8574, 1566722157355, 17219, 1566722157560, 17424, 205, true
8575, 1566722157355, 17219, 1566722157560, 17424, 205, true
8576, 1566722157357, 17221, 1566722157573, 17437, 216, true
8577, 1566722157358, 17222, 1566722157566, 17430, 208, true
8578, 1566722157358, 17222, 1566722157565, 17429, 207, true
8579, 1566722157360, 17224, 1566722157573, 17437, 213, true
8580, 1566722157361, 17225, 1566722157566, 17430, 205, true
8581, 1566722157362, 17226, 1566722157573, 17437, 211, true
8582, 1566722157365, 17229, 1566722157573, 17437, 208, true
8583, 1566722157365, 17229, 1566722157573, 17437, 208, true
8584, 1566722157366, 17230, 1566722157580, 17444, 214, true
8585, 1566722157366, 17230, 1566722157579, 17443, 213, true
8586, 1566722157367, 17231, 1566722157573, 17437, 206, true
8587, 1566722157368, 17232, 1566722157577, 17441, 209, true
8588, 1566722157374, 17238, 1566722157579, 17443, 205, true
8589, 1566722157375, 17239, 1566722157587, 17451, 212, true
8590, 1566722157375, 17239, 1566722157587, 17451, 212, true
8591, 1566722157376, 17240, 1566722157587, 17451, 211, true
8592, 1566722157376, 17240, 1566722157582, 17446, 206, true
8593, 1566722157376, 17240, 1566722157584, 17448, 208, true
8594, 1566722157376, 17240, 1566722157587, 17451, 211, true
8595, 1566722157376, 17240, 1566722157587, 17451, 211, true
8596, 1566722157377, 17241, 1566722157582, 17446, 205, true
8597, 1566722157379, 17243, 1566722157587, 17451, 208, true
8598, 1566722157381, 17245, 1566722157587, 17451, 206, true
8599, 1566722157381, 17245, 1566722157590, 17454, 209, true
8600, 1566722157382, 17246, 1566722157590, 17454, 208, true
8601, 1566722157382, 17246, 1566722157589, 17453, 207, true
8602, 1566722157383, 17247, 1566722157590, 17454, 207, true
8603, 1566722157387, 17251, 1566722157590, 17454, 203, true
8604, 1566722157388, 17252, 1566722157590, 17454, 202, true
8605, 1566722157388, 17252, 1566722157598, 17462, 210, true
8606, 1566722157388, 17252, 1566722157598, 17462, 210, true
8607, 1566722157390, 17254, 1566722157599, 17463, 209, true
8608, 1566722157392, 17256, 1566722157601, 17465, 209, true
8609, 1566722157392, 17256, 1566722157599, 17463, 207, true
8610, 1566722157393, 17257, 1566722157598, 17462, 205, true
8611, 1566722157396, 17260, 1566722157606, 17470, 210, true
8612, 1566722157397, 17261, 1566722157607, 17471, 210, true
8613, 1566722157398, 17262, 1566722157605, 17469, 207, true
8614, 1566722157400, 17264, 1566722157606, 17470, 206, true
8615, 1566722157403, 17267, 1566722157628, 17492, 225, true
8616, 1566722157403, 17267, 1566722157634, 17498, 231, true
8617, 1566722157404, 17268, 1566722157619, 17483, 215, true
8618, 1566722157405, 17269, 1566722157633, 17497, 228, true
8619, 1566722157405, 17269, 1566722157619, 17483, 214, true
8620, 1566722157406, 17270, 1566722157633, 17497, 227, true
8621, 1566722157406, 17270, 1566722157627, 17491, 221, true
8622, 1566722157407, 17271, 1566722157622, 17486, 215, true
8623, 1566722157408, 17272, 1566722157623, 17487, 215, true
8624, 1566722157408, 17272, 1566722157622, 17486, 214, true
8625, 1566722157409, 17273, 1566722157633, 17497, 224, true
8626, 1566722157409, 17273, 1566722157633, 17497, 224, true
8627, 1566722157410, 17274, 1566722157626, 17490, 216, true
8628, 1566722157410, 17274, 1566722157635, 17499, 225, true
8629, 1566722157411, 17275, 1566722157633, 17497, 222, true
8630, 1566722157411, 17275, 1566722157633, 17497, 222, true
8631, 1566722157412, 17276, 1566722157633, 17497, 221, true
8632, 1566722157412, 17276, 1566722157633, 17497, 221, true
8633, 1566722157412, 17276, 1566722157625, 17489, 213, true
8634, 1566722157412, 17276, 1566722157633, 17497, 221, true
8635, 1566722157413, 17277, 1566722157622, 17486, 209, true
8636, 1566722157413, 17277, 1566722157633, 17497, 220, true
8637, 1566722157435, 17299, 1566722157638, 17502, 203, true
8638, 1566722157436, 17300, 1566722157639, 17503, 203, true
8639, 1566722157437, 17301, 1566722157642, 17506, 205, true
8640, 1566722157441, 17305, 1566722157646, 17510, 205, true
8641, 1566722157442, 17306, 1566722157646, 17510, 204, true
8642, 1566722157443, 17307, 1566722157647, 17511, 204, true
8643, 1566722157444, 17308, 1566722157647, 17511, 203, true
8644, 1566722157445, 17309, 1566722157651, 17515, 206, true
8645, 1566722157446, 17310, 1566722157655, 17519, 209, true
8646, 1566722157460, 17324, 1566722157665, 17529, 205, true
8647, 1566722157461, 17325, 1566722157665, 17529, 204, true
8648, 1566722157462, 17326, 1566722157672, 17536, 210, true
8649, 1566722157463, 17327, 1566722157672, 17536, 209, true
8650, 1566722157467, 17331, 1566722157674, 17538, 207, true
8651, 1566722157469, 17333, 1566722157674, 17538, 205, true
8652, 1566722157471, 17335, 1566722157674, 17538, 203, true
8653, 1566722157472, 17336, 1566722157676, 17540, 204, true
8654, 1566722157473, 17337, 1566722157676, 17540, 203, true
8655, 1566722157475, 17339, 1566722157679, 17543, 204, true
8656, 1566722157482, 17346, 1566722157690, 17554, 208, true
8657, 1566722157489, 17353, 1566722157693, 17557, 204, true
8658, 1566722157491, 17355, 1566722157697, 17561, 206, true
8659, 1566722157501, 17365, 1566722157705, 17569, 204, true
8660, 1566722157502, 17366, 1566722157707, 17571, 205, true
8661, 1566722157508, 17372, 1566722157711, 17575, 203, true
8662, 1566722157509, 17373, 1566722157712, 17576, 203, true
8663, 1566722157511, 17375, 1566722157721, 17585, 210, true
8664, 1566722157521, 17385, 1566722157733, 17597, 212, true
8665, 1566722157523, 17387, 1566722157726, 17590, 203, true
8666, 1566722157524, 17388, 1566722157729, 17593, 205, true
8667, 1566722157535, 17399, 1566722157740, 17604, 205, true
8668, 1566722157538, 17402, 1566722157741, 17605, 203, true
8669, 1566722157540, 17404, 1566722157745, 17609, 205, true
8670, 1566722157541, 17405, 1566722157754, 17618, 213, true
8671, 1566722157542, 17406, 1566722157750, 17614, 208, true
8672, 1566722157542, 17406, 1566722157750, 17614, 208, true
8673, 1566722157544, 17408, 1566722157755, 17619, 211, true
8674, 1566722157546, 17410, 1566722157750, 17614, 204, true
8675, 1566722157548, 17412, 1566722157751, 17615, 203, true
8676, 1566722157548, 17412, 1566722157755, 17619, 207, true
8677, 1566722157548, 17412, 1566722157754, 17618, 206, true
8678, 1566722157549, 17413, 1566722157755, 17619, 206, true
8679, 1566722157549, 17413, 1566722157755, 17619, 206, true
8680, 1566722157552, 17416, 1566722157756, 17620, 204, true
8681, 1566722157552, 17416, 1566722157763, 17627, 211, true
8682, 1566722157553, 17417, 1566722157764, 17628, 211, true
8683, 1566722157553, 17417, 1566722157760, 17624, 207, true
8684, 1566722157554, 17418, 1566722157760, 17624, 206, true
8685, 1566722157556, 17420, 1566722157770, 17634, 214, true
8686, 1566722157561, 17425, 1566722157766, 17630, 205, true
8687, 1566722157561, 17425, 1566722157779, 17643, 218, true
8688, 1566722157562, 17426, 1566722157779, 17643, 217, true
8689, 1566722157563, 17427, 1566722157779, 17643, 216, true
8690, 1566722157564, 17428, 1566722157773, 17637, 209, true
8691, 1566722157564, 17428, 1566722157779, 17643, 215, true
8692, 1566722157566, 17430, 1566722157779, 17643, 213, true
8693, 1566722157567, 17431, 1566722157780, 17644, 213, true
8694, 1566722157568, 17432, 1566722157779, 17643, 211, true
8695, 1566722157568, 17432, 1566722157789, 17653, 221, true
8696, 1566722157568, 17432, 1566722157800, 17664, 232, true
8697, 1566722157569, 17433, 1566722157784, 17648, 215, true
8698, 1566722157569, 17433, 1566722157795, 17659, 226, true
8699, 1566722157573, 17437, 1566722157785, 17649, 212, true
8700, 1566722157574, 17438, 1566722157789, 17653, 215, true
8701, 1566722157575, 17439, 1566722157800, 17664, 225, true
8702, 1566722157575, 17439, 1566722157795, 17659, 220, true
8703, 1566722157576, 17440, 1566722157789, 17653, 213, true
8704, 1566722157577, 17441, 1566722157787, 17651, 210, true
8705, 1566722157579, 17443, 1566722157805, 17669, 226, true
8706, 1566722157580, 17444, 1566722157802, 17666, 222, true
8707, 1566722157581, 17445, 1566722157808, 17672, 227, true
8708, 1566722157584, 17448, 1566722157806, 17670, 222, true
8709, 1566722157585, 17449, 1566722157800, 17664, 215, true
8710, 1566722157592, 17456, 1566722157808, 17672, 216, true
8711, 1566722157592, 17456, 1566722157805, 17669, 213, true
8712, 1566722157592, 17456, 1566722157804, 17668, 212, true
8713, 1566722157593, 17457, 1566722157800, 17664, 207, true
8714, 1566722157593, 17457, 1566722157808, 17672, 215, true
8715, 1566722157593, 17457, 1566722157814, 17678, 221, true
8716, 1566722157593, 17457, 1566722157812, 17676, 219, true
8717, 1566722157594, 17458, 1566722157811, 17675, 217, true
8718, 1566722157595, 17459, 1566722157813, 17677, 218, true
8719, 1566722157595, 17459, 1566722157813, 17677, 218, true
8720, 1566722157602, 17466, 1566722157821, 17685, 219, true
8721, 1566722157602, 17466, 1566722157817, 17681, 215, true
8722, 1566722157603, 17467, 1566722157830, 17694, 227, true
8723, 1566722157603, 17467, 1566722157827, 17691, 224, true
8724, 1566722157603, 17467, 1566722157830, 17694, 227, true
8725, 1566722157603, 17467, 1566722157817, 17681, 214, true
8726, 1566722157607, 17471, 1566722157827, 17691, 220, true
8727, 1566722157607, 17471, 1566722157831, 17695, 224, true
8728, 1566722157608, 17472, 1566722157827, 17691, 219, true
8729, 1566722157608, 17472, 1566722157817, 17681, 209, true
8730, 1566722157609, 17473, 1566722157830, 17694, 221, true
8731, 1566722157610, 17474, 1566722157830, 17694, 220, true
8732, 1566722157611, 17475, 1566722157823, 17687, 212, true
8733, 1566722157612, 17476, 1566722157823, 17687, 211, true
8734, 1566722157613, 17477, 1566722157831, 17695, 218, true
8735, 1566722157614, 17478, 1566722157831, 17695, 217, true
8736, 1566722157614, 17478, 1566722157827, 17691, 213, true
8737, 1566722157615, 17479, 1566722157831, 17695, 216, true
8738, 1566722157619, 17483, 1566722157831, 17695, 212, true
8739, 1566722157620, 17484, 1566722157831, 17695, 211, true
8740, 1566722157620, 17484, 1566722157832, 17696, 212, true
8741, 1566722157626, 17490, 1566722157834, 17698, 208, true
8742, 1566722157628, 17492, 1566722157835, 17699, 207, true
8743, 1566722157628, 17492, 1566722157839, 17703, 211, true
8744, 1566722157629, 17493, 1566722157834, 17698, 205, true
8745, 1566722157636, 17500, 1566722157839, 17703, 203, true
8746, 1566722157636, 17500, 1566722157839, 17703, 203, true
8747, 1566722157637, 17501, 1566722157840, 17704, 203, true
8748, 1566722157638, 17502, 1566722157845, 17709, 207, true
8749, 1566722157639, 17503, 1566722157842, 17706, 203, true
8750, 1566722157639, 17503, 1566722157843, 17707, 204, true
8751, 1566722157640, 17504, 1566722157845, 17709, 205, true
8752, 1566722157640, 17504, 1566722157848, 17712, 208, true
8753, 1566722157642, 17506, 1566722157848, 17712, 206, true
8754, 1566722157642, 17506, 1566722157848, 17712, 206, true
8755, 1566722157644, 17508, 1566722157851, 17715, 207, true
8756, 1566722157644, 17508, 1566722157851, 17715, 207, true
8757, 1566722157644, 17508, 1566722157851, 17715, 207, true
8758, 1566722157648, 17512, 1566722157856, 17720, 208, true
8759, 1566722157648, 17512, 1566722157853, 17717, 205, true
8760, 1566722157649, 17513, 1566722157856, 17720, 207, true
8761, 1566722157650, 17514, 1566722157858, 17722, 208, true
8762, 1566722157652, 17516, 1566722157856, 17720, 204, true
8763, 1566722157652, 17516, 1566722157858, 17722, 206, true
8764, 1566722157653, 17517, 1566722157858, 17722, 205, true
8765, 1566722157655, 17519, 1566722157858, 17722, 203, true
8766, 1566722157655, 17519, 1566722157861, 17725, 206, true
8767, 1566722157656, 17520, 1566722157862, 17726, 206, true
8768, 1566722157657, 17521, 1566722157862, 17726, 205, true
8769, 1566722157657, 17521, 1566722157865, 17729, 208, true
8770, 1566722157658, 17522, 1566722157865, 17729, 207, true
8771, 1566722157660, 17524, 1566722157863, 17727, 203, true
8772, 1566722157660, 17524, 1566722157863, 17727, 203, true
8773, 1566722157662, 17526, 1566722157869, 17733, 207, true
8774, 1566722157662, 17526, 1566722157869, 17733, 207, true
8775, 1566722157662, 17526, 1566722157873, 17737, 211, true
8776, 1566722157665, 17529, 1566722157869, 17733, 204, true
8777, 1566722157665, 17529, 1566722157871, 17735, 206, true
8778, 1566722157666, 17530, 1566722157873, 17737, 207, true
8779, 1566722157667, 17531, 1566722157874, 17738, 207, true
8780, 1566722157668, 17532, 1566722157874, 17738, 206, true
8781, 1566722157669, 17533, 1566722157874, 17738, 205, true
8782, 1566722157669, 17533, 1566722157877, 17741, 208, true
8783, 1566722157670, 17534, 1566722157881, 17745, 211, true
8784, 1566722157672, 17536, 1566722157879, 17743, 207, true
8785, 1566722157672, 17536, 1566722157883, 17747, 211, true
8786, 1566722157674, 17538, 1566722157882, 17746, 208, true
8787, 1566722157676, 17540, 1566722157883, 17747, 207, true
8788, 1566722157677, 17541, 1566722157884, 17748, 207, true
8789, 1566722157679, 17543, 1566722157910, 17774, 231, true
8790, 1566722157679, 17543, 1566722157923, 17787, 244, true
8791, 1566722157680, 17544, 1566722157916, 17780, 236, true
8792, 1566722157680, 17544, 1566722157917, 17781, 237, true
8793, 1566722157680, 17544, 1566722157915, 17779, 235, true
8794, 1566722157681, 17545, 1566722157923, 17787, 242, true
8795, 1566722157681, 17545, 1566722157915, 17779, 234, true
8796, 1566722157682, 17546, 1566722157917, 17781, 235, true
8797, 1566722157682, 17546, 1566722157917, 17781, 235, true
8798, 1566722157682, 17546, 1566722157911, 17775, 229, true
8799, 1566722157683, 17547, 1566722157917, 17781, 234, true
8800, 1566722157683, 17547, 1566722157911, 17775, 228, true
8801, 1566722157684, 17548, 1566722157923, 17787, 239, true
8802, 1566722157684, 17548, 1566722157916, 17780, 232, true
8803, 1566722157684, 17548, 1566722157917, 17781, 233, true
8804, 1566722157684, 17548, 1566722157916, 17780, 232, true
8805, 1566722157685, 17549, 1566722157917, 17781, 232, true
8806, 1566722157685, 17549, 1566722157917, 17781, 232, true
8807, 1566722157685, 17549, 1566722157917, 17781, 232, true
8808, 1566722157686, 17550, 1566722157910, 17774, 224, true
8809, 1566722157686, 17550, 1566722157910, 17774, 224, true
8810, 1566722157686, 17550, 1566722157917, 17781, 231, true
8811, 1566722157687, 17551, 1566722157917, 17781, 230, true
8812, 1566722157687, 17551, 1566722157918, 17782, 231, true
8813, 1566722157688, 17552, 1566722157911, 17775, 223, true
8814, 1566722157689, 17553, 1566722157923, 17787, 234, true
8815, 1566722157690, 17554, 1566722157911, 17775, 221, true
8816, 1566722157690, 17554, 1566722157918, 17782, 228, true
8817, 1566722157691, 17555, 1566722157918, 17782, 227, true
8818, 1566722157691, 17555, 1566722157923, 17787, 232, true
8819, 1566722157692, 17556, 1566722157924, 17788, 232, true
8820, 1566722157693, 17557, 1566722157911, 17775, 218, true
8821, 1566722157693, 17557, 1566722157928, 17792, 235, true
8822, 1566722157694, 17558, 1566722157928, 17792, 234, true
8823, 1566722157694, 17558, 1566722157924, 17788, 230, true
8824, 1566722157694, 17558, 1566722157935, 17799, 241, true
8825, 1566722157694, 17558, 1566722157935, 17799, 241, true
8826, 1566722157695, 17559, 1566722157923, 17787, 228, true
8827, 1566722157695, 17559, 1566722157923, 17787, 228, true
8828, 1566722157695, 17559, 1566722157928, 17792, 233, true
8829, 1566722157695, 17559, 1566722157928, 17792, 233, true
8830, 1566722157696, 17560, 1566722157935, 17799, 239, true
8831, 1566722157697, 17561, 1566722157935, 17799, 238, true
8832, 1566722157698, 17562, 1566722157917, 17781, 219, true
8833, 1566722157698, 17562, 1566722157928, 17792, 230, true
8834, 1566722157698, 17562, 1566722157932, 17796, 234, true
8835, 1566722157699, 17563, 1566722157934, 17798, 235, true
8836, 1566722157699, 17563, 1566722157919, 17783, 220, true
8837, 1566722157699, 17563, 1566722157925, 17789, 226, true
8838, 1566722157700, 17564, 1566722157933, 17797, 233, true
8839, 1566722157701, 17565, 1566722157923, 17787, 222, true
8840, 1566722157701, 17565, 1566722157935, 17799, 234, true
8841, 1566722157705, 17569, 1566722157924, 17788, 219, true
8842, 1566722157706, 17570, 1566722157928, 17792, 222, true
8843, 1566722157707, 17571, 1566722157925, 17789, 218, true
8844, 1566722157726, 17590, 1566722157932, 17796, 206, true
8845, 1566722157728, 17592, 1566722157936, 17800, 208, true
8846, 1566722157729, 17593, 1566722157933, 17797, 204, true
8847, 1566722157729, 17593, 1566722157935, 17799, 206, true
8848, 1566722157730, 17594, 1566722157937, 17801, 207, true
8849, 1566722157731, 17595, 1566722157937, 17801, 206, true
8850, 1566722157731, 17595, 1566722157937, 17801, 206, true
8851, 1566722157733, 17597, 1566722157939, 17803, 206, true
8852, 1566722157734, 17598, 1566722157942, 17806, 208, true
8853, 1566722157735, 17599, 1566722157939, 17803, 204, true
8854, 1566722157735, 17599, 1566722157942, 17806, 207, true
8855, 1566722157736, 17600, 1566722157942, 17806, 206, true
8856, 1566722157736, 17600, 1566722157942, 17806, 206, true
8857, 1566722157737, 17601, 1566722157948, 17812, 211, true
8858, 1566722157738, 17602, 1566722157948, 17812, 210, true
8859, 1566722157742, 17606, 1566722157952, 17816, 210, true
8860, 1566722157742, 17606, 1566722157953, 17817, 211, true
8861, 1566722157743, 17607, 1566722157948, 17812, 205, true
8862, 1566722157743, 17607, 1566722157952, 17816, 209, true
8863, 1566722157745, 17609, 1566722157952, 17816, 207, true
8864, 1566722157746, 17610, 1566722157955, 17819, 209, true
8865, 1566722157746, 17610, 1566722157958, 17822, 212, true
8866, 1566722157747, 17611, 1566722157953, 17817, 206, true
8867, 1566722157754, 17618, 1566722157959, 17823, 205, true
8868, 1566722157757, 17621, 1566722157964, 17828, 207, true
8869, 1566722157758, 17622, 1566722157962, 17826, 204, true
8870, 1566722157758, 17622, 1566722157962, 17826, 204, true
8871, 1566722157759, 17623, 1566722157964, 17828, 205, true
8872, 1566722157761, 17625, 1566722157974, 17838, 213, true
8873, 1566722157762, 17626, 1566722157966, 17830, 204, true
8874, 1566722157764, 17628, 1566722157974, 17838, 210, true
8875, 1566722157764, 17628, 1566722157974, 17838, 210, true
8876, 1566722157766, 17630, 1566722157970, 17834, 204, true
8877, 1566722157766, 17630, 1566722157970, 17834, 204, true
8878, 1566722157767, 17631, 1566722157970, 17834, 203, true
8879, 1566722157768, 17632, 1566722157972, 17836, 204, true
8880, 1566722157768, 17632, 1566722157974, 17838, 206, true
8881, 1566722157771, 17635, 1566722157977, 17841, 206, true
8882, 1566722157773, 17637, 1566722157975, 17839, 202, true
8883, 1566722157773, 17637, 1566722157979, 17843, 206, true
8884, 1566722157774, 17638, 1566722157979, 17843, 205, true
8885, 1566722157776, 17640, 1566722157990, 17854, 214, true
8886, 1566722157781, 17645, 1566722157990, 17854, 209, true
8887, 1566722157782, 17646, 1566722157991, 17855, 209, true
8888, 1566722157782, 17646, 1566722157991, 17855, 209, true
8889, 1566722157783, 17647, 1566722157991, 17855, 208, true
8890, 1566722157785, 17649, 1566722157991, 17855, 206, true
8891, 1566722157785, 17649, 1566722157990, 17854, 205, true
8892, 1566722157786, 17650, 1566722157991, 17855, 205, true
8893, 1566722157787, 17651, 1566722157991, 17855, 204, true
8894, 1566722157787, 17651, 1566722157993, 17857, 206, true
8895, 1566722157789, 17653, 1566722157992, 17856, 203, true
8896, 1566722157791, 17655, 1566722157998, 17862, 207, true
8897, 1566722157792, 17656, 1566722157996, 17860, 204, true
8898, 1566722157793, 17657, 1566722157998, 17862, 205, true
8899, 1566722157796, 17660, 1566722158000, 17864, 204, true
8900, 1566722157797, 17661, 1566722158001, 17865, 204, true
8901, 1566722157800, 17664, 1566722158005, 17869, 205, true
8902, 1566722157802, 17666, 1566722158005, 17869, 203, true
8903, 1566722157819, 17683, 1566722158025, 17889, 206, true
8904, 1566722157854, 17718, 1566722158060, 17924, 206, true
8905, 1566722157859, 17723, 1566722158066, 17930, 207, true
8906, 1566722157864, 17728, 1566722158068, 17932, 204, true
8907, 1566722157866, 17730, 1566722158077, 17941, 211, true
8908, 1566722157870, 17734, 1566722158073, 17937, 203, true
8909, 1566722157876, 17740, 1566722158081, 17945, 205, true
8910, 1566722157877, 17741, 1566722158084, 17948, 207, true
8911, 1566722157880, 17744, 1566722158083, 17947, 203, true
8912, 1566722157885, 17749, 1566722158089, 17953, 204, true
8913, 1566722157887, 17751, 1566722158092, 17956, 205, true
8914, 1566722157888, 17752, 1566722158091, 17955, 203, true
8915, 1566722157889, 17753, 1566722158093, 17957, 204, true
8916, 1566722157890, 17754, 1566722158093, 17957, 203, true
8917, 1566722157891, 17755, 1566722158094, 17958, 203, true
8918, 1566722157893, 17757, 1566722158098, 17962, 205, true
8919, 1566722157895, 17759, 1566722158100, 17964, 205, true
8920, 1566722157897, 17761, 1566722158106, 17970, 209, true
8921, 1566722157899, 17763, 1566722158108, 17972, 209, true
8922, 1566722157901, 17765, 1566722158105, 17969, 204, true
8923, 1566722157902, 17766, 1566722158108, 17972, 206, true
8924, 1566722157904, 17768, 1566722158108, 17972, 204, true
8925, 1566722157906, 17770, 1566722158113, 17977, 207, true
8926, 1566722157929, 17793, 1566722158160, 18024, 231, true
8927, 1566722157930, 17794, 1566722158160, 18024, 230, true
8928, 1566722157938, 17802, 1566722158152, 18016, 214, true
8929, 1566722157940, 17804, 1566722158163, 18027, 223, true
8930, 1566722157944, 17808, 1566722158163, 18027, 219, true
8931, 1566722157945, 17809, 1566722158160, 18024, 215, true
8932, 1566722157945, 17809, 1566722158170, 18034, 225, true
8933, 1566722157946, 17810, 1566722158170, 18034, 224, true
8934, 1566722157946, 17810, 1566722158170, 18034, 224, true
8935, 1566722157946, 17810, 1566722158163, 18027, 217, true
8936, 1566722157948, 17812, 1566722158170, 18034, 222, true
8937, 1566722157949, 17813, 1566722158167, 18031, 218, true
8938, 1566722157950, 17814, 1566722158170, 18034, 220, true
8939, 1566722157950, 17814, 1566722158167, 18031, 217, true
8940, 1566722157953, 17817, 1566722158167, 18031, 214, true
8941, 1566722157955, 17819, 1566722158170, 18034, 215, true
8942, 1566722157955, 17819, 1566722158170, 18034, 215, true
8943, 1566722157956, 17820, 1566722158163, 18027, 207, true
8944, 1566722157956, 17820, 1566722158163, 18027, 207, true
8945, 1566722157959, 17823, 1566722158170, 18034, 211, true
8946, 1566722157959, 17823, 1566722158170, 18034, 211, true
8947, 1566722157963, 17827, 1566722158170, 18034, 207, true
8948, 1566722157967, 17831, 1566722158176, 18040, 209, true
8949, 1566722157967, 17831, 1566722158176, 18040, 209, true
8950, 1566722157968, 17832, 1566722158176, 18040, 208, true
8951, 1566722157968, 17832, 1566722158176, 18040, 208, true
8952, 1566722157968, 17832, 1566722158179, 18043, 211, true
8953, 1566722157968, 17832, 1566722158179, 18043, 211, true
8954, 1566722157971, 17835, 1566722158177, 18041, 206, true
8955, 1566722157976, 17840, 1566722158183, 18047, 207, true
8956, 1566722157976, 17840, 1566722158184, 18048, 208, true
8957, 1566722157977, 17841, 1566722158185, 18049, 208, true
8958, 1566722157979, 17843, 1566722158186, 18050, 207, true
8959, 1566722157979, 17843, 1566722158184, 18048, 205, true
8960, 1566722157980, 17844, 1566722158185, 18049, 205, true
8961, 1566722157980, 17844, 1566722158186, 18050, 206, true
8962, 1566722157980, 17844, 1566722158186, 18050, 206, true
8963, 1566722157983, 17847, 1566722158187, 18051, 204, true
8964, 1566722157983, 17847, 1566722158189, 18053, 206, true
8965, 1566722157984, 17848, 1566722158195, 18059, 211, true
8966, 1566722157984, 17848, 1566722158195, 18059, 211, true
8967, 1566722157985, 17849, 1566722158197, 18061, 212, true
8968, 1566722157985, 17849, 1566722158197, 18061, 212, true
8969, 1566722157986, 17850, 1566722158199, 18063, 213, true
8970, 1566722157990, 17854, 1566722158198, 18062, 208, true
8971, 1566722157994, 17858, 1566722158200, 18064, 206, true
8972, 1566722157994, 17858, 1566722158201, 18065, 207, true
8973, 1566722157996, 17860, 1566722158206, 18070, 210, true
8974, 1566722157998, 17862, 1566722158203, 18067, 205, true
8975, 1566722157999, 17863, 1566722158204, 18068, 205, true
8976, 1566722158001, 17865, 1566722158210, 18074, 209, true
8977, 1566722158002, 17866, 1566722158210, 18074, 208, true
8978, 1566722158002, 17866, 1566722158208, 18072, 206, true
8979, 1566722158003, 17867, 1566722158208, 18072, 205, true
8980, 1566722158003, 17867, 1566722158210, 18074, 207, true
8981, 1566722158005, 17869, 1566722158210, 18074, 205, true
8982, 1566722158006, 17870, 1566722158216, 18080, 210, true
8983, 1566722158006, 17870, 1566722158216, 18080, 210, true
8984, 1566722158006, 17870, 1566722158216, 18080, 210, true
8985, 1566722158007, 17871, 1566722158243, 18107, 236, true
8986, 1566722158007, 17871, 1566722158216, 18080, 209, true
8987, 1566722158008, 17872, 1566722158216, 18080, 208, true
8988, 1566722158009, 17873, 1566722158262, 18126, 253, true
8989, 1566722158010, 17874, 1566722158263, 18127, 253, true
8990, 1566722158011, 17875, 1566722158262, 18126, 251, true
8991, 1566722158012, 17876, 1566722158261, 18125, 249, true
8992, 1566722158012, 17876, 1566722158254, 18118, 242, true
8993, 1566722158012, 17876, 1566722158245, 18109, 233, true
8994, 1566722158013, 17877, 1566722158254, 18118, 241, true
8995, 1566722158013, 17877, 1566722158254, 18118, 241, true
8996, 1566722158013, 17877, 1566722158261, 18125, 248, true
8997, 1566722158014, 17878, 1566722158262, 18126, 248, true
8998, 1566722158014, 17878, 1566722158254, 18118, 240, true
8999, 1566722158014, 17878, 1566722158261, 18125, 247, true
9000, 1566722158015, 17879, 1566722158251, 18115, 236, true
9001, 1566722158015, 17879, 1566722158251, 18115, 236, true
9002, 1566722158015, 17879, 1566722158262, 18126, 247, true
9003, 1566722158015, 17879, 1566722158261, 18125, 246, true
9004, 1566722158015, 17879, 1566722158246, 18110, 231, true
9005, 1566722158016, 17880, 1566722158251, 18115, 235, true
9006, 1566722158016, 17880, 1566722158254, 18118, 238, true
9007, 1566722158016, 17880, 1566722158251, 18115, 235, true
9008, 1566722158017, 17881, 1566722158251, 18115, 234, true
9009, 1566722158017, 17881, 1566722158261, 18125, 244, true
9010, 1566722158017, 17881, 1566722158254, 18118, 237, true
9011, 1566722158017, 17881, 1566722158262, 18126, 245, true
9012, 1566722158018, 17882, 1566722158261, 18125, 243, true
9013, 1566722158018, 17882, 1566722158262, 18126, 244, true
9014, 1566722158018, 17882, 1566722158254, 18118, 236, true
9015, 1566722158018, 17882, 1566722158254, 18118, 236, true
9016, 1566722158019, 17883, 1566722158249, 18113, 230, true
9017, 1566722158019, 17883, 1566722158262, 18126, 243, true
9018, 1566722158019, 17883, 1566722158251, 18115, 232, true
9019, 1566722158019, 17883, 1566722158251, 18115, 232, true
9020, 1566722158020, 17884, 1566722158260, 18124, 240, true
9021, 1566722158020, 17884, 1566722158261, 18125, 241, true
9022, 1566722158020, 17884, 1566722158251, 18115, 231, true
9023, 1566722158020, 17884, 1566722158254, 18118, 234, true
9024, 1566722158021, 17885, 1566722158262, 18126, 241, true
9025, 1566722158021, 17885, 1566722158261, 18125, 240, true
9026, 1566722158021, 17885, 1566722158261, 18125, 240, true
9027, 1566722158021, 17885, 1566722158267, 18131, 246, true
9028, 1566722158022, 17886, 1566722158268, 18132, 246, true
9029, 1566722158022, 17886, 1566722158266, 18130, 244, true
9030, 1566722158022, 17886, 1566722158277, 18141, 255, true
9031, 1566722158022, 17886, 1566722158285, 18149, 263, true
9032, 1566722158023, 17887, 1566722158277, 18141, 254, true
9033, 1566722158023, 17887, 1566722158267, 18131, 244, true
9034, 1566722158023, 17887, 1566722158263, 18127, 240, true
9035, 1566722158023, 17887, 1566722158266, 18130, 243, true
9036, 1566722158024, 17888, 1566722158273, 18137, 249, true
9037, 1566722158024, 17888, 1566722158286, 18150, 262, true
9038, 1566722158025, 17889, 1566722158286, 18150, 261, true
9039, 1566722158026, 17890, 1566722158260, 18124, 234, true
9040, 1566722158026, 17890, 1566722158286, 18150, 260, true
9041, 1566722158026, 17890, 1566722158285, 18149, 259, true
9042, 1566722158026, 17890, 1566722158273, 18137, 247, true
9043, 1566722158026, 17890, 1566722158277, 18141, 251, true
9044, 1566722158027, 17891, 1566722158277, 18141, 250, true
9045, 1566722158027, 17891, 1566722158279, 18143, 252, true
9046, 1566722158027, 17891, 1566722158279, 18143, 252, true
9047, 1566722158028, 17892, 1566722158286, 18150, 258, true
9048, 1566722158028, 17892, 1566722158277, 18141, 249, true
9049, 1566722158028, 17892, 1566722158269, 18133, 241, true
9050, 1566722158028, 17892, 1566722158267, 18131, 239, true
9051, 1566722158029, 17893, 1566722158286, 18150, 257, true
9052, 1566722158029, 17893, 1566722158284, 18148, 255, true
9053, 1566722158029, 17893, 1566722158287, 18151, 258, true
9054, 1566722158029, 17893, 1566722158284, 18148, 255, true
9055, 1566722158030, 17894, 1566722158268, 18132, 238, true
9056, 1566722158030, 17894, 1566722158266, 18130, 236, true
9057, 1566722158030, 17894, 1566722158278, 18142, 248, true
9058, 1566722158030, 17894, 1566722158285, 18149, 255, true
9059, 1566722158031, 17895, 1566722158277, 18141, 246, true
9060, 1566722158031, 17895, 1566722158286, 18150, 255, true
9061, 1566722158032, 17896, 1566722158287, 18151, 255, true
9062, 1566722158032, 17896, 1566722158279, 18143, 247, true
9063, 1566722158032, 17896, 1566722158278, 18142, 246, true
9064, 1566722158033, 17897, 1566722158278, 18142, 245, true
9065, 1566722158033, 17897, 1566722158267, 18131, 234, true
9066, 1566722158033, 17897, 1566722158278, 18142, 245, true
9067, 1566722158034, 17898, 1566722158287, 18151, 253, true
9068, 1566722158034, 17898, 1566722158284, 18148, 250, true
9069, 1566722158034, 17898, 1566722158266, 18130, 232, true
9070, 1566722158035, 17899, 1566722158278, 18142, 243, true
9071, 1566722158035, 17899, 1566722158285, 18149, 250, true
9072, 1566722158035, 17899, 1566722158285, 18149, 250, true
9073, 1566722158035, 17899, 1566722158273, 18137, 238, true
9074, 1566722158036, 17900, 1566722158278, 18142, 242, true
9075, 1566722158036, 17900, 1566722158267, 18131, 231, true
9076, 1566722158036, 17900, 1566722158286, 18150, 250, true
9077, 1566722158036, 17900, 1566722158267, 18131, 231, true
9078, 1566722158037, 17901, 1566722158278, 18142, 241, true
9079, 1566722158037, 17901, 1566722158286, 18150, 249, true
9080, 1566722158037, 17901, 1566722158285, 18149, 248, true
9081, 1566722158037, 17901, 1566722158273, 18137, 236, true
9082, 1566722158038, 17902, 1566722158271, 18135, 233, true
9083, 1566722158038, 17902, 1566722158267, 18131, 229, true
9084, 1566722158038, 17902, 1566722158285, 18149, 247, true
9085, 1566722158038, 17902, 1566722158266, 18130, 228, true
9086, 1566722158039, 17903, 1566722158262, 18126, 223, true
9087, 1566722158039, 17903, 1566722158285, 18149, 246, true
9088, 1566722158058, 17922, 1566722158292, 18156, 234, true
9089, 1566722158062, 17926, 1566722158292, 18156, 230, true
9090, 1566722158062, 17926, 1566722158292, 18156, 230, true
9091, 1566722158063, 17927, 1566722158291, 18155, 228, true
9092, 1566722158068, 17932, 1566722158292, 18156, 224, true
9093, 1566722158085, 17949, 1566722158291, 18155, 206, true
9094, 1566722158086, 17950, 1566722158292, 18156, 206, true
9095, 1566722158088, 17952, 1566722158291, 18155, 203, true
9096, 1566722158089, 17953, 1566722158299, 18163, 210, true
9097, 1566722158089, 17953, 1566722158298, 18162, 209, true
9098, 1566722158090, 17954, 1566722158298, 18162, 208, true
9099, 1566722158090, 17954, 1566722158298, 18162, 208, true
9100, 1566722158091, 17955, 1566722158298, 18162, 207, true
9101, 1566722158096, 17960, 1566722158299, 18163, 203, true
9102, 1566722158096, 17960, 1566722158303, 18167, 207, true
9103, 1566722158097, 17961, 1566722158303, 18167, 206, true
9104, 1566722158098, 17962, 1566722158308, 18172, 210, true
9105, 1566722158100, 17964, 1566722158308, 18172, 208, true
9106, 1566722158101, 17965, 1566722158308, 18172, 207, true
9107, 1566722158102, 17966, 1566722158308, 18172, 206, true
9108, 1566722158103, 17967, 1566722158308, 18172, 205, true
9109, 1566722158104, 17968, 1566722158309, 18173, 205, true
9110, 1566722158106, 17970, 1566722158315, 18179, 209, true
9111, 1566722158109, 17973, 1566722158313, 18177, 204, true
9112, 1566722158110, 17974, 1566722158313, 18177, 203, true
9113, 1566722158110, 17974, 1566722158317, 18181, 207, true
9114, 1566722158110, 17974, 1566722158318, 18182, 208, true
9115, 1566722158111, 17975, 1566722158317, 18181, 206, true
9116, 1566722158115, 17979, 1566722158325, 18189, 210, true
9117, 1566722158116, 17980, 1566722158325, 18189, 209, true
9118, 1566722158117, 17981, 1566722158325, 18189, 208, true
9119, 1566722158118, 17982, 1566722158325, 18189, 207, true
9120, 1566722158120, 17984, 1566722158325, 18189, 205, true
9121, 1566722158122, 17986, 1566722158326, 18190, 204, true
9122, 1566722158124, 17988, 1566722158329, 18193, 205, true
9123, 1566722158126, 17990, 1566722158338, 18202, 212, true
9124, 1566722158128, 17992, 1566722158338, 18202, 210, true
9125, 1566722158129, 17993, 1566722158341, 18205, 212, true
9126, 1566722158131, 17995, 1566722158339, 18203, 208, true
9127, 1566722158132, 17996, 1566722158339, 18203, 207, true
9128, 1566722158133, 17997, 1566722158341, 18205, 208, true
9129, 1566722158134, 17998, 1566722158341, 18205, 207, true
9130, 1566722158135, 17999, 1566722158341, 18205, 206, true
9131, 1566722158136, 18000, 1566722158342, 18206, 206, true
9132, 1566722158137, 18001, 1566722158341, 18205, 204, true
9133, 1566722158137, 18001, 1566722158342, 18206, 205, true
9134, 1566722158139, 18003, 1566722158344, 18208, 205, true
9135, 1566722158140, 18004, 1566722158347, 18211, 207, true
9136, 1566722158140, 18004, 1566722158344, 18208, 204, true
9137, 1566722158141, 18005, 1566722158345, 18209, 204, true
9138, 1566722158142, 18006, 1566722158348, 18212, 206, true
9139, 1566722158142, 18006, 1566722158347, 18211, 205, true
9140, 1566722158144, 18008, 1566722158349, 18213, 205, true
9141, 1566722158145, 18009, 1566722158359, 18223, 214, true
9142, 1566722158155, 18019, 1566722158371, 18235, 216, true
9143, 1566722158156, 18020, 1566722158390, 18254, 234, true
9144, 1566722158156, 18020, 1566722158389, 18253, 233, true
9145, 1566722158157, 18021, 1566722158374, 18238, 217, true
9146, 1566722158159, 18023, 1566722158378, 18242, 219, true
9147, 1566722158190, 18054, 1566722158399, 18263, 209, true
9148, 1566722158190, 18054, 1566722158399, 18263, 209, true
9149, 1566722158191, 18055, 1566722158412, 18276, 221, true
9150, 1566722158191, 18055, 1566722158408, 18272, 217, true
9151, 1566722158201, 18065, 1566722158410, 18274, 209, true
9152, 1566722158201, 18065, 1566722158412, 18276, 211, true
9153, 1566722158203, 18067, 1566722158412, 18276, 209, true
9154, 1566722158204, 18068, 1566722158415, 18279, 211, true
9155, 1566722158208, 18072, 1566722158416, 18280, 208, true
9156, 1566722158212, 18076, 1566722158429, 18293, 217, true
9157, 1566722158213, 18077, 1566722158430, 18294, 217, true
9158, 1566722158213, 18077, 1566722158430, 18294, 217, true
9159, 1566722158213, 18077, 1566722158430, 18294, 217, true
9160, 1566722158216, 18080, 1566722158429, 18293, 213, true
9161, 1566722158217, 18081, 1566722158429, 18293, 212, true
9162, 1566722158219, 18083, 1566722158429, 18293, 210, true
9163, 1566722158221, 18085, 1566722158430, 18294, 209, true
9164, 1566722158221, 18085, 1566722158429, 18293, 208, true
9165, 1566722158222, 18086, 1566722158430, 18294, 208, true
9166, 1566722158223, 18087, 1566722158430, 18294, 207, true
9167, 1566722158223, 18087, 1566722158431, 18295, 208, true
9168, 1566722158224, 18088, 1566722158431, 18295, 207, true
9169, 1566722158226, 18090, 1566722158446, 18310, 220, true
9170, 1566722158227, 18091, 1566722158448, 18312, 221, true
9171, 1566722158228, 18092, 1566722158441, 18305, 213, true
9172, 1566722158228, 18092, 1566722158446, 18310, 218, true
9173, 1566722158229, 18093, 1566722158446, 18310, 217, true
9174, 1566722158229, 18093, 1566722158445, 18309, 216, true
9175, 1566722158230, 18094, 1566722158446, 18310, 216, true
9176, 1566722158231, 18095, 1566722158446, 18310, 215, true
9177, 1566722158234, 18098, 1566722158449, 18313, 215, true
9178, 1566722158235, 18099, 1566722158449, 18313, 214, true
9179, 1566722158236, 18100, 1566722158449, 18313, 213, true
9180, 1566722158237, 18101, 1566722158449, 18313, 212, true
9181, 1566722158239, 18103, 1566722158449, 18313, 210, true
9182, 1566722158240, 18104, 1566722158449, 18313, 209, true
9183, 1566722158240, 18104, 1566722158449, 18313, 209, true
9184, 1566722158241, 18105, 1566722158450, 18314, 209, true
9185, 1566722158241, 18105, 1566722158451, 18315, 210, true
9186, 1566722158243, 18107, 1566722158468, 18332, 225, true
9187, 1566722158244, 18108, 1566722158451, 18315, 207, true
9188, 1566722158352, 18216, 1566722158560, 18424, 208, true
9189, 1566722158353, 18217, 1566722158560, 18424, 207, true
9190, 1566722158354, 18218, 1566722158559, 18423, 205, true
9191, 1566722158356, 18220, 1566722158565, 18429, 209, true
9192, 1566722158357, 18221, 1566722158564, 18428, 207, true
9193, 1566722158359, 18223, 1566722158565, 18429, 206, true
9194, 1566722158360, 18224, 1566722158566, 18430, 206, true
9195, 1566722158362, 18226, 1566722158569, 18433, 207, true
9196, 1566722158366, 18230, 1566722158570, 18434, 204, true
9197, 1566722158368, 18232, 1566722158577, 18441, 209, true
9198, 1566722158370, 18234, 1566722158576, 18440, 206, true
9199, 1566722158371, 18235, 1566722158577, 18441, 206, true
9200, 1566722158373, 18237, 1566722158583, 18447, 210, true
9201, 1566722158375, 18239, 1566722158581, 18445, 206, true
9202, 1566722158376, 18240, 1566722158580, 18444, 204, true
9203, 1566722158379, 18243, 1566722158583, 18447, 204, true
9204, 1566722158380, 18244, 1566722158583, 18447, 203, true
9205, 1566722158382, 18246, 1566722158585, 18449, 203, true
9206, 1566722158383, 18247, 1566722158588, 18452, 205, true
9207, 1566722158385, 18249, 1566722158588, 18452, 203, true
9208, 1566722158387, 18251, 1566722158591, 18455, 204, true
9209, 1566722158390, 18254, 1566722158600, 18464, 210, true
9210, 1566722158392, 18256, 1566722158600, 18464, 208, true
9211, 1566722158394, 18258, 1566722158600, 18464, 206, true
9212, 1566722158395, 18259, 1566722158600, 18464, 205, true
9213, 1566722158397, 18261, 1566722158602, 18466, 205, true
9214, 1566722158401, 18265, 1566722158606, 18470, 205, true
9215, 1566722158402, 18266, 1566722158610, 18474, 208, true
9216, 1566722158404, 18268, 1566722158610, 18474, 206, true
9217, 1566722158405, 18269, 1566722158610, 18474, 205, true
9218, 1566722158409, 18273, 1566722158618, 18482, 209, true
9219, 1566722158417, 18281, 1566722158621, 18485, 204, true
9220, 1566722158417, 18281, 1566722158622, 18486, 205, true
9221, 1566722158417, 18281, 1566722158623, 18487, 206, true
9222, 1566722158417, 18281, 1566722158624, 18488, 207, true
9223, 1566722158418, 18282, 1566722158622, 18486, 204, true
9224, 1566722158419, 18283, 1566722158623, 18487, 204, true
9225, 1566722158420, 18284, 1566722158632, 18496, 212, true
9226, 1566722158422, 18286, 1566722158637, 18501, 215, true
9227, 1566722158423, 18287, 1566722158637, 18501, 214, true
9228, 1566722158424, 18288, 1566722158637, 18501, 213, true
9229, 1566722158425, 18289, 1566722158635, 18499, 210, true
9230, 1566722158426, 18290, 1566722158637, 18501, 211, true
9231, 1566722158432, 18296, 1566722158638, 18502, 206, true
9232, 1566722158432, 18296, 1566722158640, 18504, 208, true
9233, 1566722158432, 18296, 1566722158643, 18507, 211, true
9234, 1566722158432, 18296, 1566722158641, 18505, 209, true
9235, 1566722158433, 18297, 1566722158641, 18505, 208, true
9236, 1566722158434, 18298, 1566722158649, 18513, 215, true
9237, 1566722158434, 18298, 1566722158652, 18516, 218, true
9238, 1566722158435, 18299, 1566722158655, 18519, 220, true
9239, 1566722158436, 18300, 1566722158656, 18520, 220, true
9240, 1566722158437, 18301, 1566722158655, 18519, 218, true
9241, 1566722158438, 18302, 1566722158654, 18518, 216, true
9242, 1566722158438, 18302, 1566722158652, 18516, 214, true
9243, 1566722158439, 18303, 1566722158652, 18516, 213, true
9244, 1566722158440, 18304, 1566722158652, 18516, 212, true
9245, 1566722158441, 18305, 1566722158655, 18519, 214, true
9246, 1566722158452, 18316, 1566722158658, 18522, 206, true
9247, 1566722158452, 18316, 1566722158662, 18526, 210, true
9248, 1566722158452, 18316, 1566722158667, 18531, 215, true
9249, 1566722158452, 18316, 1566722158658, 18522, 206, true
9250, 1566722158453, 18317, 1566722158658, 18522, 205, true
9251, 1566722158453, 18317, 1566722158667, 18531, 214, true
9252, 1566722158456, 18320, 1566722158667, 18531, 211, true
9253, 1566722158457, 18321, 1566722158662, 18526, 205, true
9254, 1566722158458, 18322, 1566722158667, 18531, 209, true
9255, 1566722158459, 18323, 1566722158669, 18533, 210, true
9256, 1566722158459, 18323, 1566722158667, 18531, 208, true
9257, 1566722158460, 18324, 1566722158669, 18533, 209, true
9258, 1566722158462, 18326, 1566722158670, 18534, 208, true
9259, 1566722158463, 18327, 1566722158669, 18533, 206, true
9260, 1566722158464, 18328, 1566722158677, 18541, 213, true
9261, 1566722158464, 18328, 1566722158677, 18541, 213, true
9262, 1566722158465, 18329, 1566722158676, 18540, 211, true
9263, 1566722158465, 18329, 1566722158673, 18537, 208, true
9264, 1566722158466, 18330, 1566722158679, 18543, 213, true
9265, 1566722158468, 18332, 1566722158686, 18550, 218, true
9266, 1566722158470, 18334, 1566722158677, 18541, 207, true
9267, 1566722158471, 18335, 1566722158677, 18541, 206, true
9268, 1566722158471, 18335, 1566722158679, 18543, 208, true
9269, 1566722158472, 18336, 1566722158679, 18543, 207, true
9270, 1566722158473, 18337, 1566722158686, 18550, 213, true
9271, 1566722158473, 18337, 1566722158686, 18550, 213, true
9272, 1566722158476, 18340, 1566722158690, 18554, 214, true
9273, 1566722158476, 18340, 1566722158691, 18555, 215, true
9274, 1566722158477, 18341, 1566722158690, 18554, 213, true
9275, 1566722158477, 18341, 1566722158690, 18554, 213, true
9276, 1566722158477, 18341, 1566722158690, 18554, 213, true
9277, 1566722158478, 18342, 1566722158690, 18554, 212, true
9278, 1566722158479, 18343, 1566722158690, 18554, 211, true
9279, 1566722158479, 18343, 1566722158694, 18558, 215, true
9280, 1566722158480, 18344, 1566722158687, 18551, 207, true
9281, 1566722158480, 18344, 1566722158697, 18561, 217, true
9282, 1566722158481, 18345, 1566722158692, 18556, 211, true
9283, 1566722158481, 18345, 1566722158696, 18560, 215, true
9284, 1566722158482, 18346, 1566722158696, 18560, 214, true
9285, 1566722158483, 18347, 1566722158692, 18556, 209, true
9286, 1566722158483, 18347, 1566722158692, 18556, 209, true
9287, 1566722158484, 18348, 1566722158696, 18560, 212, true
9288, 1566722158484, 18348, 1566722158697, 18561, 213, true
9289, 1566722158484, 18348, 1566722158694, 18558, 210, true
9290, 1566722158485, 18349, 1566722158697, 18561, 212, true
9291, 1566722158490, 18354, 1566722158707, 18571, 217, true
9292, 1566722158490, 18354, 1566722158707, 18571, 217, true
9293, 1566722158491, 18355, 1566722158707, 18571, 216, true
9294, 1566722158491, 18355, 1566722158707, 18571, 216, true
9295, 1566722158492, 18356, 1566722158708, 18572, 216, true
9296, 1566722158493, 18357, 1566722158707, 18571, 214, true
9297, 1566722158494, 18358, 1566722158707, 18571, 213, true
9298, 1566722158494, 18358, 1566722158707, 18571, 213, true
9299, 1566722158497, 18361, 1566722158703, 18567, 206, true
9300, 1566722158498, 18362, 1566722158703, 18567, 205, true
9301, 1566722158499, 18363, 1566722158703, 18567, 204, true
9302, 1566722158500, 18364, 1566722158708, 18572, 208, true
9303, 1566722158501, 18365, 1566722158711, 18575, 210, true
9304, 1566722158502, 18366, 1566722158716, 18580, 214, true
9305, 1566722158503, 18367, 1566722158710, 18574, 207, true
9306, 1566722158504, 18368, 1566722158711, 18575, 207, true
9307, 1566722158504, 18368, 1566722158709, 18573, 205, true
9308, 1566722158506, 18370, 1566722158711, 18575, 205, true
9309, 1566722158506, 18370, 1566722158717, 18581, 211, true
9310, 1566722158506, 18370, 1566722158717, 18581, 211, true
9311, 1566722158507, 18371, 1566722158717, 18581, 210, true
9312, 1566722158508, 18372, 1566722158720, 18584, 212, true
9313, 1566722158510, 18374, 1566722158728, 18592, 218, true
9314, 1566722158510, 18374, 1566722158728, 18592, 218, true
9315, 1566722158510, 18374, 1566722158719, 18583, 209, true
9316, 1566722158511, 18375, 1566722158728, 18592, 217, true
9317, 1566722158512, 18376, 1566722158720, 18584, 208, true
9318, 1566722158513, 18377, 1566722158730, 18594, 217, true
9319, 1566722158514, 18378, 1566722158728, 18592, 214, true
9320, 1566722158515, 18379, 1566722158728, 18592, 213, true
9321, 1566722158520, 18384, 1566722158728, 18592, 208, true
9322, 1566722158521, 18385, 1566722158727, 18591, 206, true
9323, 1566722158522, 18386, 1566722158729, 18593, 207, true
9324, 1566722158523, 18387, 1566722158731, 18595, 208, true
9325, 1566722158524, 18388, 1566722158730, 18594, 206, true
9326, 1566722158524, 18388, 1566722158731, 18595, 207, true
9327, 1566722158524, 18388, 1566722158733, 18597, 209, true
9328, 1566722158527, 18391, 1566722158734, 18598, 207, true
9329, 1566722158528, 18392, 1566722158734, 18598, 206, true
9330, 1566722158528, 18392, 1566722158734, 18598, 206, true
9331, 1566722158530, 18394, 1566722158738, 18602, 208, true
9332, 1566722158531, 18395, 1566722158738, 18602, 207, true
9333, 1566722158532, 18396, 1566722158742, 18606, 210, true
9334, 1566722158532, 18396, 1566722158745, 18609, 213, true
9335, 1566722158533, 18397, 1566722158741, 18605, 208, true
9336, 1566722158534, 18398, 1566722158739, 18603, 205, true
9337, 1566722158535, 18399, 1566722158743, 18607, 208, true
9338, 1566722158536, 18400, 1566722158745, 18609, 209, true
9339, 1566722158536, 18400, 1566722158751, 18615, 215, true
9340, 1566722158536, 18400, 1566722158745, 18609, 209, true
9341, 1566722158537, 18401, 1566722158745, 18609, 208, true
9342, 1566722158538, 18402, 1566722158751, 18615, 213, true
9343, 1566722158539, 18403, 1566722158751, 18615, 212, true
9344, 1566722158542, 18406, 1566722158751, 18615, 209, true
9345, 1566722158543, 18407, 1566722158751, 18615, 208, true
9346, 1566722158544, 18408, 1566722158753, 18617, 209, true
9347, 1566722158545, 18409, 1566722158754, 18618, 209, true
9348, 1566722158545, 18409, 1566722158753, 18617, 208, true
9349, 1566722158545, 18409, 1566722158754, 18618, 209, true
9350, 1566722158547, 18411, 1566722158754, 18618, 207, true
9351, 1566722158548, 18412, 1566722158762, 18626, 214, true
9352, 1566722158548, 18412, 1566722158762, 18626, 214, true
9353, 1566722158550, 18414, 1566722158762, 18626, 212, true
9354, 1566722158551, 18415, 1566722158762, 18626, 211, true
9355, 1566722158553, 18417, 1566722158757, 18621, 204, true
9356, 1566722158554, 18418, 1566722158762, 18626, 208, true
9357, 1566722158554, 18418, 1566722158763, 18627, 209, true
9358, 1566722158560, 18424, 1566722158772, 18636, 212, true
9359, 1566722158560, 18424, 1566722158772, 18636, 212, true
9360, 1566722158561, 18425, 1566722158769, 18633, 208, true
9361, 1566722158562, 18426, 1566722158772, 18636, 210, true
9362, 1566722158566, 18430, 1566722158772, 18636, 206, true
9363, 1566722158567, 18431, 1566722158772, 18636, 205, true
9364, 1566722158567, 18431, 1566722158772, 18636, 205, true
9365, 1566722158569, 18433, 1566722158777, 18641, 208, true
9366, 1566722158570, 18434, 1566722158774, 18638, 204, true
9367, 1566722158571, 18435, 1566722158776, 18640, 205, true
9368, 1566722158572, 18436, 1566722158780, 18644, 208, true
9369, 1566722158572, 18436, 1566722158780, 18644, 208, true
9370, 1566722158574, 18438, 1566722158784, 18648, 210, true
9371, 1566722158575, 18439, 1566722158780, 18644, 205, true
9372, 1566722158577, 18441, 1566722158789, 18653, 212, true
9373, 1566722158577, 18441, 1566722158784, 18648, 207, true
9374, 1566722158578, 18442, 1566722158788, 18652, 210, true
9375, 1566722158578, 18442, 1566722158789, 18653, 211, true
9376, 1566722158584, 18448, 1566722158792, 18656, 208, true
9377, 1566722158586, 18450, 1566722158801, 18665, 215, true
9378, 1566722158587, 18451, 1566722158801, 18665, 214, true
9379, 1566722158592, 18456, 1566722158801, 18665, 209, true
9380, 1566722158593, 18457, 1566722158801, 18665, 208, true
9381, 1566722158593, 18457, 1566722158801, 18665, 208, true
9382, 1566722158594, 18458, 1566722158801, 18665, 207, true
9383, 1566722158595, 18459, 1566722158798, 18662, 203, true
9384, 1566722158595, 18459, 1566722158808, 18672, 213, true
9385, 1566722158596, 18460, 1566722158810, 18674, 214, true
9386, 1566722158602, 18466, 1566722158817, 18681, 215, true
9387, 1566722158603, 18467, 1566722158817, 18681, 214, true
9388, 1566722158603, 18467, 1566722158813, 18677, 210, true
9389, 1566722158603, 18467, 1566722158811, 18675, 208, true
9390, 1566722158604, 18468, 1566722158817, 18681, 213, true
9391, 1566722158604, 18468, 1566722158821, 18685, 217, true
9392, 1566722158607, 18471, 1566722158822, 18686, 215, true
9393, 1566722158607, 18471, 1566722158821, 18685, 214, true
9394, 1566722158610, 18474, 1566722158822, 18686, 212, true
9395, 1566722158611, 18475, 1566722158822, 18686, 211, true
9396, 1566722158612, 18476, 1566722158838, 18702, 226, true
9397, 1566722158612, 18476, 1566722158824, 18688, 212, true
9398, 1566722158614, 18478, 1566722158838, 18702, 224, true
9399, 1566722158615, 18479, 1566722158831, 18695, 216, true
9400, 1566722158616, 18480, 1566722158838, 18702, 222, true
9401, 1566722158618, 18482, 1566722158837, 18701, 219, true
9402, 1566722158619, 18483, 1566722158831, 18695, 212, true
9403, 1566722158620, 18484, 1566722158835, 18699, 215, true
9404, 1566722158628, 18492, 1566722158832, 18696, 204, true
9405, 1566722158632, 18496, 1566722158838, 18702, 206, true
9406, 1566722158633, 18497, 1566722158837, 18701, 204, true
9407, 1566722158633, 18497, 1566722158839, 18703, 206, true
9408, 1566722158634, 18498, 1566722158839, 18703, 205, true
9409, 1566722158638, 18502, 1566722158842, 18706, 204, true
9410, 1566722158640, 18504, 1566722158848, 18712, 208, true
9411, 1566722158644, 18508, 1566722158853, 18717, 209, true
9412, 1566722158647, 18511, 1566722158853, 18717, 206, true
9413, 1566722158647, 18511, 1566722158853, 18717, 206, true
9414, 1566722158649, 18513, 1566722158860, 18724, 211, true
9415, 1566722158649, 18513, 1566722158864, 18728, 215, true
9416, 1566722158650, 18514, 1566722158864, 18728, 214, true
9417, 1566722158658, 18522, 1566722158865, 18729, 207, true
9418, 1566722158660, 18524, 1566722158865, 18729, 205, true
9419, 1566722158663, 18527, 1566722158868, 18732, 205, true
9420, 1566722158663, 18527, 1566722158869, 18733, 206, true
9421, 1566722158664, 18528, 1566722158877, 18741, 213, true
9422, 1566722158673, 18537, 1566722158878, 18742, 205, true
9423, 1566722158674, 18538, 1566722158878, 18742, 204, true
9424, 1566722158674, 18538, 1566722158882, 18746, 208, true
9425, 1566722158674, 18538, 1566722158882, 18746, 208, true
9426, 1566722158682, 18546, 1566722158891, 18755, 209, true
9427, 1566722158682, 18546, 1566722158891, 18755, 209, true
9428, 1566722158683, 18547, 1566722158892, 18756, 209, true
9429, 1566722158685, 18549, 1566722158897, 18761, 212, true
9430, 1566722158701, 18565, 1566722158911, 18775, 210, true
9431, 1566722158714, 18578, 1566722158921, 18785, 207, true
9432, 1566722158714, 18578, 1566722158920, 18784, 206, true
9433, 1566722158721, 18585, 1566722158926, 18790, 205, true
9434, 1566722158721, 18585, 1566722158924, 18788, 203, true
9435, 1566722158721, 18585, 1566722158928, 18792, 207, true
9436, 1566722158722, 18586, 1566722158925, 18789, 203, true
9437, 1566722158723, 18587, 1566722158926, 18790, 203, true
9438, 1566722158723, 18587, 1566722158930, 18794, 207, true
9439, 1566722158724, 18588, 1566722158940, 18804, 216, true
9440, 1566722158725, 18589, 1566722158940, 18804, 215, true
9441, 1566722158739, 18603, 1566722158944, 18808, 205, true
9442, 1566722158743, 18607, 1566722158948, 18812, 205, true
9443, 1566722158746, 18610, 1566722158949, 18813, 203, true
9444, 1566722158747, 18611, 1566722158952, 18816, 205, true
9445, 1566722158757, 18621, 1566722158967, 18831, 210, true
9446, 1566722158759, 18623, 1566722158968, 18832, 209, true
9447, 1566722158764, 18628, 1566722158971, 18835, 207, true
9448, 1566722158764, 18628, 1566722158971, 18835, 207, true
9449, 1566722158766, 18630, 1566722158972, 18836, 206, true
9450, 1566722158767, 18631, 1566722158972, 18836, 205, true
9451, 1566722158767, 18631, 1566722158973, 18837, 206, true
9452, 1566722158768, 18632, 1566722158988, 18852, 220, true
9453, 1566722158769, 18633, 1566722158987, 18851, 218, true
9454, 1566722158774, 18638, 1566722158987, 18851, 213, true
9455, 1566722158774, 18638, 1566722158987, 18851, 213, true
9456, 1566722158776, 18640, 1566722158988, 18852, 212, true
9457, 1566722158776, 18640, 1566722158988, 18852, 212, true
9458, 1566722158778, 18642, 1566722158988, 18852, 210, true
9459, 1566722158778, 18642, 1566722158988, 18852, 210, true
9460, 1566722158778, 18642, 1566722158988, 18852, 210, true
9461, 1566722158781, 18645, 1566722158992, 18856, 211, true
9462, 1566722158781, 18645, 1566722158993, 18857, 212, true
9463, 1566722158784, 18648, 1566722158993, 18857, 209, true
9464, 1566722158784, 18648, 1566722158992, 18856, 208, true
9465, 1566722158785, 18649, 1566722158992, 18856, 207, true
9466, 1566722158785, 18649, 1566722158994, 18858, 209, true
9467, 1566722158786, 18650, 1566722158994, 18858, 208, true
9468, 1566722158787, 18651, 1566722158995, 18859, 208, true
9469, 1566722158790, 18654, 1566722158999, 18863, 209, true
9470, 1566722158791, 18655, 1566722158999, 18863, 208, true
9471, 1566722158791, 18655, 1566722158995, 18859, 204, true
9472, 1566722158794, 18658, 1566722159000, 18864, 206, true
9473, 1566722158794, 18658, 1566722159001, 18865, 207, true
9474, 1566722158796, 18660, 1566722159001, 18865, 205, true
9475, 1566722158802, 18666, 1566722159008, 18872, 206, true
9476, 1566722158802, 18666, 1566722159006, 18870, 204, true
9477, 1566722158805, 18669, 1566722159013, 18877, 208, true
9478, 1566722158806, 18670, 1566722159013, 18877, 207, true
9479, 1566722158806, 18670, 1566722159011, 18875, 205, true
9480, 1566722158807, 18671, 1566722159017, 18881, 210, true
9481, 1566722158811, 18675, 1566722159017, 18881, 206, true
9482, 1566722158812, 18676, 1566722159018, 18882, 206, true
9483, 1566722158812, 18676, 1566722159018, 18882, 206, true
9484, 1566722158815, 18679, 1566722159020, 18884, 205, true
9485, 1566722158815, 18679, 1566722159023, 18887, 208, true
9486, 1566722158819, 18683, 1566722159025, 18889, 206, true
9487, 1566722158825, 18689, 1566722159032, 18896, 207, true
9488, 1566722158825, 18689, 1566722159031, 18895, 206, true
9489, 1566722158826, 18690, 1566722159030, 18894, 204, true
9490, 1566722158826, 18690, 1566722159032, 18896, 206, true
9491, 1566722158829, 18693, 1566722159038, 18902, 209, true
9492, 1566722158829, 18693, 1566722159037, 18901, 208, true
9493, 1566722158833, 18697, 1566722159038, 18902, 205, true
9494, 1566722158833, 18697, 1566722159039, 18903, 206, true
9495, 1566722158833, 18697, 1566722159041, 18905, 208, true
9496, 1566722158840, 18704, 1566722159047, 18911, 207, true
9497, 1566722158841, 18705, 1566722159047, 18911, 206, true
9498, 1566722158842, 18706, 1566722159047, 18911, 205, true
9499, 1566722158842, 18706, 1566722159047, 18911, 205, true
9500, 1566722158844, 18708, 1566722159051, 18915, 207, true
9501, 1566722158844, 18708, 1566722159052, 18916, 208, true
9502, 1566722158845, 18709, 1566722159052, 18916, 207, true
9503, 1566722158848, 18712, 1566722159053, 18917, 205, true
9504, 1566722158849, 18713, 1566722159053, 18917, 204, true
9505, 1566722158851, 18715, 1566722159056, 18920, 205, true
9506, 1566722158854, 18718, 1566722159060, 18924, 206, true
9507, 1566722158855, 18719, 1566722159060, 18924, 205, true
9508, 1566722158855, 18719, 1566722159060, 18924, 205, true
9509, 1566722158856, 18720, 1566722159060, 18924, 204, true
9510, 1566722158858, 18722, 1566722159069, 18933, 211, true
9511, 1566722158865, 18729, 1566722159079, 18943, 214, true
9512, 1566722158866, 18730, 1566722159079, 18943, 213, true
9513, 1566722158866, 18730, 1566722159075, 18939, 209, true
9514, 1566722158866, 18730, 1566722159079, 18943, 213, true
9515, 1566722158870, 18734, 1566722159079, 18943, 209, true
9516, 1566722158871, 18735, 1566722159086, 18950, 215, true
9517, 1566722158871, 18735, 1566722159085, 18949, 214, true
9518, 1566722158871, 18735, 1566722159084, 18948, 213, true
9519, 1566722158874, 18738, 1566722159103, 18967, 229, true
9520, 1566722158875, 18739, 1566722159097, 18961, 222, true
9521, 1566722158880, 18744, 1566722159089, 18953, 209, true
9522, 1566722158882, 18746, 1566722159089, 18953, 207, true
9523, 1566722158883, 18747, 1566722159089, 18953, 206, true
9524, 1566722158884, 18748, 1566722159098, 18962, 214, true
9525, 1566722158886, 18750, 1566722159092, 18956, 206, true
9526, 1566722158887, 18751, 1566722159098, 18962, 211, true
9527, 1566722158889, 18753, 1566722159097, 18961, 208, true
9528, 1566722158892, 18756, 1566722159103, 18967, 211, true
9529, 1566722158894, 18758, 1566722159103, 18967, 209, true
9530, 1566722158895, 18759, 1566722159103, 18967, 208, true
9531, 1566722158898, 18762, 1566722159103, 18967, 205, true
9532, 1566722158899, 18763, 1566722159103, 18967, 204, true
9533, 1566722158901, 18765, 1566722159112, 18976, 211, true
9534, 1566722158901, 18765, 1566722159112, 18976, 211, true
9535, 1566722158902, 18766, 1566722159109, 18973, 207, true
9536, 1566722158902, 18766, 1566722159112, 18976, 210, true
9537, 1566722158903, 18767, 1566722159112, 18976, 209, true
9538, 1566722158904, 18768, 1566722159112, 18976, 208, true
9539, 1566722158905, 18769, 1566722159112, 18976, 207, true
9540, 1566722158906, 18770, 1566722159126, 18990, 220, true
9541, 1566722158906, 18770, 1566722159115, 18979, 209, true
9542, 1566722158906, 18770, 1566722159121, 18985, 215, true
9543, 1566722158907, 18771, 1566722159121, 18985, 214, true
9544, 1566722158908, 18772, 1566722159121, 18985, 213, true
9545, 1566722158909, 18773, 1566722159120, 18984, 211, true
9546, 1566722158910, 18774, 1566722159126, 18990, 216, true
9547, 1566722158912, 18776, 1566722159126, 18990, 214, true
9548, 1566722158915, 18779, 1566722159126, 18990, 211, true
9549, 1566722158915, 18779, 1566722159126, 18990, 211, true
9550, 1566722158915, 18779, 1566722159127, 18991, 212, true
9551, 1566722158916, 18780, 1566722159126, 18990, 210, true
9552, 1566722158916, 18780, 1566722159127, 18991, 211, true
9553, 1566722158918, 18782, 1566722159127, 18991, 209, true
9554, 1566722158919, 18783, 1566722159127, 18991, 208, true
9555, 1566722158923, 18787, 1566722159129, 18993, 206, true
9556, 1566722158927, 18791, 1566722159134, 18998, 207, true
9557, 1566722158927, 18791, 1566722159132, 18996, 205, true
9558, 1566722158927, 18791, 1566722159142, 19006, 215, true
9559, 1566722158928, 18792, 1566722159142, 19006, 214, true
9560, 1566722158930, 18794, 1566722159136, 19000, 206, true
9561, 1566722158931, 18795, 1566722159137, 19001, 206, true
9562, 1566722158931, 18795, 1566722159150, 19014, 219, true
9563, 1566722158931, 18795, 1566722159143, 19007, 212, true
9564, 1566722158932, 18796, 1566722159143, 19007, 211, true
9565, 1566722158934, 18798, 1566722159142, 19006, 208, true
9566, 1566722158935, 18799, 1566722159153, 19017, 218, true
9567, 1566722158937, 18801, 1566722159142, 19006, 205, true
9568, 1566722158937, 18801, 1566722159143, 19007, 206, true
9569, 1566722158938, 18802, 1566722159150, 19014, 212, true
9570, 1566722158940, 18804, 1566722159150, 19014, 210, true
9571, 1566722158942, 18806, 1566722159150, 19014, 208, true
9572, 1566722158942, 18806, 1566722159150, 19014, 208, true
9573, 1566722158943, 18807, 1566722159150, 19014, 207, true
9574, 1566722158945, 18809, 1566722159153, 19017, 208, true
9575, 1566722158947, 18811, 1566722159153, 19017, 206, true
9576, 1566722158949, 18813, 1566722159158, 19022, 209, true
9577, 1566722158950, 18814, 1566722159158, 19022, 208, true
9578, 1566722158951, 18815, 1566722159158, 19022, 207, true
9579, 1566722158953, 18817, 1566722159156, 19020, 203, true
9580, 1566722158956, 18820, 1566722159162, 19026, 206, true
9581, 1566722158957, 18821, 1566722159226, 19090, 269, true
9582, 1566722158959, 18823, 1566722159243, 19107, 284, true
9583, 1566722158961, 18825, 1566722159241, 19105, 280, true
9584, 1566722159003, 18867, 1566722159235, 19099, 232, true
9585, 1566722159004, 18868, 1566722159233, 19097, 229, true
9586, 1566722159006, 18870, 1566722159234, 19098, 228, true
9587, 1566722159008, 18872, 1566722159234, 19098, 226, true
9588, 1566722159011, 18875, 1566722159234, 19098, 223, true
9589, 1566722159013, 18877, 1566722159227, 19091, 214, true
9590, 1566722159014, 18878, 1566722159227, 19091, 213, true
9591, 1566722159021, 18885, 1566722159234, 19098, 213, true
9592, 1566722159023, 18887, 1566722159234, 19098, 211, true
9593, 1566722159023, 18887, 1566722159234, 19098, 211, true
9594, 1566722159025, 18889, 1566722159234, 19098, 209, true
9595, 1566722159025, 18889, 1566722159234, 19098, 209, true
9596, 1566722159026, 18890, 1566722159234, 19098, 208, true
9597, 1566722159026, 18890, 1566722159234, 19098, 208, true
9598, 1566722159027, 18891, 1566722159234, 19098, 207, true
9599, 1566722159027, 18891, 1566722159237, 19101, 210, true
9600, 1566722159028, 18892, 1566722159238, 19102, 210, true
9601, 1566722159028, 18892, 1566722159238, 19102, 210, true
9602, 1566722159028, 18892, 1566722159242, 19106, 214, true
9603, 1566722159033, 18897, 1566722159237, 19101, 204, true
9604, 1566722159034, 18898, 1566722159237, 19101, 203, true
9605, 1566722159034, 18898, 1566722159237, 19101, 203, true
9606, 1566722159034, 18898, 1566722159237, 19101, 203, true
9607, 1566722159040, 18904, 1566722159245, 19109, 205, true
9608, 1566722159041, 18905, 1566722159255, 19119, 214, true
9609, 1566722159041, 18905, 1566722159255, 19119, 214, true
9610, 1566722159042, 18906, 1566722159253, 19117, 211, true
9611, 1566722159043, 18907, 1566722159254, 19118, 211, true
9612, 1566722159043, 18907, 1566722159263, 19127, 220, true
9613, 1566722159044, 18908, 1566722159262, 19126, 218, true
9614, 1566722159045, 18909, 1566722159263, 19127, 218, true
9615, 1566722159047, 18911, 1566722159263, 19127, 216, true
9616, 1566722159048, 18912, 1566722159262, 19126, 214, true
9617, 1566722159048, 18912, 1566722159257, 19121, 209, true
9618, 1566722159049, 18913, 1566722159257, 19121, 208, true
9619, 1566722159049, 18913, 1566722159263, 19127, 214, true
9620, 1566722159049, 18913, 1566722159265, 19129, 216, true
9621, 1566722159049, 18913, 1566722159265, 19129, 216, true
9622, 1566722159054, 18918, 1566722159263, 19127, 209, true
9623, 1566722159054, 18918, 1566722159265, 19129, 211, true
9624, 1566722159056, 18920, 1566722159424, 19288, 368, true
9625, 1566722159057, 18921, 1566722159270, 19134, 213, true
9626, 1566722159058, 18922, 1566722159270, 19134, 212, true
9627, 1566722159061, 18925, 1566722159270, 19134, 209, true
9628, 1566722159062, 18926, 1566722159270, 19134, 208, true
9629, 1566722159062, 18926, 1566722159266, 19130, 204, true
9630, 1566722159064, 18928, 1566722159425, 19289, 361, true
9631, 1566722159064, 18928, 1566722159424, 19288, 360, true
9632, 1566722159064, 18928, 1566722159424, 19288, 360, true
9633, 1566722159064, 18928, 1566722159424, 19288, 360, true
9634, 1566722159065, 18929, 1566722159424, 19288, 359, true
9635, 1566722159065, 18929, 1566722159424, 19288, 359, true
9636, 1566722159065, 18929, 1566722159424, 19288, 359, true
9637, 1566722159067, 18931, 1566722159423, 19287, 356, true
9638, 1566722159068, 18932, 1566722159423, 19287, 355, true
9639, 1566722159069, 18933, 1566722159423, 19287, 354, true
9640, 1566722159070, 18934, 1566722159423, 19287, 353, true
9641, 1566722159072, 18936, 1566722159423, 19287, 351, true
9642, 1566722159073, 18937, 1566722159423, 19287, 350, true
9643, 1566722159073, 18937, 1566722159423, 19287, 350, true
9644, 1566722159074, 18938, 1566722159423, 19287, 349, true
9645, 1566722159075, 18939, 1566722159422, 19286, 347, true
9646, 1566722159075, 18939, 1566722159423, 19287, 348, true
9647, 1566722159076, 18940, 1566722159422, 19286, 346, true
9648, 1566722159078, 18942, 1566722159422, 19286, 344, true
9649, 1566722159079, 18943, 1566722159422, 19286, 343, true
9650, 1566722159080, 18944, 1566722159422, 19286, 342, true
9651, 1566722159084, 18948, 1566722159421, 19285, 337, true
9652, 1566722159086, 18950, 1566722159421, 19285, 335, true
9653, 1566722159087, 18951, 1566722159422, 19286, 335, true
9654, 1566722159087, 18951, 1566722159443, 19307, 356, true
9655, 1566722159087, 18951, 1566722159422, 19286, 335, true
9656, 1566722159087, 18951, 1566722159413, 19277, 326, true
9657, 1566722159087, 18951, 1566722159413, 19277, 326, true
9658, 1566722159089, 18953, 1566722159412, 19276, 323, true
9659, 1566722159090, 18954, 1566722159413, 19277, 323, true
9660, 1566722159090, 18954, 1566722159412, 19276, 322, true
9661, 1566722159090, 18954, 1566722159413, 19277, 323, true
9662, 1566722159091, 18955, 1566722159412, 19276, 321, true
9663, 1566722159094, 18958, 1566722159412, 19276, 318, true
9664, 1566722159094, 18958, 1566722159413, 19277, 319, true
9665, 1566722159094, 18958, 1566722159413, 19277, 319, true
9666, 1566722159094, 18958, 1566722159413, 19277, 319, true
9667, 1566722159095, 18959, 1566722159409, 19273, 314, true
9668, 1566722159098, 18962, 1566722159410, 19274, 312, true
9669, 1566722159099, 18963, 1566722159412, 19276, 313, true
9670, 1566722159099, 18963, 1566722159408, 19272, 309, true
9671, 1566722159100, 18964, 1566722159412, 19276, 312, true
9672, 1566722159100, 18964, 1566722159408, 19272, 308, true
9673, 1566722159100, 18964, 1566722159412, 19276, 312, true
9674, 1566722159101, 18965, 1566722159409, 19273, 308, true
9675, 1566722159106, 18970, 1566722159413, 19277, 307, true
9676, 1566722159107, 18971, 1566722159408, 19272, 301, true
9677, 1566722159107, 18971, 1566722159408, 19272, 301, true
9678, 1566722159107, 18971, 1566722159425, 19289, 318, true
9679, 1566722159108, 18972, 1566722159410, 19274, 302, true
9680, 1566722159108, 18972, 1566722159425, 19289, 317, true
9681, 1566722159109, 18973, 1566722159426, 19290, 317, true
9682, 1566722159112, 18976, 1566722159424, 19288, 312, true
9683, 1566722159113, 18977, 1566722159422, 19286, 309, true
9684, 1566722159113, 18977, 1566722159427, 19291, 314, true
9685, 1566722159115, 18979, 1566722159424, 19288, 309, true
9686, 1566722159117, 18981, 1566722159427, 19291, 310, true
9687, 1566722159118, 18982, 1566722159425, 19289, 307, true
9688, 1566722159118, 18982, 1566722159427, 19291, 309, true
9689, 1566722159121, 18985, 1566722159425, 19289, 304, true
9690, 1566722159122, 18986, 1566722159426, 19290, 304, true
9691, 1566722159122, 18986, 1566722159425, 19289, 303, true
9692, 1566722159123, 18987, 1566722159425, 19289, 302, true
9693, 1566722159123, 18987, 1566722159427, 19291, 304, true
9694, 1566722159123, 18987, 1566722159435, 19299, 312, true
9695, 1566722159130, 18994, 1566722159427, 19291, 297, true
9696, 1566722159131, 18995, 1566722159426, 19290, 295, true
9697, 1566722159131, 18995, 1566722159425, 19289, 294, true
9698, 1566722159131, 18995, 1566722159422, 19286, 291, true
9699, 1566722159131, 18995, 1566722159425, 19289, 294, true
9700, 1566722159132, 18996, 1566722159426, 19290, 294, true
9701, 1566722159132, 18996, 1566722159425, 19289, 293, true
9702, 1566722159133, 18997, 1566722159426, 19290, 293, true
9703, 1566722159133, 18997, 1566722159426, 19290, 293, true
9704, 1566722159133, 18997, 1566722159426, 19290, 293, true
9705, 1566722159135, 18999, 1566722159426, 19290, 291, true
9706, 1566722159137, 19001, 1566722159426, 19290, 289, true
9707, 1566722159160, 19024, 1566722159427, 19291, 267, true
9708, 1566722159161, 19025, 1566722159427, 19291, 266, true
9709, 1566722159162, 19026, 1566722159427, 19291, 265, true
9710, 1566722159163, 19027, 1566722159427, 19291, 264, true
9711, 1566722159163, 19027, 1566722159427, 19291, 264, true
9712, 1566722159164, 19028, 1566722159428, 19292, 264, true
9713, 1566722159165, 19029, 1566722159428, 19292, 263, true
9714, 1566722159165, 19029, 1566722159517, 19381, 352, true
9715, 1566722159166, 19030, 1566722159554, 19418, 388, true
9716, 1566722159168, 19032, 1566722159554, 19418, 386, true
9717, 1566722159169, 19033, 1566722159555, 19419, 386, true
9718, 1566722159169, 19033, 1566722159554, 19418, 385, true
9719, 1566722159170, 19034, 1566722159554, 19418, 384, true
9720, 1566722159171, 19035, 1566722159554, 19418, 383, true
9721, 1566722159171, 19035, 1566722159554, 19418, 383, true
9722, 1566722159172, 19036, 1566722159555, 19419, 383, true
9723, 1566722159178, 19042, 1566722159555, 19419, 377, true
9724, 1566722159183, 19047, 1566722159554, 19418, 371, true
9725, 1566722159184, 19048, 1566722159555, 19419, 371, true
9726, 1566722159216, 19080, 1566722159555, 19419, 339, true
9727, 1566722159217, 19081, 1566722159554, 19418, 337, true
9728, 1566722159218, 19082, 1566722159554, 19418, 336, true
9729, 1566722159218, 19082, 1566722159554, 19418, 336, true
9730, 1566722159219, 19083, 1566722159554, 19418, 335, true
9731, 1566722159220, 19084, 1566722159554, 19418, 334, true
9732, 1566722159220, 19084, 1566722159554, 19418, 334, true
9733, 1566722159220, 19084, 1566722159554, 19418, 334, true
9734, 1566722159221, 19085, 1566722159554, 19418, 333, true
9735, 1566722159221, 19085, 1566722159554, 19418, 333, true
9736, 1566722159221, 19085, 1566722159554, 19418, 333, true
9737, 1566722159222, 19086, 1566722159554, 19418, 332, true
9738, 1566722159222, 19086, 1566722159553, 19417, 331, true
9739, 1566722159222, 19086, 1566722159555, 19419, 333, true
9740, 1566722159223, 19087, 1566722159555, 19419, 332, true
9741, 1566722159224, 19088, 1566722159554, 19418, 330, true
9742, 1566722159225, 19089, 1566722159555, 19419, 330, true
9743, 1566722159239, 19103, 1566722159554, 19418, 315, true
9744, 1566722159245, 19109, 1566722159553, 19417, 308, true
9745, 1566722159246, 19110, 1566722159555, 19419, 309, true
9746, 1566722159249, 19113, 1566722159555, 19419, 306, true
9747, 1566722159250, 19114, 1566722159555, 19419, 305, true
9748, 1566722159250, 19114, 1566722159555, 19419, 305, true
9749, 1566722159251, 19115, 1566722159555, 19419, 304, true
9750, 1566722159252, 19116, 1566722159555, 19419, 303, true
9751, 1566722159258, 19122, 1566722159555, 19419, 297, true
9752, 1566722159274, 19138, 1566722159555, 19419, 281, true
9753, 1566722159277, 19141, 1566722159555, 19419, 278, true
9754, 1566722159281, 19145, 1566722159555, 19419, 274, true
9755, 1566722159281, 19145, 1566722159555, 19419, 274, true
9756, 1566722159283, 19147, 1566722159555, 19419, 272, true
9757, 1566722159283, 19147, 1566722159557, 19421, 274, true
9758, 1566722159283, 19147, 1566722159556, 19420, 273, true
9759, 1566722159284, 19148, 1566722159538, 19402, 254, true
9760, 1566722159284, 19148, 1566722159538, 19402, 254, true
9761, 1566722159284, 19148, 1566722159540, 19404, 256, true
9762, 1566722159285, 19149, 1566722159539, 19403, 254, true
9763, 1566722159285, 19149, 1566722159538, 19402, 253, true
9764, 1566722159287, 19151, 1566722159538, 19402, 251, true
9765, 1566722159289, 19153, 1566722159538, 19402, 249, true
9766, 1566722159289, 19153, 1566722159538, 19402, 249, true
9767, 1566722159290, 19154, 1566722159537, 19401, 247, true
9768, 1566722159291, 19155, 1566722159538, 19402, 247, true
9769, 1566722159292, 19156, 1566722159538, 19402, 246, true
9770, 1566722159293, 19157, 1566722159538, 19402, 245, true
9771, 1566722159293, 19157, 1566722159538, 19402, 245, true
9772, 1566722159295, 19159, 1566722159537, 19401, 242, true
9773, 1566722159295, 19159, 1566722159535, 19399, 240, true
9774, 1566722159295, 19159, 1566722159535, 19399, 240, true
9775, 1566722159296, 19160, 1566722159537, 19401, 241, true
9776, 1566722159297, 19161, 1566722159534, 19398, 237, true
9777, 1566722159298, 19162, 1566722159535, 19399, 237, true
9778, 1566722159298, 19162, 1566722159535, 19399, 237, true
9779, 1566722159299, 19163, 1566722159535, 19399, 236, true
9780, 1566722159300, 19164, 1566722159535, 19399, 235, true
9781, 1566722159301, 19165, 1566722159535, 19399, 234, true
9782, 1566722159303, 19167, 1566722159535, 19399, 232, true
9783, 1566722159303, 19167, 1566722159530, 19394, 227, true
9784, 1566722159304, 19168, 1566722159530, 19394, 226, true
9785, 1566722159305, 19169, 1566722159553, 19417, 248, true
9786, 1566722159306, 19170, 1566722159553, 19417, 247, true
9787, 1566722159306, 19170, 1566722159553, 19417, 247, true
9788, 1566722159306, 19170, 1566722159553, 19417, 247, true
9789, 1566722159307, 19171, 1566722159553, 19417, 246, true
9790, 1566722159308, 19172, 1566722159553, 19417, 245, true
9791, 1566722159309, 19173, 1566722159553, 19417, 244, true
9792, 1566722159309, 19173, 1566722159553, 19417, 244, true
9793, 1566722159309, 19173, 1566722159553, 19417, 244, true
9794, 1566722159310, 19174, 1566722159553, 19417, 243, true
9795, 1566722159310, 19174, 1566722159553, 19417, 243, true
9796, 1566722159312, 19176, 1566722159553, 19417, 241, true
9797, 1566722159313, 19177, 1566722159553, 19417, 240, true
9798, 1566722159314, 19178, 1566722159553, 19417, 239, true
9799, 1566722159316, 19180, 1566722159553, 19417, 237, true
9800, 1566722159317, 19181, 1566722159534, 19398, 217, true
9801, 1566722159443, 19307, 1566722159654, 19518, 211, true
9802, 1566722159454, 19318, 1566722159657, 19521, 203, true
9803, 1566722159454, 19318, 1566722159657, 19521, 203, true
9804, 1566722159455, 19319, 1566722159658, 19522, 203, true
9805, 1566722159455, 19319, 1566722159659, 19523, 204, true
9806, 1566722159456, 19320, 1566722159659, 19523, 203, true
9807, 1566722159456, 19320, 1566722159662, 19526, 206, true
9808, 1566722159457, 19321, 1566722159662, 19526, 205, true
9809, 1566722159458, 19322, 1566722159662, 19526, 204, true
9810, 1566722159459, 19323, 1566722159662, 19526, 203, true
9811, 1566722159460, 19324, 1566722159663, 19527, 203, true
9812, 1566722159461, 19325, 1566722159667, 19531, 206, true
9813, 1566722159461, 19325, 1566722159677, 19541, 216, true
9814, 1566722159462, 19326, 1566722159677, 19541, 215, true
9815, 1566722159462, 19326, 1566722159668, 19532, 206, true
9816, 1566722159462, 19326, 1566722159676, 19540, 214, true
9817, 1566722159465, 19329, 1566722159677, 19541, 212, true
9818, 1566722159465, 19329, 1566722159692, 19556, 227, true
9819, 1566722159465, 19329, 1566722159690, 19554, 225, true
9820, 1566722159466, 19330, 1566722159697, 19561, 231, true
9821, 1566722159466, 19330, 1566722159697, 19561, 231, true
9822, 1566722159467, 19331, 1566722159697, 19561, 230, true
9823, 1566722159468, 19332, 1566722159697, 19561, 229, true
9824, 1566722159469, 19333, 1566722159697, 19561, 228, true
9825, 1566722159470, 19334, 1566722159697, 19561, 227, true
9826, 1566722159471, 19335, 1566722159693, 19557, 222, true
9827, 1566722159472, 19336, 1566722159697, 19561, 225, true
9828, 1566722159473, 19337, 1566722159697, 19561, 224, true
9829, 1566722159473, 19337, 1566722159697, 19561, 224, true
9830, 1566722159474, 19338, 1566722159698, 19562, 224, true
9831, 1566722159475, 19339, 1566722159698, 19562, 223, true
9832, 1566722159476, 19340, 1566722159698, 19562, 222, true
9833, 1566722159477, 19341, 1566722159698, 19562, 221, true
9834, 1566722159477, 19341, 1566722159698, 19562, 221, true
9835, 1566722159477, 19341, 1566722159698, 19562, 221, true
9836, 1566722159478, 19342, 1566722159698, 19562, 220, true
9837, 1566722159478, 19342, 1566722159698, 19562, 220, true
9838, 1566722159479, 19343, 1566722159698, 19562, 219, true
9839, 1566722159481, 19345, 1566722159699, 19563, 218, true
9840, 1566722159481, 19345, 1566722159698, 19562, 217, true
9841, 1566722159482, 19346, 1566722159701, 19565, 219, true
9842, 1566722159482, 19346, 1566722159709, 19573, 227, true
9843, 1566722159483, 19347, 1566722159713, 19577, 230, true
9844, 1566722159483, 19347, 1566722159710, 19574, 227, true
9845, 1566722159484, 19348, 1566722159710, 19574, 226, true
9846, 1566722159484, 19348, 1566722159715, 19579, 231, true
9847, 1566722159485, 19349, 1566722159710, 19574, 225, true
9848, 1566722159485, 19349, 1566722159710, 19574, 225, true
9849, 1566722159485, 19349, 1566722159709, 19573, 224, true
9850, 1566722159486, 19350, 1566722159710, 19574, 224, true
9851, 1566722159486, 19350, 1566722159710, 19574, 224, true
9852, 1566722159486, 19350, 1566722159710, 19574, 224, true
9853, 1566722159487, 19351, 1566722159710, 19574, 223, true
9854, 1566722159487, 19351, 1566722159701, 19565, 214, true
9855, 1566722159487, 19351, 1566722159716, 19580, 229, true
9856, 1566722159488, 19352, 1566722159710, 19574, 222, true
9857, 1566722159488, 19352, 1566722159710, 19574, 222, true
9858, 1566722159488, 19352, 1566722159701, 19565, 213, true
9859, 1566722159489, 19353, 1566722159710, 19574, 221, true
9860, 1566722159489, 19353, 1566722159710, 19574, 221, true
9861, 1566722159489, 19353, 1566722159715, 19579, 226, true
9862, 1566722159489, 19353, 1566722159715, 19579, 226, true
9863, 1566722159490, 19354, 1566722159710, 19574, 220, true
9864, 1566722159490, 19354, 1566722159710, 19574, 220, true
9865, 1566722159490, 19354, 1566722159709, 19573, 219, true
9866, 1566722159491, 19355, 1566722159710, 19574, 219, true
9867, 1566722159491, 19355, 1566722159710, 19574, 219, true
9868, 1566722159491, 19355, 1566722159709, 19573, 218, true
9869, 1566722159492, 19356, 1566722159710, 19574, 218, true
9870, 1566722159492, 19356, 1566722159712, 19576, 220, true
9871, 1566722159493, 19357, 1566722159716, 19580, 223, true
9872, 1566722159494, 19358, 1566722159710, 19574, 216, true
9873, 1566722159494, 19358, 1566722159713, 19577, 219, true
9874, 1566722159495, 19359, 1566722159715, 19579, 220, true
9875, 1566722159496, 19360, 1566722159715, 19579, 219, true
9876, 1566722159498, 19362, 1566722159713, 19577, 215, true
9877, 1566722159499, 19363, 1566722159710, 19574, 211, true
9878, 1566722159500, 19364, 1566722159713, 19577, 213, true
9879, 1566722159501, 19365, 1566722159715, 19579, 214, true
9880, 1566722159507, 19371, 1566722159717, 19581, 210, true
9881, 1566722159507, 19371, 1566722159716, 19580, 209, true
9882, 1566722159507, 19371, 1566722159718, 19582, 211, true
9883, 1566722159508, 19372, 1566722159723, 19587, 215, true
9884, 1566722159509, 19373, 1566722159723, 19587, 214, true
9885, 1566722159509, 19373, 1566722159723, 19587, 214, true
9886, 1566722159509, 19373, 1566722159722, 19586, 213, true
9887, 1566722159510, 19374, 1566722159723, 19587, 213, true
9888, 1566722159510, 19374, 1566722159723, 19587, 213, true
9889, 1566722159511, 19375, 1566722159723, 19587, 212, true
9890, 1566722159513, 19377, 1566722159723, 19587, 210, true
9891, 1566722159514, 19378, 1566722159722, 19586, 208, true
9892, 1566722159515, 19379, 1566722159723, 19587, 208, true
9893, 1566722159516, 19380, 1566722159724, 19588, 208, true
9894, 1566722159517, 19381, 1566722159723, 19587, 206, true
9895, 1566722159518, 19382, 1566722159724, 19588, 206, true
9896, 1566722159519, 19383, 1566722159724, 19588, 205, true
9897, 1566722159519, 19383, 1566722159724, 19588, 205, true
9898, 1566722159520, 19384, 1566722159728, 19592, 208, true
9899, 1566722159521, 19385, 1566722159729, 19593, 208, true
9900, 1566722159522, 19386, 1566722159728, 19592, 206, true
9901, 1566722159522, 19386, 1566722159729, 19593, 207, true
9902, 1566722159523, 19387, 1566722159763, 19627, 240, true
9903, 1566722159523, 19387, 1566722159763, 19627, 240, true
9904, 1566722159524, 19388, 1566722159763, 19627, 239, true
9905, 1566722159524, 19388, 1566722159763, 19627, 239, true
9906, 1566722159524, 19388, 1566722159732, 19596, 208, true
9907, 1566722159524, 19388, 1566722159763, 19627, 239, true
9908, 1566722159525, 19389, 1566722159763, 19627, 238, true
9909, 1566722159526, 19390, 1566722159763, 19627, 237, true
9910, 1566722159526, 19390, 1566722159763, 19627, 237, true
9911, 1566722159527, 19391, 1566722159764, 19628, 237, true
9912, 1566722159528, 19392, 1566722159769, 19633, 241, true
9913, 1566722159593, 19457, 1566722159802, 19666, 209, true
9914, 1566722159616, 19480, 1566722159826, 19690, 210, true
9915, 1566722159619, 19483, 1566722159826, 19690, 207, true
9916, 1566722159621, 19485, 1566722159826, 19690, 205, true
9917, 1566722159623, 19487, 1566722159826, 19690, 203, true
9918, 1566722159624, 19488, 1566722159829, 19693, 205, true
9919, 1566722159625, 19489, 1566722159829, 19693, 204, true
9920, 1566722159626, 19490, 1566722159829, 19693, 203, true
9921, 1566722159631, 19495, 1566722159837, 19701, 206, true
9922, 1566722159632, 19496, 1566722159837, 19701, 205, true
9923, 1566722159634, 19498, 1566722159837, 19701, 203, true
9924, 1566722159636, 19500, 1566722159841, 19705, 205, true
9925, 1566722159636, 19500, 1566722159840, 19704, 204, true
9926, 1566722159638, 19502, 1566722159843, 19707, 205, true
9927, 1566722159639, 19503, 1566722159844, 19708, 205, true
9928, 1566722159640, 19504, 1566722159843, 19707, 203, true
9929, 1566722159641, 19505, 1566722159851, 19715, 210, true
9930, 1566722159643, 19507, 1566722159851, 19715, 208, true
9931, 1566722159645, 19509, 1566722159853, 19717, 208, true
9932, 1566722159647, 19511, 1566722159853, 19717, 206, true
9933, 1566722159649, 19513, 1566722159853, 19717, 204, true
9934, 1566722159651, 19515, 1566722159856, 19720, 205, true
9935, 1566722159654, 19518, 1566722159860, 19724, 206, true
9936, 1566722159655, 19519, 1566722159863, 19727, 208, true
9937, 1566722159664, 19528, 1566722159869, 19733, 205, true
9938, 1566722159689, 19553, 1566722159940, 19804, 251, true
9939, 1566722159725, 19589, 1566722159940, 19804, 215, true
9940, 1566722159740, 19604, 1566722159945, 19809, 205, true
9941, 1566722159740, 19604, 1566722159945, 19809, 205, true
9942, 1566722159741, 19605, 1566722159945, 19809, 204, true
9943, 1566722159741, 19605, 1566722159951, 19815, 210, true
9944, 1566722159741, 19605, 1566722159950, 19814, 209, true
9945, 1566722159743, 19607, 1566722159950, 19814, 207, true
9946, 1566722159743, 19607, 1566722159951, 19815, 208, true
9947, 1566722159744, 19608, 1566722159948, 19812, 204, true
9948, 1566722159744, 19608, 1566722159954, 19818, 210, true
9949, 1566722159744, 19608, 1566722159951, 19815, 207, true
9950, 1566722159745, 19609, 1566722159951, 19815, 206, true
9951, 1566722159745, 19609, 1566722159952, 19816, 207, true
9952, 1566722159746, 19610, 1566722159954, 19818, 208, true
9953, 1566722159747, 19611, 1566722159954, 19818, 207, true
9954, 1566722159749, 19613, 1566722159954, 19818, 205, true
9955, 1566722159750, 19614, 1566722159954, 19818, 204, true
9956, 1566722159752, 19616, 1566722159957, 19821, 205, true
9957, 1566722159752, 19616, 1566722159957, 19821, 205, true
9958, 1566722159752, 19616, 1566722159957, 19821, 205, true
9959, 1566722159753, 19617, 1566722159957, 19821, 204, true
9960, 1566722159754, 19618, 1566722159959, 19823, 205, true
9961, 1566722159755, 19619, 1566722159964, 19828, 209, true
9962, 1566722159756, 19620, 1566722159964, 19828, 208, true
9963, 1566722159757, 19621, 1566722159964, 19828, 207, true
9964, 1566722159758, 19622, 1566722159964, 19828, 206, true
9965, 1566722159758, 19622, 1566722159968, 19832, 210, true
9966, 1566722159758, 19622, 1566722159968, 19832, 210, true
9967, 1566722159765, 19629, 1566722159968, 19832, 203, true
9968, 1566722159766, 19630, 1566722159970, 19834, 204, true
9969, 1566722159766, 19630, 1566722159969, 19833, 203, true
9970, 1566722159767, 19631, 1566722159973, 19837, 206, true
9971, 1566722159767, 19631, 1566722159972, 19836, 205, true
9972, 1566722159768, 19632, 1566722159972, 19836, 204, true
9973, 1566722159770, 19634, 1566722159974, 19838, 204, true
9974, 1566722159770, 19634, 1566722159974, 19838, 204, true
9975, 1566722159771, 19635, 1566722159975, 19839, 204, true
9976, 1566722159772, 19636, 1566722159979, 19843, 207, true
9977, 1566722159773, 19637, 1566722159979, 19843, 206, true
9978, 1566722159773, 19637, 1566722159979, 19843, 206, true
9979, 1566722159773, 19637, 1566722159979, 19843, 206, true
9980, 1566722159774, 19638, 1566722159988, 19852, 214, true
9981, 1566722159774, 19638, 1566722159989, 19853, 215, true
9982, 1566722159775, 19639, 1566722159989, 19853, 214, true
9983, 1566722159776, 19640, 1566722159989, 19853, 213, true
9984, 1566722159776, 19640, 1566722159991, 19855, 215, true
9985, 1566722159777, 19641, 1566722159989, 19853, 212, true
9986, 1566722159777, 19641, 1566722159989, 19853, 212, true
9987, 1566722159778, 19642, 1566722159990, 19854, 212, true
9988, 1566722159778, 19642, 1566722159990, 19854, 212, true
9989, 1566722159778, 19642, 1566722159989, 19853, 211, true
9990, 1566722159778, 19642, 1566722159990, 19854, 212, true
9991, 1566722159779, 19643, 1566722159989, 19853, 210, true
9992, 1566722159779, 19643, 1566722159990, 19854, 211, true
9993, 1566722159781, 19645, 1566722159990, 19854, 209, true
9994, 1566722159784, 19648, 1566722159991, 19855, 207, true
9995, 1566722159784, 19648, 1566722159991, 19855, 207, true
9996, 1566722159785, 19649, 1566722159991, 19855, 206, true
9997, 1566722159786, 19650, 1566722159991, 19855, 205, true
9998, 1566722159787, 19651, 1566722159994, 19858, 207, true
9999, 1566722159787, 19651, 1566722159994, 19858, 207, true
10000, 1566722159788, 19652, 1566722160001, 19865, 213, true
10001, 1566722159789, 19653, 1566722160001, 19865, 212, true
10002, 1566722159790, 19654, 1566722160003, 19867, 213, true
10003, 1566722159790, 19654, 1566722160001, 19865, 211, true
10004, 1566722159790, 19654, 1566722159998, 19862, 208, true
10005, 1566722159791, 19655, 1566722159996, 19860, 205, true
10006, 1566722159791, 19655, 1566722160004, 19868, 213, true
10007, 1566722159791, 19655, 1566722160006, 19870, 215, true
10008, 1566722159792, 19656, 1566722160019, 19883, 227, true
10009, 1566722159792, 19656, 1566722160019, 19883, 227, true
10010, 1566722159793, 19657, 1566722160012, 19876, 219, true
10011, 1566722159794, 19658, 1566722160019, 19883, 225, true
10012, 1566722159794, 19658, 1566722160012, 19876, 218, true
10013, 1566722159795, 19659, 1566722160006, 19870, 211, true
10014, 1566722159796, 19660, 1566722160018, 19882, 222, true
10015, 1566722159796, 19660, 1566722160019, 19883, 223, true
10016, 1566722159797, 19661, 1566722160019, 19883, 222, true
10017, 1566722159797, 19661, 1566722160006, 19870, 209, true
10018, 1566722159798, 19662, 1566722160019, 19883, 221, true
10019, 1566722159798, 19662, 1566722160004, 19868, 206, true
10020, 1566722159798, 19662, 1566722160019, 19883, 221, true
10021, 1566722159799, 19663, 1566722160019, 19883, 220, true
10022, 1566722159800, 19664, 1566722160020, 19884, 220, true
10023, 1566722159801, 19665, 1566722160019, 19883, 218, true
10024, 1566722159802, 19666, 1566722160020, 19884, 218, true
10025, 1566722159802, 19666, 1566722160020, 19884, 218, true
10026, 1566722159803, 19667, 1566722160024, 19888, 221, true
10027, 1566722159804, 19668, 1566722160019, 19883, 215, true
10028, 1566722159804, 19668, 1566722160019, 19883, 215, true
10029, 1566722159805, 19669, 1566722160020, 19884, 215, true
10030, 1566722159805, 19669, 1566722160020, 19884, 215, true
10031, 1566722159806, 19670, 1566722160019, 19883, 213, true
10032, 1566722159806, 19670, 1566722160020, 19884, 214, true
10033, 1566722159807, 19671, 1566722160019, 19883, 212, true
10034, 1566722159808, 19672, 1566722160019, 19883, 211, true
10035, 1566722159809, 19673, 1566722160025, 19889, 216, true
10036, 1566722159812, 19676, 1566722160024, 19888, 212, true
10037, 1566722159814, 19678, 1566722160026, 19890, 212, true
10038, 1566722159815, 19679, 1566722160026, 19890, 211, true
10039, 1566722159816, 19680, 1566722160026, 19890, 210, true
10040, 1566722159816, 19680, 1566722160026, 19890, 210, true
10041, 1566722159818, 19682, 1566722160026, 19890, 208, true
10042, 1566722159819, 19683, 1566722160031, 19895, 212, true
10043, 1566722159820, 19684, 1566722160031, 19895, 211, true
10044, 1566722159820, 19684, 1566722160027, 19891, 207, true
10045, 1566722159821, 19685, 1566722160031, 19895, 210, true
10046, 1566722159821, 19685, 1566722160032, 19896, 211, true
10047, 1566722159822, 19686, 1566722160031, 19895, 209, true
10048, 1566722159823, 19687, 1566722160031, 19895, 208, true
10049, 1566722159823, 19687, 1566722160031, 19895, 208, true
10050, 1566722159823, 19687, 1566722160032, 19896, 209, true
10051, 1566722159824, 19688, 1566722160033, 19897, 209, true
10052, 1566722159827, 19691, 1566722160033, 19897, 206, true
10053, 1566722159830, 19694, 1566722160035, 19899, 205, true
10054, 1566722159831, 19695, 1566722160036, 19900, 205, true
10055, 1566722159831, 19695, 1566722160035, 19899, 204, true
10056, 1566722159831, 19695, 1566722160035, 19899, 204, true
10057, 1566722159831, 19695, 1566722160042, 19906, 211, true
10058, 1566722159832, 19696, 1566722160041, 19905, 209, true
10059, 1566722159832, 19696, 1566722160041, 19905, 209, true
10060, 1566722159833, 19697, 1566722160041, 19905, 208, true
10061, 1566722159834, 19698, 1566722160045, 19909, 211, true
10062, 1566722159835, 19699, 1566722160042, 19906, 207, true
10063, 1566722159838, 19702, 1566722160044, 19908, 206, true
10064, 1566722159838, 19702, 1566722160047, 19911, 209, true
10065, 1566722159841, 19705, 1566722160047, 19911, 206, true
10066, 1566722159844, 19708, 1566722160060, 19924, 216, true
10067, 1566722159845, 19709, 1566722160059, 19923, 214, true
10068, 1566722159845, 19709, 1566722160056, 19920, 211, true
10069, 1566722159846, 19710, 1566722160059, 19923, 213, true
10070, 1566722159846, 19710, 1566722160061, 19925, 215, true
10071, 1566722159847, 19711, 1566722160061, 19925, 214, true
10072, 1566722159848, 19712, 1566722160061, 19925, 213, true
10073, 1566722159849, 19713, 1566722160062, 19926, 213, true
10074, 1566722159857, 19721, 1566722160065, 19929, 208, true
10075, 1566722159857, 19721, 1566722160065, 19929, 208, true
10076, 1566722159858, 19722, 1566722160065, 19929, 207, true
10077, 1566722159858, 19722, 1566722160065, 19929, 207, true
10078, 1566722159858, 19722, 1566722160065, 19929, 207, true
10079, 1566722159861, 19725, 1566722160065, 19929, 204, true
10080, 1566722159861, 19725, 1566722160069, 19933, 208, true
10081, 1566722159861, 19725, 1566722160065, 19929, 204, true
10082, 1566722159863, 19727, 1566722160067, 19931, 204, true
10083, 1566722159864, 19728, 1566722160071, 19935, 207, true
10084, 1566722159865, 19729, 1566722160071, 19935, 206, true
10085, 1566722159866, 19730, 1566722160076, 19940, 210, true
10086, 1566722159866, 19730, 1566722160077, 19941, 211, true
10087, 1566722159866, 19730, 1566722160077, 19941, 211, true
10088, 1566722159867, 19731, 1566722160077, 19941, 210, true
10089, 1566722159868, 19732, 1566722160077, 19941, 209, true
10090, 1566722159870, 19734, 1566722160077, 19941, 207, true
10091, 1566722159870, 19734, 1566722160083, 19947, 213, true
10092, 1566722159871, 19735, 1566722160080, 19944, 209, true
10093, 1566722159872, 19736, 1566722160088, 19952, 216, true
10094, 1566722159874, 19738, 1566722160089, 19953, 215, true
10095, 1566722159875, 19739, 1566722160088, 19952, 213, true
10096, 1566722159875, 19739, 1566722160093, 19957, 218, true
10097, 1566722159877, 19741, 1566722160092, 19956, 215, true
10098, 1566722159878, 19742, 1566722160088, 19952, 210, true
10099, 1566722159879, 19743, 1566722160092, 19956, 213, true
10100, 1566722159879, 19743, 1566722160093, 19957, 214, true
10101, 1566722159879, 19743, 1566722160093, 19957, 214, true
10102, 1566722159880, 19744, 1566722160098, 19962, 218, true
10103, 1566722159880, 19744, 1566722160095, 19959, 215, true
10104, 1566722159881, 19745, 1566722160090, 19954, 209, true
10105, 1566722159881, 19745, 1566722160094, 19958, 213, true
10106, 1566722159882, 19746, 1566722160093, 19957, 211, true
10107, 1566722159888, 19752, 1566722160098, 19962, 210, true
10108, 1566722159889, 19753, 1566722160098, 19962, 209, true
10109, 1566722159889, 19753, 1566722160098, 19962, 209, true
10110, 1566722159890, 19754, 1566722160098, 19962, 208, true
10111, 1566722159891, 19755, 1566722160098, 19962, 207, true
10112, 1566722159893, 19757, 1566722160100, 19964, 207, true
10113, 1566722159893, 19757, 1566722160098, 19962, 205, true
10114, 1566722159893, 19757, 1566722160098, 19962, 205, true
10115, 1566722159894, 19758, 1566722160105, 19969, 211, true
10116, 1566722159895, 19759, 1566722160103, 19967, 208, true
10117, 1566722159897, 19761, 1566722160105, 19969, 208, true
10118, 1566722159898, 19762, 1566722160114, 19978, 216, true
10119, 1566722159899, 19763, 1566722160104, 19968, 205, true
10120, 1566722159900, 19764, 1566722160105, 19969, 205, true
10121, 1566722159901, 19765, 1566722160123, 19987, 222, true
10122, 1566722159902, 19766, 1566722160125, 19989, 223, true
10123, 1566722159903, 19767, 1566722160117, 19981, 214, true
10124, 1566722159903, 19767, 1566722160131, 19995, 228, true
10125, 1566722159905, 19769, 1566722160122, 19986, 217, true
10126, 1566722159907, 19771, 1566722160130, 19994, 223, true
10127, 1566722159910, 19774, 1566722160131, 19995, 221, true
10128, 1566722159917, 19781, 1566722160122, 19986, 205, true
10129, 1566722159918, 19782, 1566722160126, 19990, 208, true
10130, 1566722159921, 19785, 1566722160126, 19990, 205, true
10131, 1566722159923, 19787, 1566722160128, 19992, 205, true
10132, 1566722159925, 19789, 1566722160135, 19999, 210, true
10133, 1566722159927, 19791, 1566722160139, 20003, 212, true
10134, 1566722159930, 19794, 1566722160139, 20003, 209, true
10135, 1566722159930, 19794, 1566722160136, 20000, 206, true
10136, 1566722159931, 19795, 1566722160136, 20000, 205, true
10137, 1566722159932, 19796, 1566722160139, 20003, 207, true
10138, 1566722159934, 19798, 1566722160139, 20003, 205, true
10139, 1566722159934, 19798, 1566722160141, 20005, 207, true
10140, 1566722159935, 19799, 1566722160145, 20009, 210, true
10141, 1566722159935, 19799, 1566722160147, 20011, 212, true
10142, 1566722159940, 19804, 1566722160145, 20009, 205, true
10143, 1566722159941, 19805, 1566722160147, 20011, 206, true
10144, 1566722159942, 19806, 1566722160149, 20013, 207, true
10145, 1566722159943, 19807, 1566722160151, 20015, 208, true
10146, 1566722159946, 19810, 1566722160148, 20012, 202, true
10147, 1566722159947, 19811, 1566722160151, 20015, 204, true
10148, 1566722159965, 19829, 1566722160169, 20033, 204, true
10149, 1566722159976, 19840, 1566722160180, 20044, 204, true
10150, 1566722159977, 19841, 1566722160186, 20050, 209, true
10151, 1566722159980, 19844, 1566722160187, 20051, 207, true
10152, 1566722159981, 19845, 1566722160189, 20053, 208, true
10153, 1566722160007, 19871, 1566722160214, 20078, 207, true
10154, 1566722160008, 19872, 1566722160212, 20076, 204, true
10155, 1566722160009, 19873, 1566722160222, 20086, 213, true
10156, 1566722160038, 19902, 1566722160240, 20104, 202, true
10157, 1566722160039, 19903, 1566722160242, 20106, 203, true
10158, 1566722160042, 19906, 1566722160249, 20113, 207, true
10159, 1566722160044, 19908, 1566722160250, 20114, 206, true
10160, 1566722160044, 19908, 1566722160256, 20120, 212, true
10161, 1566722160045, 19909, 1566722160257, 20121, 212, true
10162, 1566722160045, 19909, 1566722160256, 20120, 211, true
10163, 1566722160046, 19910, 1566722160251, 20115, 205, true
10164, 1566722160048, 19912, 1566722160257, 20121, 209, true
10165, 1566722160048, 19912, 1566722160257, 20121, 209, true
10166, 1566722160048, 19912, 1566722160256, 20120, 208, true
10167, 1566722160049, 19913, 1566722160257, 20121, 208, true
10168, 1566722160050, 19914, 1566722160257, 20121, 207, true
10169, 1566722160052, 19916, 1566722160260, 20124, 208, true
10170, 1566722160053, 19917, 1566722160257, 20121, 204, true
10171, 1566722160053, 19917, 1566722160258, 20122, 205, true
10172, 1566722160054, 19918, 1566722160273, 20137, 219, true
10173, 1566722160054, 19918, 1566722160274, 20138, 220, true
10174, 1566722160055, 19919, 1566722160272, 20136, 217, true
10175, 1566722160056, 19920, 1566722160266, 20130, 210, true
10176, 1566722160056, 19920, 1566722160273, 20137, 217, true
10177, 1566722160057, 19921, 1566722160281, 20145, 224, true
10178, 1566722160062, 19926, 1566722160285, 20149, 223, true
10179, 1566722160066, 19930, 1566722160286, 20150, 220, true
10180, 1566722160066, 19930, 1566722160281, 20145, 215, true
10181, 1566722160067, 19931, 1566722160288, 20152, 221, true
10182, 1566722160067, 19931, 1566722160280, 20144, 213, true
10183, 1566722160068, 19932, 1566722160280, 20144, 212, true
10184, 1566722160068, 19932, 1566722160285, 20149, 217, true
10185, 1566722160068, 19932, 1566722160275, 20139, 207, true
10186, 1566722160070, 19934, 1566722160287, 20151, 217, true
10187, 1566722160078, 19942, 1566722160296, 20160, 218, true
10188, 1566722160080, 19944, 1566722160305, 20169, 225, true
10189, 1566722160080, 19944, 1566722160296, 20160, 216, true
10190, 1566722160081, 19945, 1566722160305, 20169, 224, true
10191, 1566722160081, 19945, 1566722160293, 20157, 212, true
10192, 1566722160081, 19945, 1566722160303, 20167, 222, true
10193, 1566722160084, 19948, 1566722160304, 20168, 220, true
10194, 1566722160084, 19948, 1566722160303, 20167, 219, true
10195, 1566722160084, 19948, 1566722160319, 20183, 235, true
10196, 1566722160086, 19950, 1566722160319, 20183, 233, true
10197, 1566722160089, 19953, 1566722160310, 20174, 221, true
10198, 1566722160090, 19954, 1566722160311, 20175, 221, true
10199, 1566722160095, 19959, 1566722160319, 20183, 224, true
10200, 1566722160095, 19959, 1566722160318, 20182, 223, true
10201, 1566722160101, 19965, 1566722160319, 20183, 218, true
10202, 1566722160101, 19965, 1566722160307, 20171, 206, true
10203, 1566722160102, 19966, 1566722160318, 20182, 216, true
10204, 1566722160103, 19967, 1566722160322, 20186, 219, true
10205, 1566722160106, 19970, 1566722160321, 20185, 215, true
10206, 1566722160106, 19970, 1566722160320, 20184, 214, true
10207, 1566722160107, 19971, 1566722160321, 20185, 214, true
10208, 1566722160107, 19971, 1566722160320, 20184, 213, true
10209, 1566722160107, 19971, 1566722160323, 20187, 216, true
10210, 1566722160108, 19972, 1566722160323, 20187, 215, true
10211, 1566722160109, 19973, 1566722160323, 20187, 214, true
10212, 1566722160110, 19974, 1566722160324, 20188, 214, true
10213, 1566722160111, 19975, 1566722160324, 20188, 213, true
10214, 1566722160115, 19979, 1566722160325, 20189, 210, true
10215, 1566722160116, 19980, 1566722160326, 20190, 210, true
10216, 1566722160118, 19982, 1566722160325, 20189, 207, true
10217, 1566722160118, 19982, 1566722160329, 20193, 211, true
10218, 1566722160118, 19982, 1566722160329, 20193, 211, true
10219, 1566722160119, 19983, 1566722160330, 20194, 211, true
10220, 1566722160119, 19983, 1566722160329, 20193, 210, true
10221, 1566722160120, 19984, 1566722160328, 20192, 208, true
10222, 1566722160120, 19984, 1566722160329, 20193, 209, true
10223, 1566722160121, 19985, 1566722160334, 20198, 213, true
10224, 1566722160123, 19987, 1566722160333, 20197, 210, true
10225, 1566722160124, 19988, 1566722160332, 20196, 208, true
10226, 1566722160125, 19989, 1566722160331, 20195, 206, true
10227, 1566722160126, 19990, 1566722160341, 20205, 215, true
10228, 1566722160127, 19991, 1566722160331, 20195, 204, true
10229, 1566722160129, 19993, 1566722160341, 20205, 212, true
10230, 1566722160131, 19995, 1566722160341, 20205, 210, true
10231, 1566722160132, 19996, 1566722160341, 20205, 209, true
10232, 1566722160133, 19997, 1566722160342, 20206, 209, true
10233, 1566722160133, 19997, 1566722160341, 20205, 208, true
10234, 1566722160133, 19997, 1566722160346, 20210, 213, true
10235, 1566722160134, 19998, 1566722160344, 20208, 210, true
10236, 1566722160134, 19998, 1566722160354, 20218, 220, true
10237, 1566722160135, 19999, 1566722160349, 20213, 214, true
10238, 1566722160137, 20001, 1566722160358, 20222, 221, true
10239, 1566722160137, 20001, 1566722160358, 20222, 221, true
10240, 1566722160139, 20003, 1566722160346, 20210, 207, true
10241, 1566722160140, 20004, 1566722160361, 20225, 221, true
10242, 1566722160140, 20004, 1566722160358, 20222, 218, true
10243, 1566722160141, 20005, 1566722160358, 20222, 217, true
10244, 1566722160142, 20006, 1566722160358, 20222, 216, true
10245, 1566722160149, 20013, 1566722160358, 20222, 209, true
10246, 1566722160149, 20013, 1566722160361, 20225, 212, true
10247, 1566722160154, 20018, 1566722160361, 20225, 207, true
10248, 1566722160155, 20019, 1566722160361, 20225, 206, true
10249, 1566722160155, 20019, 1566722160364, 20228, 209, true
10250, 1566722160156, 20020, 1566722160361, 20225, 205, true
10251, 1566722160156, 20020, 1566722160361, 20225, 205, true
10252, 1566722160157, 20021, 1566722160364, 20228, 207, true
10253, 1566722160158, 20022, 1566722160364, 20228, 206, true
10254, 1566722160159, 20023, 1566722160365, 20229, 206, true
10255, 1566722160160, 20024, 1566722160366, 20230, 206, true
10256, 1566722160161, 20025, 1566722160370, 20234, 209, true
10257, 1566722160162, 20026, 1566722160370, 20234, 208, true
10258, 1566722160162, 20026, 1566722160367, 20231, 205, true
10259, 1566722160163, 20027, 1566722160370, 20234, 207, true
10260, 1566722160164, 20028, 1566722160370, 20234, 206, true
10261, 1566722160166, 20030, 1566722160370, 20234, 204, true
10262, 1566722160167, 20031, 1566722160372, 20236, 205, true
10263, 1566722160169, 20033, 1566722160372, 20236, 203, true
10264, 1566722160170, 20034, 1566722160375, 20239, 205, true
10265, 1566722160172, 20036, 1566722160376, 20240, 204, true
10266, 1566722160173, 20037, 1566722160379, 20243, 206, true
10267, 1566722160174, 20038, 1566722160381, 20245, 207, true
10268, 1566722160175, 20039, 1566722160389, 20253, 214, true
10269, 1566722160176, 20040, 1566722160389, 20253, 213, true
10270, 1566722160176, 20040, 1566722160389, 20253, 213, true
10271, 1566722160176, 20040, 1566722160390, 20254, 214, true
10272, 1566722160177, 20041, 1566722160389, 20253, 212, true
10273, 1566722160178, 20042, 1566722160390, 20254, 212, true
10274, 1566722160179, 20043, 1566722160390, 20254, 211, true
10275, 1566722160187, 20051, 1566722160398, 20262, 211, true
10276, 1566722160189, 20053, 1566722160399, 20263, 210, true
10277, 1566722160190, 20054, 1566722160398, 20262, 208, true
10278, 1566722160190, 20054, 1566722160403, 20267, 213, true
10279, 1566722160190, 20054, 1566722160399, 20263, 209, true
10280, 1566722160191, 20055, 1566722160403, 20267, 212, true
10281, 1566722160192, 20056, 1566722160403, 20267, 211, true
10282, 1566722160193, 20057, 1566722160403, 20267, 210, true
10283, 1566722160194, 20058, 1566722160403, 20267, 209, true
10284, 1566722160196, 20060, 1566722160404, 20268, 208, true
10285, 1566722160198, 20062, 1566722160409, 20273, 211, true
10286, 1566722160199, 20063, 1566722160407, 20271, 208, true
10287, 1566722160201, 20065, 1566722160409, 20273, 208, true
10288, 1566722160203, 20067, 1566722160409, 20273, 206, true
10289, 1566722160205, 20069, 1566722160415, 20279, 210, true
10290, 1566722160207, 20071, 1566722160419, 20283, 212, true
10291, 1566722160208, 20072, 1566722160419, 20283, 211, true
10292, 1566722160210, 20074, 1566722160433, 20297, 223, true
10293, 1566722160213, 20077, 1566722160429, 20293, 216, true
10294, 1566722160216, 20080, 1566722160427, 20291, 211, true
10295, 1566722160217, 20081, 1566722160433, 20297, 216, true
10296, 1566722160219, 20083, 1566722160433, 20297, 214, true
10297, 1566722160221, 20085, 1566722160429, 20293, 208, true
10298, 1566722160224, 20088, 1566722160431, 20295, 207, true
10299, 1566722160227, 20091, 1566722160431, 20295, 204, true
10300, 1566722160229, 20093, 1566722160433, 20297, 204, true
10301, 1566722160231, 20095, 1566722160434, 20298, 203, true
10302, 1566722160233, 20097, 1566722160437, 20301, 204, true
10303, 1566722160235, 20099, 1566722160438, 20302, 203, true
10304, 1566722160236, 20100, 1566722160443, 20307, 207, true
10305, 1566722160238, 20102, 1566722160443, 20307, 205, true
10306, 1566722160241, 20105, 1566722160451, 20315, 210, true
10307, 1566722160243, 20107, 1566722160451, 20315, 208, true
10308, 1566722160244, 20108, 1566722160451, 20315, 207, true
10309, 1566722160246, 20110, 1566722160451, 20315, 205, true
10310, 1566722160248, 20112, 1566722160454, 20318, 206, true
10311, 1566722160252, 20116, 1566722160462, 20326, 210, true
10312, 1566722160261, 20125, 1566722160473, 20337, 212, true
10313, 1566722160263, 20127, 1566722160473, 20337, 210, true
10314, 1566722160264, 20128, 1566722160473, 20337, 209, true
10315, 1566722160266, 20130, 1566722160474, 20338, 208, true
10316, 1566722160269, 20133, 1566722160478, 20342, 209, true
10317, 1566722160270, 20134, 1566722160480, 20344, 210, true
10318, 1566722160270, 20134, 1566722160487, 20351, 217, true
10319, 1566722160271, 20135, 1566722160483, 20347, 212, true
10320, 1566722160275, 20139, 1566722160487, 20351, 212, true
10321, 1566722160283, 20147, 1566722160537, 20401, 254, true
10322, 1566722160288, 20152, 1566722160541, 20405, 253, true
10323, 1566722160289, 20153, 1566722160539, 20403, 250, true
10324, 1566722160289, 20153, 1566722160552, 20416, 263, true
10325, 1566722160290, 20154, 1566722160551, 20415, 261, true
10326, 1566722160290, 20154, 1566722160545, 20409, 255, true
10327, 1566722160291, 20155, 1566722160595, 20459, 304, true
10328, 1566722160291, 20155, 1566722160556, 20420, 265, true
10329, 1566722160292, 20156, 1566722160582, 20446, 290, true
10330, 1566722160293, 20157, 1566722160556, 20420, 263, true
10331, 1566722160294, 20158, 1566722160591, 20455, 297, true
10332, 1566722160298, 20162, 1566722160557, 20421, 259, true
10333, 1566722160298, 20162, 1566722160557, 20421, 259, true
10334, 1566722160298, 20162, 1566722160579, 20443, 281, true
10335, 1566722160299, 20163, 1566722160580, 20444, 281, true
10336, 1566722160300, 20164, 1566722160579, 20443, 279, true
10337, 1566722160300, 20164, 1566722160560, 20424, 260, true
10338, 1566722160300, 20164, 1566722160594, 20458, 294, true
10339, 1566722160300, 20164, 1566722160590, 20454, 290, true
10340, 1566722160301, 20165, 1566722160556, 20420, 255, true
10341, 1566722160302, 20166, 1566722160568, 20432, 266, true
10342, 1566722160303, 20167, 1566722160560, 20424, 257, true
10343, 1566722160303, 20167, 1566722160590, 20454, 287, true
10344, 1566722160304, 20168, 1566722160557, 20421, 253, true
10345, 1566722160305, 20169, 1566722160595, 20459, 290, true
10346, 1566722160305, 20169, 1566722160600, 20464, 295, true
10347, 1566722160306, 20170, 1566722160612, 20476, 306, true
10348, 1566722160306, 20170, 1566722160590, 20454, 284, true
10349, 1566722160306, 20170, 1566722160560, 20424, 254, true
10350, 1566722160307, 20171, 1566722160552, 20416, 245, true
10351, 1566722160308, 20172, 1566722160569, 20433, 261, true
10352, 1566722160308, 20172, 1566722160606, 20470, 298, true
10353, 1566722160308, 20172, 1566722160560, 20424, 252, true
10354, 1566722160309, 20173, 1566722160595, 20459, 286, true
10355, 1566722160309, 20173, 1566722160569, 20433, 260, true
10356, 1566722160309, 20173, 1566722160557, 20421, 248, true
10357, 1566722160311, 20175, 1566722160561, 20425, 250, true
10358, 1566722160311, 20175, 1566722160587, 20451, 276, true
10359, 1566722160311, 20175, 1566722160584, 20448, 273, true
10360, 1566722160311, 20175, 1566722160595, 20459, 284, true
10361, 1566722160312, 20176, 1566722160590, 20454, 278, true
10362, 1566722160312, 20176, 1566722160600, 20464, 288, true
10363, 1566722160312, 20176, 1566722160606, 20470, 294, true
10364, 1566722160313, 20177, 1566722160557, 20421, 244, true
10365, 1566722160313, 20177, 1566722160579, 20443, 266, true
10366, 1566722160313, 20177, 1566722160590, 20454, 277, true
10367, 1566722160314, 20178, 1566722160580, 20444, 266, true
10368, 1566722160314, 20178, 1566722160569, 20433, 255, true
10369, 1566722160314, 20178, 1566722160580, 20444, 266, true
10370, 1566722160314, 20178, 1566722160557, 20421, 243, true
10371, 1566722160314, 20178, 1566722160590, 20454, 276, true
10372, 1566722160314, 20178, 1566722160599, 20463, 285, true
10373, 1566722160314, 20178, 1566722160602, 20466, 288, true
10374, 1566722160315, 20179, 1566722160557, 20421, 242, true
10375, 1566722160315, 20179, 1566722160595, 20459, 280, true
10376, 1566722160315, 20179, 1566722160590, 20454, 275, true
10377, 1566722160315, 20179, 1566722160615, 20479, 300, true
10378, 1566722160315, 20179, 1566722160615, 20479, 300, true
10379, 1566722160315, 20179, 1566722160556, 20420, 241, true
10380, 1566722160315, 20179, 1566722160595, 20459, 280, true
10381, 1566722160315, 20179, 1566722160615, 20479, 300, true
10382, 1566722160315, 20179, 1566722160561, 20425, 246, true
10383, 1566722160315, 20179, 1566722160595, 20459, 280, true
10384, 1566722160335, 20199, 1566722160584, 20448, 249, true
10385, 1566722160336, 20200, 1566722160581, 20445, 245, true
10386, 1566722160336, 20200, 1566722160561, 20425, 225, true
10387, 1566722160336, 20200, 1566722160580, 20444, 244, true
10388, 1566722160337, 20201, 1566722160591, 20455, 254, true
10389, 1566722160337, 20201, 1566722160568, 20432, 231, true
10390, 1566722160338, 20202, 1566722160595, 20459, 257, true
10391, 1566722160340, 20204, 1566722160579, 20443, 239, true
10392, 1566722160343, 20207, 1566722160607, 20471, 264, true
10393, 1566722160343, 20207, 1566722160595, 20459, 252, true
10394, 1566722160345, 20209, 1566722160599, 20463, 254, true
10395, 1566722160345, 20209, 1566722160557, 20421, 212, true
10396, 1566722160347, 20211, 1566722160595, 20459, 248, true
10397, 1566722160347, 20211, 1566722160563, 20427, 216, true
10398, 1566722160347, 20211, 1566722160557, 20421, 210, true
10399, 1566722160347, 20211, 1566722160606, 20470, 259, true
10400, 1566722160348, 20212, 1566722160615, 20479, 267, true
10401, 1566722160354, 20218, 1566722160612, 20476, 258, true
10402, 1566722160371, 20235, 1566722160606, 20470, 235, true
10403, 1566722160371, 20235, 1566722160612, 20476, 241, true
10404, 1566722160371, 20235, 1566722160600, 20464, 229, true
10405, 1566722160371, 20235, 1566722160603, 20467, 232, true
10406, 1566722160373, 20237, 1566722160600, 20464, 227, true
10407, 1566722160373, 20237, 1566722160602, 20466, 229, true
10408, 1566722160375, 20239, 1566722160612, 20476, 237, true
10409, 1566722160375, 20239, 1566722160600, 20464, 225, true
10410, 1566722160376, 20240, 1566722160615, 20479, 239, true
10411, 1566722160376, 20240, 1566722160606, 20470, 230, true
10412, 1566722160377, 20241, 1566722160612, 20476, 235, true
10413, 1566722160379, 20243, 1566722160600, 20464, 221, true
10414, 1566722160381, 20245, 1566722160611, 20475, 230, true
10415, 1566722160381, 20245, 1566722160606, 20470, 225, true
10416, 1566722160382, 20246, 1566722160606, 20470, 224, true
10417, 1566722160384, 20248, 1566722160612, 20476, 228, true
10418, 1566722160410, 20274, 1566722160617, 20481, 207, true
10419, 1566722160411, 20275, 1566722160618, 20482, 207, true
10420, 1566722160412, 20276, 1566722160618, 20482, 206, true
10421, 1566722160412, 20276, 1566722160618, 20482, 206, true
10422, 1566722160413, 20277, 1566722160618, 20482, 205, true
10423, 1566722160413, 20277, 1566722160622, 20486, 209, true
10424, 1566722160414, 20278, 1566722160621, 20485, 207, true
10425, 1566722160414, 20278, 1566722160619, 20483, 205, true
10426, 1566722160415, 20279, 1566722160619, 20483, 204, true
10427, 1566722160416, 20280, 1566722160622, 20486, 206, true
10428, 1566722160417, 20281, 1566722160631, 20495, 214, true
10429, 1566722160419, 20283, 1566722160623, 20487, 204, true
10430, 1566722160420, 20284, 1566722160631, 20495, 211, true
10431, 1566722160421, 20285, 1566722160631, 20495, 210, true
10432, 1566722160421, 20285, 1566722160631, 20495, 210, true
10433, 1566722160422, 20286, 1566722160631, 20495, 209, true
10434, 1566722160422, 20286, 1566722160631, 20495, 209, true
10435, 1566722160423, 20287, 1566722160633, 20497, 210, true
10436, 1566722160423, 20287, 1566722160631, 20495, 208, true
10437, 1566722160423, 20287, 1566722160633, 20497, 210, true
10438, 1566722160424, 20288, 1566722160631, 20495, 207, true
10439, 1566722160425, 20289, 1566722160631, 20495, 206, true
10440, 1566722160427, 20291, 1566722160633, 20497, 206, true
10441, 1566722160430, 20294, 1566722160635, 20499, 205, true
10442, 1566722160430, 20294, 1566722160638, 20502, 208, true
10443, 1566722160435, 20299, 1566722160639, 20503, 204, true
10444, 1566722160435, 20299, 1566722160639, 20503, 204, true
10445, 1566722160436, 20300, 1566722160641, 20505, 205, true
10446, 1566722160438, 20302, 1566722160642, 20506, 204, true
10447, 1566722160438, 20302, 1566722160641, 20505, 203, true
10448, 1566722160439, 20303, 1566722160644, 20508, 205, true
10449, 1566722160440, 20304, 1566722160643, 20507, 203, true
10450, 1566722160440, 20304, 1566722160643, 20507, 203, true
10451, 1566722160441, 20305, 1566722160650, 20514, 209, true
10452, 1566722160441, 20305, 1566722160647, 20511, 206, true
10453, 1566722160444, 20308, 1566722160658, 20522, 214, true
10454, 1566722160445, 20309, 1566722160647, 20511, 202, true
10455, 1566722160445, 20309, 1566722160659, 20523, 214, true
10456, 1566722160455, 20319, 1566722160665, 20529, 210, true
10457, 1566722160455, 20319, 1566722160661, 20525, 206, true
10458, 1566722160455, 20319, 1566722160665, 20529, 210, true
10459, 1566722160457, 20321, 1566722160663, 20527, 206, true
10460, 1566722160457, 20321, 1566722160661, 20525, 204, true
10461, 1566722160458, 20322, 1566722160665, 20529, 207, true
10462, 1566722160459, 20323, 1566722160663, 20527, 204, true
10463, 1566722160460, 20324, 1566722160663, 20527, 203, true
10464, 1566722160461, 20325, 1566722160665, 20529, 204, true
10465, 1566722160463, 20327, 1566722160671, 20535, 208, true
10466, 1566722160463, 20327, 1566722160671, 20535, 208, true
10467, 1566722160466, 20330, 1566722160680, 20544, 214, true
10468, 1566722160467, 20331, 1566722160679, 20543, 212, true
10469, 1566722160468, 20332, 1566722160680, 20544, 212, true
10470, 1566722160478, 20342, 1566722160685, 20549, 207, true
10471, 1566722160478, 20342, 1566722160682, 20546, 204, true
10472, 1566722160478, 20342, 1566722160690, 20554, 212, true
10473, 1566722160479, 20343, 1566722160690, 20554, 211, true
10474, 1566722160480, 20344, 1566722160690, 20554, 210, true
10475, 1566722160481, 20345, 1566722160690, 20554, 209, true
10476, 1566722160482, 20346, 1566722160690, 20554, 208, true
10477, 1566722160484, 20348, 1566722160690, 20554, 206, true
10478, 1566722160484, 20348, 1566722160696, 20560, 212, true
10479, 1566722160486, 20350, 1566722160698, 20562, 212, true
10480, 1566722160492, 20356, 1566722160700, 20564, 208, true
10481, 1566722160492, 20356, 1566722160703, 20567, 211, true
10482, 1566722160493, 20357, 1566722160703, 20567, 210, true
10483, 1566722160494, 20358, 1566722160700, 20564, 206, true
10484, 1566722160495, 20359, 1566722160703, 20567, 208, true
10485, 1566722160496, 20360, 1566722160703, 20567, 207, true
10486, 1566722160497, 20361, 1566722160704, 20568, 207, true
10487, 1566722160498, 20362, 1566722160706, 20570, 208, true
10488, 1566722160500, 20364, 1566722160705, 20569, 205, true
10489, 1566722160500, 20364, 1566722160707, 20571, 207, true
10490, 1566722160500, 20364, 1566722160709, 20573, 209, true
10491, 1566722160501, 20365, 1566722160707, 20571, 206, true
10492, 1566722160504, 20368, 1566722160720, 20584, 216, true
10493, 1566722160504, 20368, 1566722160709, 20573, 205, true
10494, 1566722160505, 20369, 1566722160713, 20577, 208, true
10495, 1566722160506, 20370, 1566722160712, 20576, 206, true
10496, 1566722160509, 20373, 1566722160719, 20583, 210, true
10497, 1566722160510, 20374, 1566722160721, 20585, 211, true
10498, 1566722160510, 20374, 1566722160721, 20585, 211, true
10499, 1566722160511, 20375, 1566722160720, 20584, 209, true
10500, 1566722160511, 20375, 1566722160720, 20584, 209, true
10501, 1566722160512, 20376, 1566722160719, 20583, 207, true
10502, 1566722160516, 20380, 1566722160721, 20585, 205, true
10503, 1566722160517, 20381, 1566722160722, 20586, 205, true
10504, 1566722160518, 20382, 1566722160724, 20588, 206, true
10505, 1566722160519, 20383, 1566722160733, 20597, 214, true
10506, 1566722160520, 20384, 1566722160735, 20599, 215, true
10507, 1566722160521, 20385, 1566722160735, 20599, 214, true
10508, 1566722160522, 20386, 1566722160733, 20597, 211, true
10509, 1566722160523, 20387, 1566722160733, 20597, 210, true
10510, 1566722160524, 20388, 1566722160733, 20597, 209, true
10511, 1566722160526, 20390, 1566722160734, 20598, 208, true
10512, 1566722160526, 20390, 1566722160733, 20597, 207, true
10513, 1566722160527, 20391, 1566722160735, 20599, 208, true
10514, 1566722160528, 20392, 1566722160737, 20601, 209, true
10515, 1566722160529, 20393, 1566722160735, 20599, 206, true
10516, 1566722160530, 20394, 1566722160742, 20606, 212, true
10517, 1566722160531, 20395, 1566722160742, 20606, 211, true
10518, 1566722160532, 20396, 1566722160742, 20606, 210, true
10519, 1566722160532, 20396, 1566722160742, 20606, 210, true
10520, 1566722160533, 20397, 1566722160742, 20606, 209, true
10521, 1566722160534, 20398, 1566722160738, 20602, 204, true
10522, 1566722160534, 20398, 1566722160745, 20609, 211, true
10523, 1566722160535, 20399, 1566722160749, 20613, 214, true
10524, 1566722160536, 20400, 1566722160749, 20613, 213, true
10525, 1566722160541, 20405, 1566722160749, 20613, 208, true
10526, 1566722160542, 20406, 1566722160749, 20613, 207, true
10527, 1566722160542, 20406, 1566722160749, 20613, 207, true
10528, 1566722160543, 20407, 1566722160749, 20613, 206, true
10529, 1566722160546, 20410, 1566722160749, 20613, 203, true
10530, 1566722160547, 20411, 1566722160750, 20614, 203, true
10531, 1566722160549, 20413, 1566722160757, 20621, 208, true
10532, 1566722160565, 20429, 1566722160772, 20636, 207, true
10533, 1566722160570, 20434, 1566722160772, 20636, 202, true
10534, 1566722160571, 20435, 1566722160778, 20642, 207, true
10535, 1566722160572, 20436, 1566722160778, 20642, 206, true
10536, 1566722160573, 20437, 1566722160778, 20642, 205, true
10537, 1566722160574, 20438, 1566722160778, 20642, 204, true
10538, 1566722160575, 20439, 1566722160790, 20654, 215, true
10539, 1566722160585, 20449, 1566722160792, 20656, 207, true
10540, 1566722160645, 20509, 1566722160850, 20714, 205, true
10541, 1566722160648, 20512, 1566722160851, 20715, 203, true
10542, 1566722160649, 20513, 1566722160853, 20717, 204, true
10543, 1566722160651, 20515, 1566722160854, 20718, 203, true
10544, 1566722160653, 20517, 1566722160855, 20719, 202, true
10545, 1566722160654, 20518, 1566722160857, 20721, 203, true
10546, 1566722160655, 20519, 1566722160858, 20722, 203, true
10547, 1566722160656, 20520, 1566722160862, 20726, 206, true
10548, 1566722160659, 20523, 1566722160868, 20732, 209, true
10549, 1566722160662, 20526, 1566722160867, 20731, 205, true
10550, 1566722160666, 20530, 1566722160871, 20735, 205, true
10551, 1566722160666, 20530, 1566722160871, 20735, 205, true
10552, 1566722160667, 20531, 1566722160870, 20734, 203, true
10553, 1566722160668, 20532, 1566722160871, 20735, 203, true
10554, 1566722160668, 20532, 1566722160872, 20736, 204, true
10555, 1566722160668, 20532, 1566722160881, 20745, 213, true
10556, 1566722160669, 20533, 1566722160878, 20742, 209, true
10557, 1566722160671, 20535, 1566722160877, 20741, 206, true
10558, 1566722160672, 20536, 1566722160881, 20745, 209, true
10559, 1566722160672, 20536, 1566722160881, 20745, 209, true
10560, 1566722160673, 20537, 1566722160881, 20745, 208, true
10561, 1566722160674, 20538, 1566722160881, 20745, 207, true
10562, 1566722160675, 20539, 1566722160881, 20745, 206, true
10563, 1566722160675, 20539, 1566722160881, 20745, 206, true
10564, 1566722160676, 20540, 1566722160882, 20746, 206, true
10565, 1566722160677, 20541, 1566722160883, 20747, 206, true
10566, 1566722160682, 20546, 1566722160886, 20750, 204, true
10567, 1566722160682, 20546, 1566722160889, 20753, 207, true
10568, 1566722160683, 20547, 1566722160889, 20753, 206, true
10569, 1566722160683, 20547, 1566722160889, 20753, 206, true
10570, 1566722160684, 20548, 1566722160889, 20753, 205, true
10571, 1566722160684, 20548, 1566722160889, 20753, 205, true
10572, 1566722160686, 20550, 1566722160891, 20755, 205, true
10573, 1566722160693, 20557, 1566722160902, 20766, 209, true
10574, 1566722160693, 20557, 1566722160902, 20766, 209, true
10575, 1566722160694, 20558, 1566722160902, 20766, 208, true
10576, 1566722160695, 20559, 1566722160902, 20766, 207, true
10577, 1566722160696, 20560, 1566722160903, 20767, 207, true
10578, 1566722160698, 20562, 1566722160904, 20768, 206, true
10579, 1566722160698, 20562, 1566722160905, 20769, 207, true
10580, 1566722160699, 20563, 1566722160909, 20773, 210, true
10581, 1566722160701, 20565, 1566722160909, 20773, 208, true
10582, 1566722160704, 20568, 1566722160909, 20773, 205, true
10583, 1566722160705, 20569, 1566722160909, 20773, 204, true
10584, 1566722160707, 20571, 1566722160916, 20780, 209, true
10585, 1566722160709, 20573, 1566722160923, 20787, 214, true
10586, 1566722160710, 20574, 1566722160923, 20787, 213, true
10587, 1566722160710, 20574, 1566722160923, 20787, 213, true
10588, 1566722160710, 20574, 1566722160922, 20786, 212, true
10589, 1566722160711, 20575, 1566722160923, 20787, 212, true
10590, 1566722160713, 20577, 1566722160923, 20787, 210, true
10591, 1566722160713, 20577, 1566722160922, 20786, 209, true
10592, 1566722160713, 20577, 1566722160923, 20787, 210, true
10593, 1566722160714, 20578, 1566722160922, 20786, 208, true
10594, 1566722160714, 20578, 1566722160922, 20786, 208, true
10595, 1566722160716, 20580, 1566722160922, 20786, 206, true
10596, 1566722160716, 20580, 1566722160922, 20786, 206, true
10597, 1566722160717, 20581, 1566722160925, 20789, 208, true
10598, 1566722160723, 20587, 1566722160933, 20797, 210, true
10599, 1566722160724, 20588, 1566722160933, 20797, 209, true
10600, 1566722160724, 20588, 1566722160933, 20797, 209, true
10601, 1566722160725, 20589, 1566722160933, 20797, 208, true
10602, 1566722160725, 20589, 1566722160931, 20795, 206, true
10603, 1566722160726, 20590, 1566722160933, 20797, 207, true
10604, 1566722160727, 20591, 1566722160933, 20797, 206, true
10605, 1566722160729, 20593, 1566722160935, 20799, 206, true
10606, 1566722160730, 20594, 1566722160935, 20799, 205, true
10607, 1566722160730, 20594, 1566722160935, 20799, 205, true
10608, 1566722160738, 20602, 1566722160942, 20806, 204, true
10609, 1566722160738, 20602, 1566722160941, 20805, 203, true
10610, 1566722160738, 20602, 1566722160942, 20806, 204, true
10611, 1566722160739, 20603, 1566722160943, 20807, 204, true
10612, 1566722160739, 20603, 1566722160943, 20807, 204, true
10613, 1566722160742, 20606, 1566722160953, 20817, 211, true
10614, 1566722160743, 20607, 1566722160953, 20817, 210, true
10615, 1566722160743, 20607, 1566722160953, 20817, 210, true
10616, 1566722160744, 20608, 1566722160947, 20811, 203, true
10617, 1566722160744, 20608, 1566722160953, 20817, 209, true
10618, 1566722160745, 20609, 1566722160953, 20817, 208, true
10619, 1566722160745, 20609, 1566722160953, 20817, 208, true
10620, 1566722160749, 20613, 1566722160953, 20817, 204, true
10621, 1566722160752, 20616, 1566722160959, 20823, 207, true
10622, 1566722160752, 20616, 1566722160958, 20822, 206, true
10623, 1566722160753, 20617, 1566722160955, 20819, 202, true
10624, 1566722160753, 20617, 1566722160959, 20823, 206, true
10625, 1566722160754, 20618, 1566722160959, 20823, 205, true
10626, 1566722160754, 20618, 1566722160959, 20823, 205, true
10627, 1566722160755, 20619, 1566722160959, 20823, 204, true
10628, 1566722160757, 20621, 1566722160961, 20825, 204, true
10629, 1566722160758, 20622, 1566722160962, 20826, 204, true
10630, 1566722160758, 20622, 1566722160963, 20827, 205, true
10631, 1566722160759, 20623, 1566722160967, 20831, 208, true
10632, 1566722160760, 20624, 1566722160967, 20831, 207, true
10633, 1566722160760, 20624, 1566722160968, 20832, 208, true
10634, 1566722160761, 20625, 1566722160969, 20833, 208, true
10635, 1566722160762, 20626, 1566722160970, 20834, 208, true
10636, 1566722160762, 20626, 1566722160970, 20834, 208, true
10637, 1566722160764, 20628, 1566722160973, 20837, 209, true
10638, 1566722160764, 20628, 1566722160969, 20833, 205, true
10639, 1566722160765, 20629, 1566722160973, 20837, 208, true
10640, 1566722160766, 20630, 1566722160973, 20837, 207, true
10641, 1566722160766, 20630, 1566722160973, 20837, 207, true
10642, 1566722160767, 20631, 1566722160973, 20837, 206, true
10643, 1566722160767, 20631, 1566722160973, 20837, 206, true
10644, 1566722160768, 20632, 1566722160974, 20838, 206, true
10645, 1566722160771, 20635, 1566722160978, 20842, 207, true
10646, 1566722160771, 20635, 1566722160978, 20842, 207, true
10647, 1566722160773, 20637, 1566722160978, 20842, 205, true
10648, 1566722160774, 20638, 1566722160978, 20842, 204, true
10649, 1566722160774, 20638, 1566722160981, 20845, 207, true
10650, 1566722160775, 20639, 1566722160983, 20847, 208, true
10651, 1566722160775, 20639, 1566722160983, 20847, 208, true
10652, 1566722160780, 20644, 1566722160983, 20847, 203, true
10653, 1566722160780, 20644, 1566722160991, 20855, 211, true
10654, 1566722160781, 20645, 1566722160988, 20852, 207, true
10655, 1566722160781, 20645, 1566722160990, 20854, 209, true
10656, 1566722160782, 20646, 1566722160990, 20854, 208, true
10657, 1566722160783, 20647, 1566722160988, 20852, 205, true
10658, 1566722160784, 20648, 1566722160988, 20852, 204, true
10659, 1566722160785, 20649, 1566722160994, 20858, 209, true
10660, 1566722160785, 20649, 1566722160994, 20858, 209, true
10661, 1566722160786, 20650, 1566722160992, 20856, 206, true
10662, 1566722160787, 20651, 1566722161003, 20867, 216, true
10663, 1566722160788, 20652, 1566722161003, 20867, 215, true
10664, 1566722160788, 20652, 1566722160995, 20859, 207, true
10665, 1566722160788, 20652, 1566722161002, 20866, 214, true
10666, 1566722160789, 20653, 1566722160995, 20859, 206, true
10667, 1566722160794, 20658, 1566722161003, 20867, 209, true
10668, 1566722160794, 20658, 1566722161000, 20864, 206, true
10669, 1566722160794, 20658, 1566722161002, 20866, 208, true
10670, 1566722160798, 20662, 1566722161007, 20871, 209, true
10671, 1566722160798, 20662, 1566722161007, 20871, 209, true
10672, 1566722160799, 20663, 1566722161007, 20871, 208, true
10673, 1566722160799, 20663, 1566722161007, 20871, 208, true
10674, 1566722160800, 20664, 1566722161007, 20871, 207, true
10675, 1566722160801, 20665, 1566722161010, 20874, 209, true
10676, 1566722160802, 20666, 1566722161007, 20871, 205, true
10677, 1566722160802, 20666, 1566722161010, 20874, 208, true
10678, 1566722160803, 20667, 1566722161019, 20883, 216, true
10679, 1566722160804, 20668, 1566722161010, 20874, 206, true
10680, 1566722160805, 20669, 1566722161029, 20893, 224, true
10681, 1566722160806, 20670, 1566722161029, 20893, 223, true
10682, 1566722160808, 20672, 1566722161029, 20893, 221, true
10683, 1566722160808, 20672, 1566722161029, 20893, 221, true
10684, 1566722160811, 20675, 1566722161023, 20887, 212, true
10685, 1566722160812, 20676, 1566722161021, 20885, 209, true
10686, 1566722160812, 20676, 1566722161021, 20885, 209, true
10687, 1566722160813, 20677, 1566722161030, 20894, 217, true
10688, 1566722160813, 20677, 1566722161029, 20893, 216, true
10689, 1566722160814, 20678, 1566722161023, 20887, 209, true
10690, 1566722160814, 20678, 1566722161021, 20885, 207, true
10691, 1566722160815, 20679, 1566722161023, 20887, 208, true
10692, 1566722160819, 20683, 1566722161029, 20893, 210, true
10693, 1566722160821, 20685, 1566722161035, 20899, 214, true
10694, 1566722160822, 20686, 1566722161035, 20899, 213, true
10695, 1566722160824, 20688, 1566722161035, 20899, 211, true
10696, 1566722160826, 20690, 1566722161035, 20899, 209, true
10697, 1566722160832, 20696, 1566722161037, 20901, 205, true
10698, 1566722160835, 20699, 1566722161041, 20905, 206, true
10699, 1566722160838, 20702, 1566722161043, 20907, 205, true
10700, 1566722160840, 20704, 1566722161043, 20907, 203, true
10701, 1566722160842, 20706, 1566722161047, 20911, 205, true
10702, 1566722160844, 20708, 1566722161052, 20916, 208, true
10703, 1566722160846, 20710, 1566722161054, 20918, 208, true
10704, 1566722160846, 20710, 1566722161053, 20917, 207, true
10705, 1566722160848, 20712, 1566722161054, 20918, 206, true
10706, 1566722160852, 20716, 1566722161056, 20920, 204, true
10707, 1566722160855, 20719, 1566722161059, 20923, 204, true
10708, 1566722160858, 20722, 1566722161063, 20927, 205, true
10709, 1566722160860, 20724, 1566722161064, 20928, 204, true
10710, 1566722160860, 20724, 1566722161065, 20929, 205, true
10711, 1566722160861, 20725, 1566722161068, 20932, 207, true
10712, 1566722160862, 20726, 1566722161069, 20933, 207, true
10713, 1566722160864, 20728, 1566722161069, 20933, 205, true
10714, 1566722160864, 20728, 1566722161071, 20935, 207, true
10715, 1566722160868, 20732, 1566722161075, 20939, 207, true
10716, 1566722160873, 20737, 1566722161081, 20945, 208, true
10717, 1566722160873, 20737, 1566722161080, 20944, 207, true
10718, 1566722160886, 20750, 1566722161093, 20957, 207, true
10719, 1566722160893, 20757, 1566722161108, 20972, 215, true
10720, 1566722160893, 20757, 1566722161097, 20961, 204, true
10721, 1566722160893, 20757, 1566722161099, 20963, 206, true
10722, 1566722160927, 20791, 1566722161135, 20999, 208, true
10723, 1566722160928, 20792, 1566722161136, 21000, 208, true
10724, 1566722160928, 20792, 1566722161135, 20999, 207, true
10725, 1566722160929, 20793, 1566722161149, 21013, 220, true
10726, 1566722160930, 20794, 1566722161142, 21006, 212, true
10727, 1566722160930, 20794, 1566722161142, 21006, 212, true
10728, 1566722160935, 20799, 1566722161154, 21018, 219, true
10729, 1566722160936, 20800, 1566722161143, 21007, 207, true
10730, 1566722160936, 20800, 1566722161149, 21013, 213, true
10731, 1566722160936, 20800, 1566722161152, 21016, 216, true
10732, 1566722160939, 20803, 1566722161161, 21025, 222, true
10733, 1566722160939, 20803, 1566722161152, 21016, 213, true
10734, 1566722160940, 20804, 1566722161154, 21018, 214, true
10735, 1566722160944, 20808, 1566722161154, 21018, 210, true
10736, 1566722160946, 20810, 1566722161154, 21018, 208, true
10737, 1566722160946, 20810, 1566722161162, 21026, 216, true
10738, 1566722160947, 20811, 1566722161168, 21032, 221, true
10739, 1566722160947, 20811, 1566722161168, 21032, 221, true
10740, 1566722160948, 20812, 1566722161162, 21026, 214, true
10741, 1566722160948, 20812, 1566722161162, 21026, 214, true
10742, 1566722160949, 20813, 1566722161165, 21029, 216, true
10743, 1566722160950, 20814, 1566722161160, 21024, 210, true
10744, 1566722160955, 20819, 1566722161166, 21030, 211, true
10745, 1566722160955, 20819, 1566722161178, 21042, 223, true
10746, 1566722160960, 20824, 1566722161180, 21044, 220, true
10747, 1566722160960, 20824, 1566722161173, 21037, 213, true
10748, 1566722160965, 20829, 1566722161180, 21044, 215, true
10749, 1566722160979, 20843, 1566722161182, 21046, 203, true
10750, 1566722160981, 20845, 1566722161185, 21049, 204, true
10751, 1566722160984, 20848, 1566722161190, 21054, 206, true
10752, 1566722160985, 20849, 1566722161191, 21055, 206, true
10753, 1566722160985, 20849, 1566722161189, 21053, 204, true
10754, 1566722160985, 20849, 1566722161190, 21054, 205, true
10755, 1566722160985, 20849, 1566722161191, 21055, 206, true
10756, 1566722160985, 20849, 1566722161192, 21056, 207, true
10757, 1566722160993, 20857, 1566722161198, 21062, 205, true
10758, 1566722160996, 20860, 1566722161203, 21067, 207, true
10759, 1566722160997, 20861, 1566722161202, 21066, 205, true
10760, 1566722160997, 20861, 1566722161202, 21066, 205, true
10761, 1566722160997, 20861, 1566722161202, 21066, 205, true
10762, 1566722161000, 20864, 1566722161207, 21071, 207, true
10763, 1566722161000, 20864, 1566722161209, 21073, 209, true
10764, 1566722161001, 20865, 1566722161207, 21071, 206, true
10765, 1566722161004, 20868, 1566722161209, 21073, 205, true
10766, 1566722161008, 20872, 1566722161220, 21084, 212, true
10767, 1566722161009, 20873, 1566722161214, 21078, 205, true
10768, 1566722161010, 20874, 1566722161221, 21085, 211, true
10769, 1566722161011, 20875, 1566722161221, 21085, 210, true
10770, 1566722161012, 20876, 1566722161221, 21085, 209, true
10771, 1566722161013, 20877, 1566722161221, 21085, 208, true
10772, 1566722161013, 20877, 1566722161220, 21084, 207, true
10773, 1566722161014, 20878, 1566722161228, 21092, 214, true
10774, 1566722161014, 20878, 1566722161228, 21092, 214, true
10775, 1566722161015, 20879, 1566722161221, 21085, 206, true
10776, 1566722161015, 20879, 1566722161224, 21088, 209, true
10777, 1566722161015, 20879, 1566722161221, 21085, 206, true
10778, 1566722161015, 20879, 1566722161228, 21092, 213, true
10779, 1566722161016, 20880, 1566722161224, 21088, 208, true
10780, 1566722161017, 20881, 1566722161228, 21092, 211, true
10781, 1566722161018, 20882, 1566722161225, 21089, 207, true
10782, 1566722161022, 20886, 1566722161234, 21098, 212, true
10783, 1566722161024, 20888, 1566722161239, 21103, 215, true
10784, 1566722161033, 20897, 1566722161241, 21105, 208, true
10785, 1566722161035, 20899, 1566722161241, 21105, 206, true
10786, 1566722161036, 20900, 1566722161244, 21108, 208, true
10787, 1566722161037, 20901, 1566722161252, 21116, 215, true
10788, 1566722161038, 20902, 1566722161244, 21108, 206, true
10789, 1566722161043, 20907, 1566722161250, 21114, 207, true
10790, 1566722161045, 20909, 1566722161252, 21116, 207, true
10791, 1566722161046, 20910, 1566722161250, 21114, 204, true
10792, 1566722161048, 20912, 1566722161252, 21116, 204, true
10793, 1566722161048, 20912, 1566722161253, 21117, 205, true
10794, 1566722161049, 20913, 1566722161260, 21124, 211, true
10795, 1566722161049, 20913, 1566722161260, 21124, 211, true
10796, 1566722161049, 20913, 1566722161260, 21124, 211, true
10797, 1566722161054, 20918, 1566722161263, 21127, 209, true
10798, 1566722161055, 20919, 1566722161260, 21124, 205, true
10799, 1566722161056, 20920, 1566722161263, 21127, 207, true
10800, 1566722161056, 20920, 1566722161263, 21127, 207, true
10801, 1566722161057, 20921, 1566722161263, 21127, 206, true
10802, 1566722161057, 20921, 1566722161263, 21127, 206, true
10803, 1566722161060, 20924, 1566722161266, 21130, 206, true
10804, 1566722161060, 20924, 1566722161269, 21133, 209, true
10805, 1566722161061, 20925, 1566722161269, 21133, 208, true
10806, 1566722161064, 20928, 1566722161269, 21133, 205, true
10807, 1566722161065, 20929, 1566722161272, 21136, 207, true
10808, 1566722161066, 20930, 1566722161271, 21135, 205, true
10809, 1566722161066, 20930, 1566722161273, 21137, 207, true
10810, 1566722161066, 20930, 1566722161273, 21137, 207, true
10811, 1566722161066, 20930, 1566722161273, 21137, 207, true
10812, 1566722161070, 20934, 1566722161279, 21143, 209, true
10813, 1566722161072, 20936, 1566722161280, 21144, 208, true
10814, 1566722161072, 20936, 1566722161275, 21139, 203, true
10815, 1566722161073, 20937, 1566722161279, 21143, 206, true
10816, 1566722161073, 20937, 1566722161280, 21144, 207, true
10817, 1566722161074, 20938, 1566722161282, 21146, 208, true
10818, 1566722161074, 20938, 1566722161283, 21147, 209, true
10819, 1566722161075, 20939, 1566722161282, 21146, 207, true
10820, 1566722161076, 20940, 1566722161288, 21152, 212, true
10821, 1566722161076, 20940, 1566722161286, 21150, 210, true
10822, 1566722161077, 20941, 1566722161290, 21154, 213, true
10823, 1566722161079, 20943, 1566722161288, 21152, 209, true
10824, 1566722161082, 20946, 1566722161295, 21159, 213, true
10825, 1566722161082, 20946, 1566722161290, 21154, 208, true
10826, 1566722161082, 20946, 1566722161295, 21159, 213, true
10827, 1566722161083, 20947, 1566722161295, 21159, 212, true
10828, 1566722161084, 20948, 1566722161291, 21155, 207, true
10829, 1566722161085, 20949, 1566722161301, 21165, 216, true
10830, 1566722161085, 20949, 1566722161301, 21165, 216, true
10831, 1566722161085, 20949, 1566722161301, 21165, 216, true
10832, 1566722161087, 20951, 1566722161301, 21165, 214, true
10833, 1566722161090, 20954, 1566722161297, 21161, 207, true
10834, 1566722161091, 20955, 1566722161301, 21165, 210, true
10835, 1566722161093, 20957, 1566722161301, 21165, 208, true
10836, 1566722161094, 20958, 1566722161301, 21165, 207, true
10837, 1566722161095, 20959, 1566722161301, 21165, 206, true
10838, 1566722161098, 20962, 1566722161303, 21167, 205, true
10839, 1566722161098, 20962, 1566722161305, 21169, 207, true
10840, 1566722161098, 20962, 1566722161305, 21169, 207, true
10841, 1566722161099, 20963, 1566722161307, 21171, 208, true
10842, 1566722161101, 20965, 1566722161305, 21169, 204, true
10843, 1566722161101, 20965, 1566722161307, 21171, 206, true
10844, 1566722161102, 20966, 1566722161307, 21171, 205, true
10845, 1566722161104, 20968, 1566722161309, 21173, 205, true
10846, 1566722161105, 20969, 1566722161309, 21173, 204, true
10847, 1566722161106, 20970, 1566722161312, 21176, 206, true
10848, 1566722161107, 20971, 1566722161312, 21176, 205, true
10849, 1566722161108, 20972, 1566722161316, 21180, 208, true
10850, 1566722161109, 20973, 1566722161315, 21179, 206, true
10851, 1566722161110, 20974, 1566722161317, 21181, 207, true
10852, 1566722161110, 20974, 1566722161321, 21185, 211, true
10853, 1566722161111, 20975, 1566722161326, 21190, 215, true
10854, 1566722161112, 20976, 1566722161318, 21182, 206, true
10855, 1566722161113, 20977, 1566722161326, 21190, 213, true
10856, 1566722161114, 20978, 1566722161326, 21190, 212, true
10857, 1566722161115, 20979, 1566722161322, 21186, 207, true
10858, 1566722161116, 20980, 1566722161326, 21190, 210, true
10859, 1566722161120, 20984, 1566722161326, 21190, 206, true
10860, 1566722161120, 20984, 1566722161331, 21195, 211, true
10861, 1566722161120, 20984, 1566722161331, 21195, 211, true
10862, 1566722161121, 20985, 1566722161331, 21195, 210, true
10863, 1566722161121, 20985, 1566722161331, 21195, 210, true
10864, 1566722161122, 20986, 1566722161331, 21195, 209, true
10865, 1566722161122, 20986, 1566722161331, 21195, 209, true
10866, 1566722161126, 20990, 1566722161341, 21205, 215, true
10867, 1566722161126, 20990, 1566722161336, 21200, 210, true
10868, 1566722161126, 20990, 1566722161336, 21200, 210, true
10869, 1566722161127, 20991, 1566722161336, 21200, 209, true
10870, 1566722161128, 20992, 1566722161342, 21206, 214, true
10871, 1566722161128, 20992, 1566722161349, 21213, 221, true
10872, 1566722161129, 20993, 1566722161340, 21204, 211, true
10873, 1566722161129, 20993, 1566722161347, 21211, 218, true
10874, 1566722161130, 20994, 1566722161347, 21211, 217, true
10875, 1566722161131, 20995, 1566722161337, 21201, 206, true
10876, 1566722161131, 20995, 1566722161339, 21203, 208, true
10877, 1566722161131, 20995, 1566722161347, 21211, 216, true
10878, 1566722161132, 20996, 1566722161349, 21213, 217, true
10879, 1566722161133, 20997, 1566722161354, 21218, 221, true
10880, 1566722161134, 20998, 1566722161354, 21218, 220, true
10881, 1566722161136, 21000, 1566722161349, 21213, 213, true
10882, 1566722161136, 21000, 1566722161354, 21218, 218, true
10883, 1566722161137, 21001, 1566722161354, 21218, 217, true
10884, 1566722161137, 21001, 1566722161354, 21218, 217, true
10885, 1566722161138, 21002, 1566722161347, 21211, 209, true
10886, 1566722161140, 21004, 1566722161354, 21218, 214, true
10887, 1566722161149, 21013, 1566722161360, 21224, 211, true
10888, 1566722161150, 21014, 1566722161360, 21224, 210, true
10889, 1566722161150, 21014, 1566722161356, 21220, 206, true
10890, 1566722161151, 21015, 1566722161361, 21225, 210, true
10891, 1566722161156, 21020, 1566722161368, 21232, 212, true
10892, 1566722161156, 21020, 1566722161366, 21230, 210, true
10893, 1566722161157, 21021, 1566722161370, 21234, 213, true
10894, 1566722161157, 21021, 1566722161368, 21232, 211, true
10895, 1566722161157, 21021, 1566722161365, 21229, 208, true
10896, 1566722161159, 21023, 1566722161372, 21236, 213, true
10897, 1566722161162, 21026, 1566722161372, 21236, 210, true
10898, 1566722161163, 21027, 1566722161370, 21234, 207, true
10899, 1566722161163, 21027, 1566722161372, 21236, 209, true
10900, 1566722161164, 21028, 1566722161372, 21236, 208, true
10901, 1566722161169, 21033, 1566722161374, 21238, 205, true
10902, 1566722161171, 21035, 1566722161378, 21242, 207, true
10903, 1566722161173, 21037, 1566722161376, 21240, 203, true
10904, 1566722161174, 21038, 1566722161377, 21241, 203, true
10905, 1566722161175, 21039, 1566722161378, 21242, 203, true
10906, 1566722161176, 21040, 1566722161381, 21245, 205, true
10907, 1566722161180, 21044, 1566722161384, 21248, 204, true
10908, 1566722161182, 21046, 1566722161391, 21255, 209, true
10909, 1566722161183, 21047, 1566722161387, 21251, 204, true
10910, 1566722161185, 21049, 1566722161388, 21252, 203, true
10911, 1566722161187, 21051, 1566722161391, 21255, 204, true
10912, 1566722161188, 21052, 1566722161395, 21259, 207, true
10913, 1566722161193, 21057, 1566722161397, 21261, 204, true
10914, 1566722161195, 21059, 1566722161397, 21261, 202, true
10915, 1566722161196, 21060, 1566722161403, 21267, 207, true
10916, 1566722161199, 21063, 1566722161402, 21266, 203, true
10917, 1566722161200, 21064, 1566722161407, 21271, 207, true
10918, 1566722161203, 21067, 1566722161407, 21271, 204, true
10919, 1566722161205, 21069, 1566722161410, 21274, 205, true
10920, 1566722161208, 21072, 1566722161413, 21277, 205, true
10921, 1566722161211, 21075, 1566722161424, 21288, 213, true
10922, 1566722161211, 21075, 1566722161424, 21288, 213, true
10923, 1566722161211, 21075, 1566722161424, 21288, 213, true
10924, 1566722161212, 21076, 1566722161424, 21288, 212, true
10925, 1566722161212, 21076, 1566722161417, 21281, 205, true
10926, 1566722161213, 21077, 1566722161424, 21288, 211, true
10927, 1566722161214, 21078, 1566722161424, 21288, 210, true
10928, 1566722161215, 21079, 1566722161424, 21288, 209, true
10929, 1566722161217, 21081, 1566722161432, 21296, 215, true
10930, 1566722161222, 21086, 1566722161434, 21298, 212, true
10931, 1566722161223, 21087, 1566722161443, 21307, 220, true
10932, 1566722161223, 21087, 1566722161433, 21297, 210, true
10933, 1566722161224, 21088, 1566722161435, 21299, 211, true
10934, 1566722161226, 21090, 1566722161439, 21303, 213, true
10935, 1566722161230, 21094, 1566722161438, 21302, 208, true
10936, 1566722161231, 21095, 1566722161439, 21303, 208, true
10937, 1566722161231, 21095, 1566722161444, 21308, 213, true
10938, 1566722161232, 21096, 1566722161443, 21307, 211, true
10939, 1566722161233, 21097, 1566722161443, 21307, 210, true
10940, 1566722161235, 21099, 1566722161443, 21307, 208, true
10941, 1566722161236, 21100, 1566722161450, 21314, 214, true
10942, 1566722161236, 21100, 1566722161443, 21307, 207, true
10943, 1566722161236, 21100, 1566722161443, 21307, 207, true
10944, 1566722161239, 21103, 1566722161444, 21308, 205, true
10945, 1566722161239, 21103, 1566722161449, 21313, 210, true
10946, 1566722161242, 21106, 1566722161455, 21319, 213, true
10947, 1566722161242, 21106, 1566722161452, 21316, 210, true
10948, 1566722161245, 21109, 1566722161453, 21317, 208, true
10949, 1566722161245, 21109, 1566722161451, 21315, 206, true
10950, 1566722161245, 21109, 1566722161455, 21319, 210, true
10951, 1566722161246, 21110, 1566722161453, 21317, 207, true
10952, 1566722161247, 21111, 1566722161456, 21320, 209, true
10953, 1566722161248, 21112, 1566722161457, 21321, 209, true
10954, 1566722161254, 21118, 1566722161457, 21321, 203, true
10955, 1566722161255, 21119, 1566722161458, 21322, 203, true
10956, 1566722161255, 21119, 1566722161459, 21323, 204, true
10957, 1566722161257, 21121, 1566722161460, 21324, 203, true
10958, 1566722161257, 21121, 1566722161465, 21329, 208, true
10959, 1566722161257, 21121, 1566722161469, 21333, 212, true
10960, 1566722161264, 21128, 1566722161474, 21338, 210, true
10961, 1566722161265, 21129, 1566722161470, 21334, 205, true
10962, 1566722161277, 21141, 1566722161487, 21351, 210, true
10963, 1566722161284, 21148, 1566722161491, 21355, 207, true
10964, 1566722161286, 21150, 1566722161493, 21357, 207, true
10965, 1566722161291, 21155, 1566722161498, 21362, 207, true
10966, 1566722161291, 21155, 1566722161496, 21360, 205, true
10967, 1566722161292, 21156, 1566722161499, 21363, 207, true
10968, 1566722161293, 21157, 1566722161501, 21365, 208, true
10969, 1566722161293, 21157, 1566722161500, 21364, 207, true
10970, 1566722161297, 21161, 1566722161502, 21366, 205, true
10971, 1566722161297, 21161, 1566722161508, 21372, 211, true
10972, 1566722161298, 21162, 1566722161510, 21374, 212, true
10973, 1566722161302, 21166, 1566722161510, 21374, 208, true
10974, 1566722161305, 21169, 1566722161512, 21376, 207, true
10975, 1566722161310, 21174, 1566722161520, 21384, 210, true
10976, 1566722161310, 21174, 1566722161514, 21378, 204, true
10977, 1566722161310, 21174, 1566722161519, 21383, 209, true
10978, 1566722161311, 21175, 1566722161520, 21384, 209, true
10979, 1566722161314, 21178, 1566722161519, 21383, 205, true
10980, 1566722161314, 21178, 1566722161519, 21383, 205, true
10981, 1566722161314, 21178, 1566722161519, 21383, 205, true
10982, 1566722161318, 21182, 1566722161522, 21386, 204, true
10983, 1566722161319, 21183, 1566722161523, 21387, 204, true
10984, 1566722161321, 21185, 1566722161549, 21413, 228, true
10985, 1566722161322, 21186, 1566722161549, 21413, 227, true
10986, 1566722161322, 21186, 1566722161552, 21416, 230, true
10987, 1566722161323, 21187, 1566722161552, 21416, 229, true
10988, 1566722161323, 21187, 1566722161552, 21416, 229, true
10989, 1566722161327, 21191, 1566722161552, 21416, 225, true
10990, 1566722161328, 21192, 1566722161552, 21416, 224, true
10991, 1566722161328, 21192, 1566722161553, 21417, 225, true
10992, 1566722161332, 21196, 1566722161553, 21417, 221, true
10993, 1566722161334, 21198, 1566722161553, 21417, 219, true
10994, 1566722161334, 21198, 1566722161553, 21417, 219, true
10995, 1566722161335, 21199, 1566722161553, 21417, 218, true
10996, 1566722161338, 21202, 1566722161553, 21417, 215, true
10997, 1566722161344, 21208, 1566722161557, 21421, 213, true
10998, 1566722161351, 21215, 1566722161558, 21422, 207, true
10999, 1566722161351, 21215, 1566722161560, 21424, 209, true
11000, 1566722161355, 21219, 1566722161563, 21427, 208, true
11001, 1566722161357, 21221, 1566722161563, 21427, 206, true
11002, 1566722161357, 21221, 1566722161563, 21427, 206, true
11003, 1566722161358, 21222, 1566722161564, 21428, 206, true
11004, 1566722161358, 21222, 1566722161564, 21428, 206, true
11005, 1566722161359, 21223, 1566722161563, 21427, 204, true
11006, 1566722161361, 21225, 1566722161567, 21431, 206, true
11007, 1566722161361, 21225, 1566722161567, 21431, 206, true
11008, 1566722161362, 21226, 1566722161570, 21434, 208, true
11009, 1566722161362, 21226, 1566722161570, 21434, 208, true
11010, 1566722161363, 21227, 1566722161572, 21436, 209, true
11011, 1566722161363, 21227, 1566722161573, 21437, 210, true
11012, 1566722161366, 21230, 1566722161571, 21435, 205, true
11013, 1566722161368, 21232, 1566722161573, 21437, 205, true
11014, 1566722161373, 21237, 1566722161579, 21443, 206, true
11015, 1566722161374, 21238, 1566722161580, 21444, 206, true
11016, 1566722161375, 21239, 1566722161594, 21458, 219, true
11017, 1566722161375, 21239, 1566722161595, 21459, 220, true
11018, 1566722161378, 21242, 1566722161595, 21459, 217, true
11019, 1566722161379, 21243, 1566722161597, 21461, 218, true
11020, 1566722161380, 21244, 1566722161597, 21461, 217, true
11021, 1566722161381, 21245, 1566722161595, 21459, 214, true
11022, 1566722161382, 21246, 1566722161595, 21459, 213, true
11023, 1566722161382, 21246, 1566722161597, 21461, 215, true
11024, 1566722161383, 21247, 1566722161595, 21459, 212, true
11025, 1566722161384, 21248, 1566722161597, 21461, 213, true
11026, 1566722161385, 21249, 1566722161597, 21461, 212, true
11027, 1566722161386, 21250, 1566722161598, 21462, 212, true
11028, 1566722161389, 21253, 1566722161598, 21462, 209, true
11029, 1566722161392, 21256, 1566722161605, 21469, 213, true
11030, 1566722161393, 21257, 1566722161598, 21462, 205, true
11031, 1566722161393, 21257, 1566722161608, 21472, 215, true
11032, 1566722161395, 21259, 1566722161608, 21472, 213, true
11033, 1566722161395, 21259, 1566722161608, 21472, 213, true
11034, 1566722161398, 21262, 1566722161608, 21472, 210, true
11035, 1566722161398, 21262, 1566722161608, 21472, 210, true
11036, 1566722161399, 21263, 1566722161608, 21472, 209, true
11037, 1566722161399, 21263, 1566722161608, 21472, 209, true
11038, 1566722161400, 21264, 1566722161608, 21472, 208, true
11039, 1566722161401, 21265, 1566722161620, 21484, 219, true
11040, 1566722161404, 21268, 1566722161610, 21474, 206, true
11041, 1566722161405, 21269, 1566722161613, 21477, 208, true
11042, 1566722161405, 21269, 1566722161620, 21484, 215, true
11043, 1566722161406, 21270, 1566722161620, 21484, 214, true
11044, 1566722161408, 21272, 1566722161620, 21484, 212, true
11045, 1566722161409, 21273, 1566722161615, 21479, 206, true
11046, 1566722161410, 21274, 1566722161620, 21484, 210, true
11047, 1566722161410, 21274, 1566722161620, 21484, 210, true
11048, 1566722161412, 21276, 1566722161620, 21484, 208, true
11049, 1566722161414, 21278, 1566722161620, 21484, 206, true
11050, 1566722161414, 21278, 1566722161678, 21542, 264, true
11051, 1566722161415, 21279, 1566722161622, 21486, 207, true
11052, 1566722161416, 21280, 1566722161658, 21522, 242, true
11053, 1566722161419, 21283, 1566722161671, 21535, 252, true
11054, 1566722161420, 21284, 1566722161669, 21533, 249, true
11055, 1566722161422, 21286, 1566722161658, 21522, 236, true
11056, 1566722161425, 21289, 1566722161732, 21596, 307, true
11057, 1566722161426, 21290, 1566722161729, 21593, 303, true
11058, 1566722161426, 21290, 1566722161904, 21768, 478, true
11059, 1566722161426, 21290, 1566722161720, 21584, 294, true
11060, 1566722161426, 21290, 1566722161899, 21763, 473, true
11061, 1566722161427, 21291, 1566722161905, 21769, 478, true
11062, 1566722161427, 21291, 1566722161907, 21771, 480, true
11063, 1566722161427, 21291, 1566722161906, 21770, 479, true
11064, 1566722161427, 21291, 1566722161906, 21770, 479, true
11065, 1566722161428, 21292, 1566722161912, 21776, 484, true
11066, 1566722161428, 21292, 1566722161727, 21591, 299, true
11067, 1566722161428, 21292, 1566722161902, 21766, 474, true
11068, 1566722161429, 21293, 1566722161909, 21773, 480, true
11069, 1566722161429, 21293, 1566722161990, 21854, 561, true
11070, 1566722161430, 21294, 1566722161906, 21770, 476, true
11071, 1566722161430, 21294, 1566722161901, 21765, 471, true
11072, 1566722161430, 21294, 1566722161724, 21588, 294, true
11073, 1566722161431, 21295, 1566722161912, 21776, 481, true
11074, 1566722161432, 21296, 1566722161989, 21853, 557, true
11075, 1566722161433, 21297, 1566722161729, 21593, 296, true
11076, 1566722161433, 21297, 1566722161725, 21589, 292, true
11077, 1566722161434, 21298, 1566722161905, 21769, 471, true
11078, 1566722161434, 21298, 1566722161732, 21596, 298, true
11079, 1566722161435, 21299, 1566722161908, 21772, 473, true
11080, 1566722161435, 21299, 1566722161898, 21762, 463, true
11081, 1566722161436, 21300, 1566722161907, 21771, 471, true
11082, 1566722161437, 21301, 1566722161970, 21834, 533, true
11083, 1566722161438, 21302, 1566722161724, 21588, 286, true
11084, 1566722161439, 21303, 1566722161904, 21768, 465, true
11085, 1566722161439, 21303, 1566722161910, 21774, 471, true
11086, 1566722161440, 21304, 1566722161914, 21778, 474, true
11087, 1566722161442, 21306, 1566722161903, 21767, 461, true
11088, 1566722161444, 21308, 1566722161976, 21840, 532, true
11089, 1566722161444, 21308, 1566722161908, 21772, 464, true
11090, 1566722161445, 21309, 1566722161904, 21768, 459, true
11091, 1566722161445, 21309, 1566722161909, 21773, 464, true
11092, 1566722161445, 21309, 1566722161976, 21840, 531, true
11093, 1566722161445, 21309, 1566722161732, 21596, 287, true
11094, 1566722161445, 21309, 1566722161991, 21855, 546, true
11095, 1566722161446, 21310, 1566722161903, 21767, 457, true
11096, 1566722161446, 21310, 1566722161903, 21767, 457, true
11097, 1566722161446, 21310, 1566722161986, 21850, 540, true
11098, 1566722161446, 21310, 1566722161908, 21772, 462, true
11099, 1566722161447, 21311, 1566722161728, 21592, 281, true
11100, 1566722161447, 21311, 1566722161906, 21770, 459, true
11101, 1566722161448, 21312, 1566722161728, 21592, 280, true
11102, 1566722161449, 21313, 1566722161899, 21763, 450, true
11103, 1566722161450, 21314, 1566722161976, 21840, 526, true
11104, 1566722161450, 21314, 1566722161900, 21764, 450, true
11105, 1566722161451, 21315, 1566722161976, 21840, 525, true
11106, 1566722161451, 21315, 1566722161724, 21588, 273, true
11107, 1566722161452, 21316, 1566722161908, 21772, 456, true
11108, 1566722161453, 21317, 1566722161976, 21840, 523, true
11109, 1566722161454, 21318, 1566722161902, 21766, 448, true
11110, 1566722161454, 21318, 1566722161902, 21766, 448, true
11111, 1566722161454, 21318, 1566722161907, 21771, 453, true
11112, 1566722161455, 21319, 1566722161905, 21769, 450, true
11113, 1566722161457, 21321, 1566722161910, 21774, 453, true
11114, 1566722161458, 21322, 1566722161902, 21766, 444, true
11115, 1566722161458, 21322, 1566722161902, 21766, 444, true
11116, 1566722161459, 21323, 1566722161992, 21856, 533, true
11117, 1566722161459, 21323, 1566722161902, 21766, 443, true
11118, 1566722161460, 21324, 1566722161907, 21771, 447, true
11119, 1566722161460, 21324, 1566722161905, 21769, 445, true
11120, 1566722161460, 21324, 1566722161975, 21839, 515, true
11121, 1566722161461, 21325, 1566722161977, 21841, 516, true
11122, 1566722161462, 21326, 1566722161992, 21856, 530, true
11123, 1566722161462, 21326, 1566722161906, 21770, 444, true
11124, 1566722161462, 21326, 1566722161991, 21855, 529, true
11125, 1566722161463, 21327, 1566722161982, 21846, 519, true
11126, 1566722161463, 21327, 1566722161718, 21582, 255, true
11127, 1566722161464, 21328, 1566722161732, 21596, 268, true
11128, 1566722161464, 21328, 1566722161905, 21769, 441, true
11129, 1566722161465, 21329, 1566722161911, 21775, 446, true
11130, 1566722161466, 21330, 1566722161903, 21767, 437, true
11131, 1566722161466, 21330, 1566722161968, 21832, 502, true
11132, 1566722161467, 21331, 1566722161990, 21854, 523, true
11133, 1566722161467, 21331, 1566722161905, 21769, 438, true
11134, 1566722161468, 21332, 1566722161902, 21766, 434, true
11135, 1566722161469, 21333, 1566722161906, 21770, 437, true
11136, 1566722161469, 21333, 1566722161982, 21846, 513, true
11137, 1566722161470, 21334, 1566722161907, 21771, 437, true
11138, 1566722161471, 21335, 1566722161903, 21767, 432, true
11139, 1566722161471, 21335, 1566722161901, 21765, 430, true
11140, 1566722161471, 21335, 1566722161992, 21856, 521, true
11141, 1566722161472, 21336, 1566722161912, 21776, 440, true
11142, 1566722161472, 21336, 1566722161971, 21835, 499, true
11143, 1566722161472, 21336, 1566722161972, 21836, 500, true
11144, 1566722161473, 21337, 1566722161910, 21774, 437, true
11145, 1566722161474, 21338, 1566722161974, 21838, 500, true
11146, 1566722161474, 21338, 1566722161971, 21835, 497, true
11147, 1566722161475, 21339, 1566722161974, 21838, 499, true
11148, 1566722161475, 21339, 1566722161913, 21777, 438, true
11149, 1566722161475, 21339, 1566722161939, 21803, 464, true
11150, 1566722161476, 21340, 1566722161975, 21839, 499, true
11151, 1566722161476, 21340, 1566722161912, 21776, 436, true
11152, 1566722161476, 21340, 1566722161951, 21815, 475, true
11153, 1566722161477, 21341, 1566722161951, 21815, 474, true
11154, 1566722161477, 21341, 1566722161909, 21773, 432, true
11155, 1566722161477, 21341, 1566722161910, 21774, 433, true
11156, 1566722161477, 21341, 1566722161974, 21838, 497, true
11157, 1566722161477, 21341, 1566722161935, 21799, 458, true
11158, 1566722161477, 21341, 1566722161971, 21835, 494, true
11159, 1566722161477, 21341, 1566722161975, 21839, 498, true
11160, 1566722161477, 21341, 1566722161912, 21776, 435, true
11161, 1566722161478, 21342, 1566722161969, 21833, 491, true
11162, 1566722161478, 21342, 1566722161916, 21780, 438, true
11163, 1566722161478, 21342, 1566722161914, 21778, 436, true
11164, 1566722161478, 21342, 1566722161913, 21777, 435, true
11165, 1566722161478, 21342, 1566722161912, 21776, 434, true
11166, 1566722161478, 21342, 1566722161915, 21779, 437, true
11167, 1566722161478, 21342, 1566722161915, 21779, 437, true
11168, 1566722161478, 21342, 1566722161971, 21835, 493, true
11169, 1566722161478, 21342, 1566722161952, 21816, 474, true
11170, 1566722161478, 21342, 1566722161913, 21777, 435, true
11171, 1566722161478, 21342, 1566722161915, 21779, 437, true
11172, 1566722161478, 21342, 1566722161940, 21804, 462, true
11173, 1566722161479, 21343, 1566722161915, 21779, 436, true
11174, 1566722161479, 21343, 1566722161940, 21804, 461, true
11175, 1566722161479, 21343, 1566722161915, 21779, 436, true
11176, 1566722161479, 21343, 1566722161975, 21839, 496, true
11177, 1566722161479, 21343, 1566722161973, 21837, 494, true
11178, 1566722161479, 21343, 1566722161968, 21832, 489, true
11179, 1566722161479, 21343, 1566722161973, 21837, 494, true
11180, 1566722161479, 21343, 1566722161973, 21837, 494, true
11181, 1566722161479, 21343, 1566722161939, 21803, 460, true
11182, 1566722161479, 21343, 1566722161940, 21804, 461, true
11183, 1566722161479, 21343, 1566722161910, 21774, 431, true
11184, 1566722161480, 21344, 1566722161972, 21836, 492, true
11185, 1566722161480, 21344, 1566722161970, 21834, 490, true
11186, 1566722161480, 21344, 1566722161910, 21774, 430, true
11187, 1566722161480, 21344, 1566722161948, 21812, 468, true
11188, 1566722161480, 21344, 1566722161972, 21836, 492, true
11189, 1566722161480, 21344, 1566722161970, 21834, 490, true
11190, 1566722161480, 21344, 1566722161915, 21779, 435, true
11191, 1566722161480, 21344, 1566722161911, 21775, 431, true
11192, 1566722161480, 21344, 1566722161972, 21836, 492, true
11193, 1566722161480, 21344, 1566722161936, 21800, 456, true
11194, 1566722161480, 21344, 1566722161974, 21838, 494, true
11195, 1566722161481, 21345, 1566722161911, 21775, 430, true
11196, 1566722161481, 21345, 1566722161973, 21837, 492, true
11197, 1566722161481, 21345, 1566722161948, 21812, 467, true
11198, 1566722161481, 21345, 1566722161913, 21777, 432, true
11199, 1566722161481, 21345, 1566722161974, 21838, 493, true
11200, 1566722161481, 21345, 1566722161914, 21778, 433, true
11201, 1566722161481, 21345, 1566722161974, 21838, 493, true
11202, 1566722161481, 21345, 1566722161909, 21773, 428, true
11203, 1566722161481, 21345, 1566722161972, 21836, 491, true
11204, 1566722161481, 21345, 1566722161969, 21833, 488, true
11205, 1566722161481, 21345, 1566722161950, 21814, 469, true
11206, 1566722161482, 21346, 1566722161973, 21837, 491, true
11207, 1566722161482, 21346, 1566722161965, 21829, 483, true
11208, 1566722161482, 21346, 1566722161969, 21833, 487, true
11209, 1566722161482, 21346, 1566722161969, 21833, 487, true
11210, 1566722161482, 21346, 1566722161952, 21816, 470, true
11211, 1566722161482, 21346, 1566722161915, 21779, 433, true
11212, 1566722161482, 21346, 1566722161974, 21838, 492, true
11213, 1566722161482, 21346, 1566722161973, 21837, 491, true
11214, 1566722161482, 21346, 1566722161911, 21775, 429, true
11215, 1566722161482, 21346, 1566722161970, 21834, 488, true
11216, 1566722161482, 21346, 1566722161913, 21777, 431, true
11217, 1566722161483, 21347, 1566722161973, 21837, 490, true
11218, 1566722161483, 21347, 1566722161909, 21773, 426, true
11219, 1566722161483, 21347, 1566722161972, 21836, 489, true
11220, 1566722161483, 21347, 1566722161936, 21800, 453, true
11221, 1566722161483, 21347, 1566722161973, 21837, 490, true
11222, 1566722161483, 21347, 1566722161952, 21816, 469, true
11223, 1566722161483, 21347, 1566722161953, 21817, 470, true
11224, 1566722161483, 21347, 1566722161974, 21838, 491, true
11225, 1566722161483, 21347, 1566722161968, 21832, 485, true
11226, 1566722161483, 21347, 1566722161911, 21775, 428, true
11227, 1566722161484, 21348, 1566722161909, 21773, 425, true
11228, 1566722161484, 21348, 1566722161914, 21778, 430, true
11229, 1566722161484, 21348, 1566722161972, 21836, 488, true
11230, 1566722161484, 21348, 1566722161914, 21778, 430, true
11231, 1566722161484, 21348, 1566722161913, 21777, 429, true
11232, 1566722161484, 21348, 1566722161913, 21777, 429, true
11233, 1566722161484, 21348, 1566722161911, 21775, 427, true
11234, 1566722161484, 21348, 1566722161949, 21813, 465, true
11235, 1566722161484, 21348, 1566722161910, 21774, 426, true
11236, 1566722161581, 21445, 1566722161898, 21762, 317, true
11237, 1566722161581, 21445, 1566722161898, 21762, 317, true
11238, 1566722161582, 21446, 1566722161897, 21761, 315, true
11239, 1566722161584, 21448, 1566722161897, 21761, 313, true
11240, 1566722161585, 21449, 1566722161896, 21760, 311, true
11241, 1566722161600, 21464, 1566722161896, 21760, 296, true
11242, 1566722161602, 21466, 1566722161895, 21759, 293, true
11243, 1566722161603, 21467, 1566722161895, 21759, 292, true
11244, 1566722161611, 21475, 1566722161895, 21759, 284, true
11245, 1566722161612, 21476, 1566722161895, 21759, 283, true
11246, 1566722161614, 21478, 1566722161895, 21759, 281, true
11247, 1566722161616, 21480, 1566722161895, 21759, 279, true
11248, 1566722161623, 21487, 1566722161894, 21758, 271, true
11249, 1566722161626, 21490, 1566722161894, 21758, 268, true
11250, 1566722161628, 21492, 1566722161894, 21758, 266, true
11251, 1566722161629, 21493, 1566722161894, 21758, 265, true
11252, 1566722161631, 21495, 1566722161997, 21861, 366, true
11253, 1566722161633, 21497, 1566722161997, 21861, 364, true
11254, 1566722161636, 21500, 1566722161999, 21863, 363, true
11255, 1566722161639, 21503, 1566722161999, 21863, 360, true
11256, 1566722161641, 21505, 1566722161999, 21863, 358, true
11257, 1566722161644, 21508, 1566722161999, 21863, 355, true
11258, 1566722161645, 21509, 1566722161999, 21863, 354, true
11259, 1566722161648, 21512, 1566722161998, 21862, 350, true
11260, 1566722161653, 21517, 1566722161998, 21862, 345, true
11261, 1566722161654, 21518, 1566722161997, 21861, 343, true
11262, 1566722161654, 21518, 1566722161998, 21862, 344, true
11263, 1566722161663, 21527, 1566722161998, 21862, 335, true
11264, 1566722161666, 21530, 1566722161998, 21862, 332, true
11265, 1566722161666, 21530, 1566722161998, 21862, 332, true
11266, 1566722161667, 21531, 1566722161998, 21862, 331, true
11267, 1566722161667, 21531, 1566722161998, 21862, 331, true
11268, 1566722161675, 21539, 1566722161998, 21862, 323, true
11269, 1566722161675, 21539, 1566722161998, 21862, 323, true
11270, 1566722161676, 21540, 1566722161998, 21862, 322, true
11271, 1566722161677, 21541, 1566722161998, 21862, 321, true
11272, 1566722161680, 21544, 1566722161998, 21862, 318, true
11273, 1566722161681, 21545, 1566722161997, 21861, 316, true
11274, 1566722161682, 21546, 1566722161998, 21862, 316, true
11275, 1566722161683, 21547, 1566722161998, 21862, 315, true
11276, 1566722161684, 21548, 1566722161997, 21861, 313, true
11277, 1566722161685, 21549, 1566722161997, 21861, 312, true
11278, 1566722161686, 21550, 1566722161997, 21861, 311, true
11279, 1566722161688, 21552, 1566722161998, 21862, 310, true
11280, 1566722161688, 21552, 1566722161999, 21863, 311, true
11281, 1566722161689, 21553, 1566722161997, 21861, 308, true
11282, 1566722161689, 21553, 1566722161999, 21863, 310, true
11283, 1566722161690, 21554, 1566722161999, 21863, 309, true
11284, 1566722161690, 21554, 1566722161997, 21861, 307, true
11285, 1566722161691, 21555, 1566722161999, 21863, 308, true
11286, 1566722161695, 21559, 1566722161999, 21863, 304, true
11287, 1566722161695, 21559, 1566722161999, 21863, 304, true
11288, 1566722161695, 21559, 1566722161999, 21863, 304, true
11289, 1566722161696, 21560, 1566722161998, 21862, 302, true
11290, 1566722161696, 21560, 1566722161998, 21862, 302, true
11291, 1566722161697, 21561, 1566722161999, 21863, 302, true
11292, 1566722161697, 21561, 1566722161998, 21862, 301, true
11293, 1566722161697, 21561, 1566722161999, 21863, 302, true
11294, 1566722161697, 21561, 1566722161999, 21863, 302, true
11295, 1566722161698, 21562, 1566722161999, 21863, 301, true
11296, 1566722161701, 21565, 1566722161998, 21862, 297, true
11297, 1566722161701, 21565, 1566722161999, 21863, 298, true
11298, 1566722161701, 21565, 1566722161998, 21862, 297, true
11299, 1566722161702, 21566, 1566722161999, 21863, 297, true
11300, 1566722161703, 21567, 1566722161999, 21863, 296, true
11301, 1566722161706, 21570, 1566722161998, 21862, 292, true
11302, 1566722161708, 21572, 1566722161998, 21862, 290, true
11303, 1566722161708, 21572, 1566722161998, 21862, 290, true
11304, 1566722161708, 21572, 1566722161999, 21863, 291, true
11305, 1566722161709, 21573, 1566722161999, 21863, 290, true
11306, 1566722161709, 21573, 1566722161998, 21862, 289, true
11307, 1566722161710, 21574, 1566722161998, 21862, 288, true
11308, 1566722161711, 21575, 1566722161999, 21863, 288, true
11309, 1566722161712, 21576, 1566722161999, 21863, 287, true
11310, 1566722161713, 21577, 1566722161999, 21863, 286, true
11311, 1566722161714, 21578, 1566722161999, 21863, 285, true
11312, 1566722161717, 21581, 1566722161999, 21863, 282, true
11313, 1566722161721, 21585, 1566722161999, 21863, 278, true
11314, 1566722161721, 21585, 1566722161999, 21863, 278, true
11315, 1566722161721, 21585, 1566722162078, 21942, 357, true
11316, 1566722161721, 21585, 1566722161999, 21863, 278, true
11317, 1566722161722, 21586, 1566722162073, 21937, 351, true
11318, 1566722161991, 21855, 1566722162231, 22095, 240, true
11319, 1566722161992, 21856, 1566722162212, 22076, 220, true
11320, 1566722162001, 21865, 1566722162228, 22092, 227, true
11321, 1566722162003, 21867, 1566722162229, 22093, 226, true
11322, 1566722162003, 21867, 1566722162228, 22092, 225, true
11323, 1566722162004, 21868, 1566722162232, 22096, 228, true
11324, 1566722162004, 21868, 1566722162231, 22095, 227, true
11325, 1566722162004, 21868, 1566722162228, 22092, 224, true
11326, 1566722162010, 21874, 1566722162229, 22093, 219, true
11327, 1566722162010, 21874, 1566722162228, 22092, 218, true
11328, 1566722162011, 21875, 1566722162231, 22095, 220, true
11329, 1566722162012, 21876, 1566722162231, 22095, 219, true
11330, 1566722162013, 21877, 1566722162231, 22095, 218, true
11331, 1566722162013, 21877, 1566722162228, 22092, 215, true
11332, 1566722162027, 21891, 1566722162232, 22096, 205, true
11333, 1566722162030, 21894, 1566722162234, 22098, 204, true
11334, 1566722162031, 21895, 1566722162235, 22099, 204, true
11335, 1566722162032, 21896, 1566722162235, 22099, 203, true
11336, 1566722162032, 21896, 1566722162237, 22101, 205, true
11337, 1566722162033, 21897, 1566722162238, 22102, 205, true
11338, 1566722162034, 21898, 1566722162238, 22102, 204, true
11339, 1566722162034, 21898, 1566722162239, 22103, 205, true
11340, 1566722162035, 21899, 1566722162239, 22103, 204, true
11341, 1566722162036, 21900, 1566722162239, 22103, 203, true
11342, 1566722162037, 21901, 1566722162241, 22105, 204, true
11343, 1566722162037, 21901, 1566722162241, 22105, 204, true
11344, 1566722162038, 21902, 1566722162243, 22107, 205, true
11345, 1566722162039, 21903, 1566722162243, 22107, 204, true
11346, 1566722162039, 21903, 1566722162243, 22107, 204, true
11347, 1566722162040, 21904, 1566722162245, 22109, 205, true
11348, 1566722162041, 21905, 1566722162247, 22111, 206, true
11349, 1566722162042, 21906, 1566722162245, 22109, 203, true
11350, 1566722162042, 21906, 1566722162250, 22114, 208, true
11351, 1566722162043, 21907, 1566722162250, 22114, 207, true
11352, 1566722162046, 21910, 1566722162257, 22121, 211, true
11353, 1566722162046, 21910, 1566722162257, 22121, 211, true
11354, 1566722162047, 21911, 1566722162257, 22121, 210, true
11355, 1566722162048, 21912, 1566722162257, 22121, 209, true
11356, 1566722162049, 21913, 1566722162257, 22121, 208, true
11357, 1566722162050, 21914, 1566722162257, 22121, 207, true
11358, 1566722162051, 21915, 1566722162265, 22129, 214, true
11359, 1566722162051, 21915, 1566722162265, 22129, 214, true
11360, 1566722162052, 21916, 1566722162258, 22122, 206, true
11361, 1566722162053, 21917, 1566722162258, 22122, 205, true
11362, 1566722162054, 21918, 1566722162265, 22129, 211, true
11363, 1566722162055, 21919, 1566722162265, 22129, 210, true
11364, 1566722162056, 21920, 1566722162265, 22129, 209, true
11365, 1566722162056, 21920, 1566722162265, 22129, 209, true
11366, 1566722162057, 21921, 1566722162265, 22129, 208, true
11367, 1566722162058, 21922, 1566722162265, 22129, 207, true
11368, 1566722162059, 21923, 1566722162265, 22129, 206, true
11369, 1566722162060, 21924, 1566722162266, 22130, 206, true
11370, 1566722162061, 21925, 1566722162266, 22130, 205, true
11371, 1566722162061, 21925, 1566722162266, 22130, 205, true
11372, 1566722162061, 21925, 1566722162265, 22129, 204, true
11373, 1566722162063, 21927, 1566722162275, 22139, 212, true
11374, 1566722162063, 21927, 1566722162268, 22132, 205, true
11375, 1566722162064, 21928, 1566722162268, 22132, 204, true
11376, 1566722162065, 21929, 1566722162275, 22139, 210, true
11377, 1566722162066, 21930, 1566722162276, 22140, 210, true
11378, 1566722162067, 21931, 1566722162271, 22135, 204, true
11379, 1566722162067, 21931, 1566722162276, 22140, 209, true
11380, 1566722162068, 21932, 1566722162279, 22143, 211, true
11381, 1566722162069, 21933, 1566722162279, 22143, 210, true
11382, 1566722162070, 21934, 1566722162279, 22143, 209, true
11383, 1566722162071, 21935, 1566722162276, 22140, 205, true
11384, 1566722162071, 21935, 1566722162281, 22145, 210, true
11385, 1566722162072, 21936, 1566722162286, 22150, 214, true
11386, 1566722162073, 21937, 1566722162303, 22167, 230, true
11387, 1566722162073, 21937, 1566722162306, 22170, 233, true
11388, 1566722162074, 21938, 1566722162307, 22171, 233, true
11389, 1566722162074, 21938, 1566722162302, 22166, 228, true
11390, 1566722162074, 21938, 1566722162298, 22162, 224, true
11391, 1566722162074, 21938, 1566722162307, 22171, 233, true
11392, 1566722162075, 21939, 1566722162307, 22171, 232, true
11393, 1566722162076, 21940, 1566722162307, 22171, 231, true
11394, 1566722162077, 21941, 1566722162319, 22183, 242, true
11395, 1566722162077, 21941, 1566722162311, 22175, 234, true
11396, 1566722162078, 21942, 1566722162299, 22163, 221, true
11397, 1566722162079, 21943, 1566722162307, 22171, 228, true
11398, 1566722162079, 21943, 1566722162291, 22155, 212, true
11399, 1566722162079, 21943, 1566722162306, 22170, 227, true
11400, 1566722162079, 21943, 1566722162298, 22162, 219, true
11401, 1566722162080, 21944, 1566722162307, 22171, 227, true
11402, 1566722162080, 21944, 1566722162307, 22171, 227, true
11403, 1566722162080, 21944, 1566722162298, 22162, 218, true
11404, 1566722162081, 21945, 1566722162311, 22175, 230, true
11405, 1566722162081, 21945, 1566722162307, 22171, 226, true
11406, 1566722162081, 21945, 1566722162303, 22167, 222, true
11407, 1566722162082, 21946, 1566722162303, 22167, 221, true
11408, 1566722162082, 21946, 1566722162319, 22183, 237, true
11409, 1566722162083, 21947, 1566722162320, 22184, 237, true
11410, 1566722162083, 21947, 1566722162320, 22184, 237, true
11411, 1566722162084, 21948, 1566722162320, 22184, 236, true
11412, 1566722162084, 21948, 1566722162321, 22185, 237, true
11413, 1566722162084, 21948, 1566722162320, 22184, 236, true
11414, 1566722162085, 21949, 1566722162320, 22184, 235, true
11415, 1566722162085, 21949, 1566722162311, 22175, 226, true
11416, 1566722162085, 21949, 1566722162321, 22185, 236, true
11417, 1566722162086, 21950, 1566722162321, 22185, 235, true
11418, 1566722162086, 21950, 1566722162321, 22185, 235, true
11419, 1566722162086, 21950, 1566722162320, 22184, 234, true
11420, 1566722162086, 21950, 1566722162321, 22185, 235, true
11421, 1566722162087, 21951, 1566722162321, 22185, 234, true
11422, 1566722162087, 21951, 1566722162311, 22175, 224, true
11423, 1566722162087, 21951, 1566722162320, 22184, 233, true
11424, 1566722162088, 21952, 1566722162321, 22185, 233, true
11425, 1566722162088, 21952, 1566722162321, 22185, 233, true
11426, 1566722162088, 21952, 1566722162321, 22185, 233, true
11427, 1566722162089, 21953, 1566722162321, 22185, 232, true
11428, 1566722162089, 21953, 1566722162320, 22184, 231, true
11429, 1566722162090, 21954, 1566722162319, 22183, 229, true
11430, 1566722162091, 21955, 1566722162307, 22171, 216, true
11431, 1566722162091, 21955, 1566722162321, 22185, 230, true
11432, 1566722162091, 21955, 1566722162320, 22184, 229, true
11433, 1566722162092, 21956, 1566722162321, 22185, 229, true
11434, 1566722162092, 21956, 1566722162308, 22172, 216, true
11435, 1566722162092, 21956, 1566722162320, 22184, 228, true
11436, 1566722162093, 21957, 1566722162307, 22171, 214, true
11437, 1566722162093, 21957, 1566722162321, 22185, 228, true
11438, 1566722162094, 21958, 1566722162320, 22184, 226, true
11439, 1566722162094, 21958, 1566722162321, 22185, 227, true
11440, 1566722162095, 21959, 1566722162321, 22185, 226, true
11441, 1566722162095, 21959, 1566722162321, 22185, 226, true
11442, 1566722162096, 21960, 1566722162308, 22172, 212, true
11443, 1566722162097, 21961, 1566722162321, 22185, 224, true
11444, 1566722162112, 21976, 1566722162322, 22186, 210, true
11445, 1566722162113, 21977, 1566722162322, 22186, 209, true
11446, 1566722162114, 21978, 1566722162322, 22186, 208, true
11447, 1566722162116, 21980, 1566722162324, 22188, 208, true
11448, 1566722162118, 21982, 1566722162324, 22188, 206, true
11449, 1566722162118, 21982, 1566722162324, 22188, 206, true
11450, 1566722162120, 21984, 1566722162325, 22189, 205, true
11451, 1566722162121, 21985, 1566722162326, 22190, 205, true
11452, 1566722162123, 21987, 1566722162326, 22190, 203, true
11453, 1566722162124, 21988, 1566722162338, 22202, 214, true
11454, 1566722162128, 21992, 1566722162338, 22202, 210, true
11455, 1566722162130, 21994, 1566722162341, 22205, 211, true
11456, 1566722162130, 21994, 1566722162339, 22203, 209, true
11457, 1566722162131, 21995, 1566722162345, 22209, 214, true
11458, 1566722162132, 21996, 1566722162341, 22205, 209, true
11459, 1566722162133, 21997, 1566722162342, 22206, 209, true
11460, 1566722162136, 22000, 1566722162346, 22210, 210, true
11461, 1566722162138, 22002, 1566722162345, 22209, 207, true
11462, 1566722162140, 22004, 1566722162349, 22213, 209, true
11463, 1566722162140, 22004, 1566722162348, 22212, 208, true
11464, 1566722162141, 22005, 1566722162347, 22211, 206, true
11465, 1566722162142, 22006, 1566722162346, 22210, 204, true
11466, 1566722162145, 22009, 1566722162350, 22214, 205, true
11467, 1566722162147, 22011, 1566722162354, 22218, 207, true
11468, 1566722162150, 22014, 1566722162369, 22233, 219, true
11469, 1566722162152, 22016, 1566722162369, 22233, 217, true
11470, 1566722162156, 22020, 1566722162369, 22233, 213, true
11471, 1566722162157, 22021, 1566722162369, 22233, 212, true
11472, 1566722162158, 22022, 1566722162365, 22229, 207, true
11473, 1566722162159, 22023, 1566722162369, 22233, 210, true
11474, 1566722162160, 22024, 1566722162369, 22233, 209, true
11475, 1566722162161, 22025, 1566722162371, 22235, 210, true
11476, 1566722162162, 22026, 1566722162368, 22232, 206, true
11477, 1566722162165, 22029, 1566722162370, 22234, 205, true
11478, 1566722162166, 22030, 1566722162381, 22245, 215, true
11479, 1566722162166, 22030, 1566722162376, 22240, 210, true
11480, 1566722162167, 22031, 1566722162382, 22246, 215, true
11481, 1566722162167, 22031, 1566722162386, 22250, 219, true
11482, 1566722162170, 22034, 1566722162378, 22242, 208, true
11483, 1566722162171, 22035, 1566722162386, 22250, 215, true
11484, 1566722162171, 22035, 1566722162385, 22249, 214, true
11485, 1566722162171, 22035, 1566722162386, 22250, 215, true
11486, 1566722162172, 22036, 1566722162386, 22250, 214, true
11487, 1566722162173, 22037, 1566722162386, 22250, 213, true
11488, 1566722162174, 22038, 1566722162386, 22250, 212, true
11489, 1566722162174, 22038, 1566722162386, 22250, 212, true
11490, 1566722162174, 22038, 1566722162386, 22250, 212, true
11491, 1566722162174, 22038, 1566722162386, 22250, 212, true
11492, 1566722162175, 22039, 1566722162389, 22253, 214, true
11493, 1566722162175, 22039, 1566722162389, 22253, 214, true
11494, 1566722162176, 22040, 1566722162389, 22253, 213, true
11495, 1566722162177, 22041, 1566722162389, 22253, 212, true
11496, 1566722162179, 22043, 1566722162389, 22253, 210, true
11497, 1566722162181, 22045, 1566722162389, 22253, 208, true
11498, 1566722162182, 22046, 1566722162386, 22250, 204, true
11499, 1566722162182, 22046, 1566722162391, 22255, 209, true
11500, 1566722162185, 22049, 1566722162391, 22255, 206, true
11501, 1566722162186, 22050, 1566722162391, 22255, 205, true
11502, 1566722162187, 22051, 1566722162391, 22255, 204, true
11503, 1566722162188, 22052, 1566722162396, 22260, 208, true
11504, 1566722162189, 22053, 1566722162397, 22261, 208, true
11505, 1566722162190, 22054, 1566722162396, 22260, 206, true
11506, 1566722162190, 22054, 1566722162394, 22258, 204, true
11507, 1566722162191, 22055, 1566722162397, 22261, 206, true
11508, 1566722162192, 22056, 1566722162401, 22265, 209, true
11509, 1566722162192, 22056, 1566722162401, 22265, 209, true
11510, 1566722162192, 22056, 1566722162401, 22265, 209, true
11511, 1566722162193, 22057, 1566722162401, 22265, 208, true
11512, 1566722162193, 22057, 1566722162405, 22269, 212, true
11513, 1566722162193, 22057, 1566722162407, 22271, 214, true
11514, 1566722162195, 22059, 1566722162430, 22294, 235, true
11515, 1566722162196, 22060, 1566722162432, 22296, 236, true
11516, 1566722162197, 22061, 1566722162432, 22296, 235, true
11517, 1566722162198, 22062, 1566722162432, 22296, 234, true
11518, 1566722162199, 22063, 1566722162422, 22286, 223, true
11519, 1566722162205, 22069, 1566722162430, 22294, 225, true
11520, 1566722162206, 22070, 1566722162424, 22288, 218, true
11521, 1566722162206, 22070, 1566722162432, 22296, 226, true
11522, 1566722162209, 22073, 1566722162432, 22296, 223, true
11523, 1566722162210, 22074, 1566722162432, 22296, 222, true
11524, 1566722162211, 22075, 1566722162430, 22294, 219, true
11525, 1566722162217, 22081, 1566722162426, 22290, 209, true
11526, 1566722162217, 22081, 1566722162430, 22294, 213, true
11527, 1566722162218, 22082, 1566722162430, 22294, 212, true
11528, 1566722162219, 22083, 1566722162430, 22294, 211, true
11529, 1566722162220, 22084, 1566722162429, 22293, 209, true
11530, 1566722162220, 22084, 1566722162430, 22294, 210, true
11531, 1566722162221, 22085, 1566722162430, 22294, 209, true
11532, 1566722162225, 22089, 1566722162452, 22316, 227, true
11533, 1566722162225, 22089, 1566722162452, 22316, 227, true
11534, 1566722162231, 22095, 1566722162440, 22304, 209, true
11535, 1566722162235, 22099, 1566722162444, 22308, 209, true
11536, 1566722162241, 22105, 1566722162451, 22315, 210, true
11537, 1566722162248, 22112, 1566722162452, 22316, 204, true
11538, 1566722162248, 22112, 1566722162452, 22316, 204, true
11539, 1566722162249, 22113, 1566722162454, 22318, 205, true
11540, 1566722162251, 22115, 1566722162454, 22318, 203, true
11541, 1566722162252, 22116, 1566722162457, 22321, 205, true
11542, 1566722162253, 22117, 1566722162456, 22320, 203, true
11543, 1566722162253, 22117, 1566722162457, 22321, 204, true
11544, 1566722162254, 22118, 1566722162476, 22340, 222, true
11545, 1566722162258, 22122, 1566722162464, 22328, 206, true
11546, 1566722162259, 22123, 1566722162474, 22338, 215, true
11547, 1566722162269, 22133, 1566722162478, 22342, 209, true
11548, 1566722162269, 22133, 1566722162476, 22340, 207, true
11549, 1566722162271, 22135, 1566722162477, 22341, 206, true
11550, 1566722162271, 22135, 1566722162476, 22340, 205, true
11551, 1566722162272, 22136, 1566722162478, 22342, 206, true
11552, 1566722162272, 22136, 1566722162478, 22342, 206, true
11553, 1566722162273, 22137, 1566722162483, 22347, 210, true
11554, 1566722162276, 22140, 1566722162483, 22347, 207, true
11555, 1566722162280, 22144, 1566722162483, 22347, 203, true
11556, 1566722162281, 22145, 1566722162491, 22355, 210, true
11557, 1566722162282, 22146, 1566722162486, 22350, 204, true
11558, 1566722162282, 22146, 1566722162488, 22352, 206, true
11559, 1566722162283, 22147, 1566722162498, 22362, 215, true
11560, 1566722162284, 22148, 1566722162496, 22360, 212, true
11561, 1566722162286, 22150, 1566722162492, 22356, 206, true
11562, 1566722162286, 22150, 1566722162493, 22357, 207, true
11563, 1566722162287, 22151, 1566722162493, 22357, 206, true
11564, 1566722162288, 22152, 1566722162498, 22362, 210, true
11565, 1566722162289, 22153, 1566722162498, 22362, 209, true
11566, 1566722162290, 22154, 1566722162499, 22363, 209, true
11567, 1566722162293, 22157, 1566722162498, 22362, 205, true
11568, 1566722162295, 22159, 1566722162502, 22366, 207, true
11569, 1566722162300, 22164, 1566722162502, 22366, 202, true
11570, 1566722162336, 22200, 1566722162548, 22412, 212, true
11571, 1566722162343, 22207, 1566722162552, 22416, 209, true
11572, 1566722162351, 22215, 1566722162556, 22420, 205, true
11573, 1566722162353, 22217, 1566722162561, 22425, 208, true
11574, 1566722162354, 22218, 1566722162558, 22422, 204, true
11575, 1566722162356, 22220, 1566722162561, 22425, 205, true
11576, 1566722162357, 22221, 1566722162563, 22427, 206, true
11577, 1566722162359, 22223, 1566722162561, 22425, 202, true
11578, 1566722162360, 22224, 1566722162564, 22428, 204, true
11579, 1566722162361, 22225, 1566722162566, 22430, 205, true
11580, 1566722162363, 22227, 1566722162568, 22432, 205, true
11581, 1566722162365, 22229, 1566722162578, 22442, 213, true
11582, 1566722162372, 22236, 1566722162580, 22444, 208, true
11583, 1566722162374, 22238, 1566722162578, 22442, 204, true
11584, 1566722162375, 22239, 1566722162578, 22442, 203, true
11585, 1566722162377, 22241, 1566722162585, 22449, 208, true
11586, 1566722162378, 22242, 1566722162599, 22463, 221, true
11587, 1566722162399, 22263, 1566722162603, 22467, 204, true
11588, 1566722162403, 22267, 1566722162609, 22473, 206, true
11589, 1566722162406, 22270, 1566722162609, 22473, 203, true
11590, 1566722162408, 22272, 1566722162611, 22475, 203, true
11591, 1566722162409, 22273, 1566722162612, 22476, 203, true
11592, 1566722162410, 22274, 1566722162616, 22480, 206, true
11593, 1566722162411, 22275, 1566722162615, 22479, 204, true
11594, 1566722162412, 22276, 1566722162615, 22479, 203, true
11595, 1566722162413, 22277, 1566722162616, 22480, 203, true
11596, 1566722162414, 22278, 1566722162617, 22481, 203, true
11597, 1566722162416, 22280, 1566722162623, 22487, 207, true
11598, 1566722162417, 22281, 1566722162620, 22484, 203, true
11599, 1566722162417, 22281, 1566722162623, 22487, 206, true
11600, 1566722162418, 22282, 1566722162623, 22487, 205, true
11601, 1566722162419, 22283, 1566722162623, 22487, 204, true
11602, 1566722162420, 22284, 1566722162627, 22491, 207, true
11603, 1566722162422, 22286, 1566722162629, 22493, 207, true
11604, 1566722162422, 22286, 1566722162643, 22507, 221, true
11605, 1566722162422, 22286, 1566722162641, 22505, 219, true
11606, 1566722162423, 22287, 1566722162643, 22507, 220, true
11607, 1566722162423, 22287, 1566722162641, 22505, 218, true
11608, 1566722162423, 22287, 1566722162651, 22515, 228, true
11609, 1566722162424, 22288, 1566722162643, 22507, 219, true
11610, 1566722162425, 22289, 1566722162644, 22508, 219, true
11611, 1566722162426, 22290, 1566722162641, 22505, 215, true
11612, 1566722162435, 22299, 1566722162643, 22507, 208, true
11613, 1566722162435, 22299, 1566722162639, 22503, 204, true
11614, 1566722162435, 22299, 1566722162647, 22511, 212, true
11615, 1566722162440, 22304, 1566722162654, 22518, 214, true
11616, 1566722162441, 22305, 1566722162654, 22518, 213, true
11617, 1566722162441, 22305, 1566722162651, 22515, 210, true
11618, 1566722162441, 22305, 1566722162657, 22521, 216, true
11619, 1566722162441, 22305, 1566722162656, 22520, 215, true
11620, 1566722162442, 22306, 1566722162653, 22517, 211, true
11621, 1566722162442, 22306, 1566722162657, 22521, 215, true
11622, 1566722162443, 22307, 1566722162654, 22518, 211, true
11623, 1566722162446, 22310, 1566722162656, 22520, 210, true
11624, 1566722162446, 22310, 1566722162656, 22520, 210, true
11625, 1566722162448, 22312, 1566722162656, 22520, 208, true
11626, 1566722162448, 22312, 1566722162657, 22521, 209, true
11627, 1566722162449, 22313, 1566722162659, 22523, 210, true
11628, 1566722162452, 22316, 1566722162659, 22523, 207, true
11629, 1566722162455, 22319, 1566722162661, 22525, 206, true
11630, 1566722162455, 22319, 1566722162670, 22534, 215, true
11631, 1566722162458, 22322, 1566722162665, 22529, 207, true
11632, 1566722162458, 22322, 1566722162670, 22534, 212, true
11633, 1566722162459, 22323, 1566722162670, 22534, 211, true
11634, 1566722162459, 22323, 1566722162670, 22534, 211, true
11635, 1566722162459, 22323, 1566722162664, 22528, 205, true
11636, 1566722162460, 22324, 1566722162670, 22534, 210, true
11637, 1566722162461, 22325, 1566722162670, 22534, 209, true
11638, 1566722162462, 22326, 1566722162670, 22534, 208, true
11639, 1566722162464, 22328, 1566722162671, 22535, 207, true
11640, 1566722162465, 22329, 1566722162671, 22535, 206, true
11641, 1566722162466, 22330, 1566722162671, 22535, 205, true
11642, 1566722162467, 22331, 1566722162676, 22540, 209, true
11643, 1566722162468, 22332, 1566722162674, 22538, 206, true
11644, 1566722162469, 22333, 1566722162672, 22536, 203, true
11645, 1566722162469, 22333, 1566722162677, 22541, 208, true
11646, 1566722162470, 22334, 1566722162675, 22539, 205, true
11647, 1566722162471, 22335, 1566722162688, 22552, 217, true
11648, 1566722162472, 22336, 1566722162682, 22546, 210, true
11649, 1566722162473, 22337, 1566722162688, 22552, 215, true
11650, 1566722162478, 22342, 1566722162688, 22552, 210, true
11651, 1566722162478, 22342, 1566722162683, 22547, 205, true
11652, 1566722162479, 22343, 1566722162688, 22552, 209, true
11653, 1566722162479, 22343, 1566722162688, 22552, 209, true
11654, 1566722162480, 22344, 1566722162688, 22552, 208, true
11655, 1566722162481, 22345, 1566722162688, 22552, 207, true
11656, 1566722162484, 22348, 1566722162688, 22552, 204, true
11657, 1566722162485, 22349, 1566722162691, 22555, 206, true
11658, 1566722162486, 22350, 1566722162692, 22556, 206, true
11659, 1566722162486, 22350, 1566722162689, 22553, 203, true
11660, 1566722162486, 22350, 1566722162694, 22558, 208, true
11661, 1566722162488, 22352, 1566722162697, 22561, 209, true
11662, 1566722162489, 22353, 1566722162703, 22567, 214, true
11663, 1566722162490, 22354, 1566722162697, 22561, 207, true
11664, 1566722162491, 22355, 1566722162703, 22567, 212, true
11665, 1566722162492, 22356, 1566722162703, 22567, 211, true
11666, 1566722162494, 22358, 1566722162704, 22568, 210, true
11667, 1566722162494, 22358, 1566722162703, 22567, 209, true
11668, 1566722162495, 22359, 1566722162703, 22567, 208, true
11669, 1566722162499, 22363, 1566722162703, 22567, 204, true
11670, 1566722162499, 22363, 1566722162703, 22567, 204, true
11671, 1566722162501, 22365, 1566722162719, 22583, 218, true
11672, 1566722162503, 22367, 1566722162717, 22581, 214, true
11673, 1566722162503, 22367, 1566722162705, 22569, 202, true
11674, 1566722162503, 22367, 1566722162719, 22583, 216, true
11675, 1566722162504, 22368, 1566722162717, 22581, 213, true
11676, 1566722162505, 22369, 1566722162716, 22580, 211, true
11677, 1566722162505, 22369, 1566722162720, 22584, 215, true
11678, 1566722162506, 22370, 1566722162719, 22583, 213, true
11679, 1566722162507, 22371, 1566722162717, 22581, 210, true
11680, 1566722162508, 22372, 1566722162720, 22584, 212, true
11681, 1566722162509, 22373, 1566722162720, 22584, 211, true
11682, 1566722162510, 22374, 1566722162720, 22584, 210, true
11683, 1566722162511, 22375, 1566722162720, 22584, 209, true
11684, 1566722162511, 22375, 1566722162720, 22584, 209, true
11685, 1566722162512, 22376, 1566722162720, 22584, 208, true
11686, 1566722162513, 22377, 1566722162722, 22586, 209, true
11687, 1566722162514, 22378, 1566722162720, 22584, 206, true
11688, 1566722162515, 22379, 1566722162722, 22586, 207, true
11689, 1566722162516, 22380, 1566722162725, 22589, 209, true
11690, 1566722162517, 22381, 1566722162723, 22587, 206, true
11691, 1566722162518, 22382, 1566722162723, 22587, 205, true
11692, 1566722162519, 22383, 1566722162724, 22588, 205, true
11693, 1566722162520, 22384, 1566722162724, 22588, 204, true
11694, 1566722162522, 22386, 1566722162729, 22593, 207, true
11695, 1566722162523, 22387, 1566722162729, 22593, 206, true
11696, 1566722162524, 22388, 1566722162729, 22593, 205, true
11697, 1566722162525, 22389, 1566722162730, 22594, 205, true
11698, 1566722162525, 22389, 1566722162735, 22599, 210, true
11699, 1566722162526, 22390, 1566722162729, 22593, 203, true
11700, 1566722162527, 22391, 1566722162732, 22596, 205, true
11701, 1566722162527, 22391, 1566722162735, 22599, 208, true
11702, 1566722162528, 22392, 1566722162735, 22599, 207, true
11703, 1566722162528, 22392, 1566722162735, 22599, 207, true
11704, 1566722162529, 22393, 1566722162735, 22599, 206, true
11705, 1566722162530, 22394, 1566722162739, 22603, 209, true
11706, 1566722162531, 22395, 1566722162736, 22600, 205, true
11707, 1566722162532, 22396, 1566722162737, 22601, 205, true
11708, 1566722162533, 22397, 1566722162740, 22604, 207, true
11709, 1566722162534, 22398, 1566722162740, 22604, 206, true
11710, 1566722162535, 22399, 1566722162740, 22604, 205, true
11711, 1566722162536, 22400, 1566722162744, 22608, 208, true
11712, 1566722162538, 22402, 1566722162746, 22610, 208, true
11713, 1566722162539, 22403, 1566722162744, 22608, 205, true
11714, 1566722162541, 22405, 1566722162747, 22611, 206, true
11715, 1566722162542, 22406, 1566722162761, 22625, 219, true
11716, 1566722162543, 22407, 1566722162753, 22617, 210, true
11717, 1566722162543, 22407, 1566722162758, 22622, 215, true
11718, 1566722162544, 22408, 1566722162759, 22623, 215, true
11719, 1566722162545, 22409, 1566722162761, 22625, 216, true
11720, 1566722162555, 22419, 1566722162761, 22625, 206, true
11721, 1566722162556, 22420, 1566722162763, 22627, 207, true
11722, 1566722162558, 22422, 1566722162767, 22631, 209, true
11723, 1566722162564, 22428, 1566722162771, 22635, 207, true
11724, 1566722162565, 22429, 1566722162771, 22635, 206, true
11725, 1566722162566, 22430, 1566722162771, 22635, 205, true
11726, 1566722162568, 22432, 1566722162772, 22636, 204, true
11727, 1566722162569, 22433, 1566722162777, 22641, 208, true
11728, 1566722162569, 22433, 1566722162775, 22639, 206, true
11729, 1566722162569, 22433, 1566722162777, 22641, 208, true
11730, 1566722162570, 22434, 1566722162773, 22637, 203, true
11731, 1566722162571, 22435, 1566722162778, 22642, 207, true
11732, 1566722162572, 22436, 1566722162782, 22646, 210, true
11733, 1566722162573, 22437, 1566722162781, 22645, 208, true
11734, 1566722162574, 22438, 1566722162784, 22648, 210, true
11735, 1566722162576, 22440, 1566722162790, 22654, 214, true
11736, 1566722162581, 22445, 1566722162784, 22648, 203, true
11737, 1566722162581, 22445, 1566722162789, 22653, 208, true
11738, 1566722162583, 22447, 1566722162789, 22653, 206, true
11739, 1566722162583, 22447, 1566722162786, 22650, 203, true
11740, 1566722162584, 22448, 1566722162790, 22654, 206, true
11741, 1566722162586, 22450, 1566722162790, 22654, 204, true
11742, 1566722162587, 22451, 1566722162792, 22656, 205, true
11743, 1566722162588, 22452, 1566722162792, 22656, 204, true
11744, 1566722162588, 22452, 1566722162798, 22662, 210, true
11745, 1566722162588, 22452, 1566722162794, 22658, 206, true
11746, 1566722162589, 22453, 1566722162800, 22664, 211, true
11747, 1566722162590, 22454, 1566722162799, 22663, 209, true
11748, 1566722162591, 22455, 1566722162800, 22664, 209, true
11749, 1566722162592, 22456, 1566722162796, 22660, 204, true
11750, 1566722162594, 22458, 1566722162808, 22672, 214, true
11751, 1566722162594, 22458, 1566722162803, 22667, 209, true
11752, 1566722162595, 22459, 1566722162809, 22673, 214, true
11753, 1566722162596, 22460, 1566722162808, 22672, 212, true
11754, 1566722162596, 22460, 1566722162808, 22672, 212, true
11755, 1566722162596, 22460, 1566722162808, 22672, 212, true
11756, 1566722162597, 22461, 1566722162803, 22667, 206, true
11757, 1566722162597, 22461, 1566722162808, 22672, 211, true
11758, 1566722162597, 22461, 1566722162808, 22672, 211, true
11759, 1566722162597, 22461, 1566722162808, 22672, 211, true
11760, 1566722162598, 22462, 1566722162812, 22676, 214, true
11761, 1566722162598, 22462, 1566722162812, 22676, 214, true
11762, 1566722162604, 22468, 1566722162812, 22676, 208, true
11763, 1566722162605, 22469, 1566722162821, 22685, 216, true
11764, 1566722162605, 22469, 1566722162826, 22690, 221, true
11765, 1566722162606, 22470, 1566722162822, 22686, 216, true
11766, 1566722162607, 22471, 1566722162824, 22688, 217, true
11767, 1566722162612, 22476, 1566722162826, 22690, 214, true
11768, 1566722162613, 22477, 1566722162827, 22691, 214, true
11769, 1566722162613, 22477, 1566722162827, 22691, 214, true
11770, 1566722162616, 22480, 1566722162827, 22691, 211, true
11771, 1566722162618, 22482, 1566722162827, 22691, 209, true
11772, 1566722162619, 22483, 1566722162826, 22690, 207, true
11773, 1566722162620, 22484, 1566722162832, 22696, 212, true
11774, 1566722162620, 22484, 1566722162832, 22696, 212, true
11775, 1566722162621, 22485, 1566722162832, 22696, 211, true
11776, 1566722162624, 22488, 1566722162832, 22696, 208, true
11777, 1566722162625, 22489, 1566722162833, 22697, 208, true
11778, 1566722162625, 22489, 1566722162832, 22696, 207, true
11779, 1566722162627, 22491, 1566722162834, 22698, 207, true
11780, 1566722162628, 22492, 1566722162838, 22702, 210, true
11781, 1566722162628, 22492, 1566722162833, 22697, 205, true
11782, 1566722162630, 22494, 1566722162837, 22701, 207, true
11783, 1566722162630, 22494, 1566722162838, 22702, 208, true
11784, 1566722162631, 22495, 1566722162838, 22702, 207, true
11785, 1566722162634, 22498, 1566722162838, 22702, 204, true
11786, 1566722162634, 22498, 1566722162847, 22711, 213, true
11787, 1566722162634, 22498, 1566722162839, 22703, 205, true
11788, 1566722162635, 22499, 1566722162852, 22716, 217, true
11789, 1566722162635, 22499, 1566722162852, 22716, 217, true
11790, 1566722162636, 22500, 1566722162863, 22727, 227, true
11791, 1566722162644, 22508, 1566722162864, 22728, 220, true
11792, 1566722162645, 22509, 1566722162864, 22728, 219, true
11793, 1566722162645, 22509, 1566722162863, 22727, 218, true
11794, 1566722162646, 22510, 1566722162880, 22744, 234, true
11795, 1566722162647, 22511, 1566722162868, 22732, 221, true
11796, 1566722162647, 22511, 1566722162877, 22741, 230, true
11797, 1566722162648, 22512, 1566722162880, 22744, 232, true
11798, 1566722162649, 22513, 1566722162873, 22737, 224, true
11799, 1566722162649, 22513, 1566722162868, 22732, 219, true
11800, 1566722162649, 22513, 1566722162865, 22729, 216, true
11801, 1566722162657, 22521, 1566722162868, 22732, 211, true
11802, 1566722162664, 22528, 1566722162884, 22748, 220, true
11803, 1566722162666, 22530, 1566722162885, 22749, 219, true
11804, 1566722162679, 22543, 1566722162885, 22749, 206, true
11805, 1566722162681, 22545, 1566722162887, 22751, 206, true
11806, 1566722162692, 22556, 1566722162901, 22765, 209, true
11807, 1566722162694, 22558, 1566722162897, 22761, 203, true
11808, 1566722162695, 22559, 1566722162901, 22765, 206, true
11809, 1566722162698, 22562, 1566722162901, 22765, 203, true
11810, 1566722162699, 22563, 1566722162903, 22767, 204, true
11811, 1566722162707, 22571, 1566722162913, 22777, 206, true
11812, 1566722162741, 22605, 1566722162946, 22810, 205, true
11813, 1566722162742, 22606, 1566722162946, 22810, 204, true
11814, 1566722162744, 22608, 1566722162949, 22813, 205, true
11815, 1566722162749, 22613, 1566722162952, 22816, 203, true
11816, 1566722162751, 22615, 1566722162953, 22817, 202, true
11817, 1566722162751, 22615, 1566722162954, 22818, 203, true
11818, 1566722162752, 22616, 1566722162959, 22823, 207, true
11819, 1566722162753, 22617, 1566722162979, 22843, 226, true
11820, 1566722162753, 22617, 1566722162978, 22842, 225, true
11821, 1566722162753, 22617, 1566722162979, 22843, 226, true
11822, 1566722162753, 22617, 1566722162979, 22843, 226, true
11823, 1566722162754, 22618, 1566722162979, 22843, 225, true
11824, 1566722162755, 22619, 1566722162983, 22847, 228, true
11825, 1566722162755, 22619, 1566722162983, 22847, 228, true
11826, 1566722162755, 22619, 1566722162968, 22832, 213, true
11827, 1566722162755, 22619, 1566722162979, 22843, 224, true
11828, 1566722162756, 22620, 1566722162979, 22843, 223, true
11829, 1566722162756, 22620, 1566722162980, 22844, 224, true
11830, 1566722162756, 22620, 1566722162979, 22843, 223, true
11831, 1566722162756, 22620, 1566722162970, 22834, 214, true
11832, 1566722162757, 22621, 1566722162979, 22843, 222, true
11833, 1566722162758, 22622, 1566722162970, 22834, 212, true
11834, 1566722162758, 22622, 1566722162971, 22835, 213, true
11835, 1566722162759, 22623, 1566722162971, 22835, 212, true
11836, 1566722162760, 22624, 1566722162979, 22843, 219, true
11837, 1566722162761, 22625, 1566722162980, 22844, 219, true
11838, 1566722162762, 22626, 1566722162970, 22834, 208, true
11839, 1566722162762, 22626, 1566722162979, 22843, 217, true
11840, 1566722162762, 22626, 1566722162981, 22845, 219, true
11841, 1566722162763, 22627, 1566722162979, 22843, 216, true
11842, 1566722162764, 22628, 1566722162980, 22844, 216, true
11843, 1566722162765, 22629, 1566722162983, 22847, 218, true
11844, 1566722162774, 22638, 1566722162985, 22849, 211, true
11845, 1566722162778, 22642, 1566722162982, 22846, 204, true
11846, 1566722162778, 22642, 1566722162985, 22849, 207, true
11847, 1566722162782, 22646, 1566722162988, 22852, 206, true
11848, 1566722162782, 22646, 1566722162986, 22850, 204, true
11849, 1566722162783, 22647, 1566722162992, 22856, 209, true
11850, 1566722162783, 22647, 1566722162992, 22856, 209, true
11851, 1566722162786, 22650, 1566722162989, 22853, 203, true
11852, 1566722162787, 22651, 1566722162994, 22858, 207, true
11853, 1566722162787, 22651, 1566722162995, 22859, 208, true
11854, 1566722162788, 22652, 1566722162999, 22863, 211, true
11855, 1566722162792, 22656, 1566722163000, 22864, 208, true
11856, 1566722162793, 22657, 1566722162997, 22861, 204, true
11857, 1566722162793, 22657, 1566722162999, 22863, 206, true
11858, 1566722162795, 22659, 1566722163000, 22864, 205, true
11859, 1566722162795, 22659, 1566722163000, 22864, 205, true
11860, 1566722162795, 22659, 1566722163013, 22877, 218, true
11861, 1566722162800, 22664, 1566722163013, 22877, 213, true
11862, 1566722162801, 22665, 1566722163013, 22877, 212, true
11863, 1566722162803, 22667, 1566722163013, 22877, 210, true
11864, 1566722162813, 22677, 1566722163018, 22882, 205, true
11865, 1566722162814, 22678, 1566722163019, 22883, 205, true
11866, 1566722162814, 22678, 1566722163029, 22893, 215, true
11867, 1566722162814, 22678, 1566722163029, 22893, 215, true
11868, 1566722162814, 22678, 1566722163020, 22884, 206, true
11869, 1566722162814, 22678, 1566722163027, 22891, 213, true
11870, 1566722162815, 22679, 1566722163029, 22893, 214, true
11871, 1566722162815, 22679, 1566722163024, 22888, 209, true
11872, 1566722162816, 22680, 1566722163020, 22884, 204, true
11873, 1566722162818, 22682, 1566722163027, 22891, 209, true
11874, 1566722162818, 22682, 1566722163029, 22893, 211, true
11875, 1566722162819, 22683, 1566722163027, 22891, 208, true
11876, 1566722162821, 22685, 1566722163029, 22893, 208, true
11877, 1566722162822, 22686, 1566722163026, 22890, 204, true
11878, 1566722162827, 22691, 1566722163033, 22897, 206, true
11879, 1566722162827, 22691, 1566722163032, 22896, 205, true
11880, 1566722162827, 22691, 1566722163034, 22898, 207, true
11881, 1566722162828, 22692, 1566722163031, 22895, 203, true
11882, 1566722162828, 22692, 1566722163034, 22898, 206, true
11883, 1566722162828, 22692, 1566722163037, 22901, 209, true
11884, 1566722162834, 22698, 1566722163044, 22908, 210, true
11885, 1566722162834, 22698, 1566722163045, 22909, 211, true
11886, 1566722162834, 22698, 1566722163042, 22906, 208, true
11887, 1566722162835, 22699, 1566722163043, 22907, 208, true
11888, 1566722162835, 22699, 1566722163041, 22905, 206, true
11889, 1566722162835, 22699, 1566722163049, 22913, 214, true
11890, 1566722162836, 22700, 1566722163050, 22914, 214, true
11891, 1566722162840, 22704, 1566722163049, 22913, 209, true
11892, 1566722162840, 22704, 1566722163050, 22914, 210, true
11893, 1566722162841, 22705, 1566722163049, 22913, 208, true
11894, 1566722162841, 22705, 1566722163049, 22913, 208, true
11895, 1566722162843, 22707, 1566722163050, 22914, 207, true
11896, 1566722162845, 22709, 1566722163050, 22914, 205, true
11897, 1566722162845, 22709, 1566722163049, 22913, 204, true
11898, 1566722162847, 22711, 1566722163055, 22919, 208, true
11899, 1566722162848, 22712, 1566722163058, 22922, 210, true
11900, 1566722162848, 22712, 1566722163060, 22924, 212, true
11901, 1566722162848, 22712, 1566722163059, 22923, 211, true
11902, 1566722162849, 22713, 1566722163059, 22923, 210, true
11903, 1566722162849, 22713, 1566722163058, 22922, 209, true
11904, 1566722162849, 22713, 1566722163060, 22924, 211, true
11905, 1566722162850, 22714, 1566722163060, 22924, 210, true
11906, 1566722162850, 22714, 1566722163058, 22922, 208, true
11907, 1566722162855, 22719, 1566722163061, 22925, 206, true
11908, 1566722162857, 22721, 1566722163065, 22929, 208, true
11909, 1566722162857, 22721, 1566722163068, 22932, 211, true
11910, 1566722162857, 22721, 1566722163069, 22933, 212, true
11911, 1566722162858, 22722, 1566722163068, 22932, 210, true
11912, 1566722162858, 22722, 1566722163068, 22932, 210, true
11913, 1566722162859, 22723, 1566722163063, 22927, 204, true
11914, 1566722162859, 22723, 1566722163069, 22933, 210, true
11915, 1566722162859, 22723, 1566722163064, 22928, 205, true
11916, 1566722162860, 22724, 1566722163073, 22937, 213, true
11917, 1566722162861, 22725, 1566722163085, 22949, 224, true
11918, 1566722162866, 22730, 1566722163086, 22950, 220, true
11919, 1566722162866, 22730, 1566722163083, 22947, 217, true
11920, 1566722162867, 22731, 1566722163085, 22949, 218, true
11921, 1566722162869, 22733, 1566722163080, 22944, 211, true
11922, 1566722162870, 22734, 1566722163093, 22957, 223, true
11923, 1566722162870, 22734, 1566722163090, 22954, 220, true
11924, 1566722162870, 22734, 1566722163091, 22955, 221, true
11925, 1566722162871, 22735, 1566722163085, 22949, 214, true
11926, 1566722162871, 22735, 1566722163094, 22958, 223, true
11927, 1566722162871, 22735, 1566722163093, 22957, 222, true
11928, 1566722162872, 22736, 1566722163102, 22966, 230, true
11929, 1566722162872, 22736, 1566722163101, 22965, 229, true
11930, 1566722162874, 22738, 1566722163101, 22965, 227, true
11931, 1566722162875, 22739, 1566722163101, 22965, 226, true
11932, 1566722162876, 22740, 1566722163101, 22965, 225, true
11933, 1566722162878, 22742, 1566722163101, 22965, 223, true
11934, 1566722162878, 22742, 1566722163101, 22965, 223, true
11935, 1566722162881, 22745, 1566722163102, 22966, 221, true
11936, 1566722162882, 22746, 1566722163117, 22981, 235, true
11937, 1566722162882, 22746, 1566722163107, 22971, 225, true
11938, 1566722162885, 22749, 1566722163115, 22979, 230, true
11939, 1566722162885, 22749, 1566722163118, 22982, 233, true
11940, 1566722162886, 22750, 1566722163117, 22981, 231, true
11941, 1566722162886, 22750, 1566722163123, 22987, 237, true
11942, 1566722162887, 22751, 1566722163119, 22983, 232, true
11943, 1566722162888, 22752, 1566722163122, 22986, 234, true
11944, 1566722162889, 22753, 1566722163117, 22981, 228, true
11945, 1566722162890, 22754, 1566722163117, 22981, 227, true
11946, 1566722162891, 22755, 1566722163115, 22979, 224, true
11947, 1566722162892, 22756, 1566722163123, 22987, 231, true
11948, 1566722162893, 22757, 1566722163122, 22986, 229, true
11949, 1566722162894, 22758, 1566722163101, 22965, 207, true
11950, 1566722162895, 22759, 1566722163123, 22987, 228, true
11951, 1566722162898, 22762, 1566722163117, 22981, 219, true
11952, 1566722162899, 22763, 1566722163116, 22980, 217, true
11953, 1566722162902, 22766, 1566722163123, 22987, 221, true
11954, 1566722162903, 22767, 1566722163123, 22987, 220, true
11955, 1566722162907, 22771, 1566722163122, 22986, 215, true
11956, 1566722162907, 22771, 1566722163115, 22979, 208, true
11957, 1566722162908, 22772, 1566722163122, 22986, 214, true
11958, 1566722162908, 22772, 1566722163122, 22986, 214, true
11959, 1566722162909, 22773, 1566722163123, 22987, 214, true
11960, 1566722162910, 22774, 1566722163123, 22987, 213, true
11961, 1566722162911, 22775, 1566722163123, 22987, 212, true
11962, 1566722162912, 22776, 1566722163123, 22987, 211, true
11963, 1566722162913, 22777, 1566722163118, 22982, 205, true
11964, 1566722162914, 22778, 1566722163123, 22987, 209, true
11965, 1566722162914, 22778, 1566722163123, 22987, 209, true
11966, 1566722162915, 22779, 1566722163125, 22989, 210, true
11967, 1566722162915, 22779, 1566722163125, 22989, 210, true
11968, 1566722162918, 22782, 1566722163126, 22990, 208, true
11969, 1566722162918, 22782, 1566722163125, 22989, 207, true
11970, 1566722162918, 22782, 1566722163125, 22989, 207, true
11971, 1566722162919, 22783, 1566722163132, 22996, 213, true
11972, 1566722162920, 22784, 1566722163127, 22991, 207, true
11973, 1566722162920, 22784, 1566722163126, 22990, 206, true
11974, 1566722162921, 22785, 1566722163132, 22996, 211, true
11975, 1566722162925, 22789, 1566722163132, 22996, 207, true
11976, 1566722162925, 22789, 1566722163132, 22996, 207, true
11977, 1566722162925, 22789, 1566722163132, 22996, 207, true
11978, 1566722162926, 22790, 1566722163132, 22996, 206, true
11979, 1566722162927, 22791, 1566722163132, 22996, 205, true
11980, 1566722162929, 22793, 1566722163132, 22996, 203, true
11981, 1566722162931, 22795, 1566722163135, 22999, 204, true
11982, 1566722162933, 22797, 1566722163139, 23003, 206, true
11983, 1566722162934, 22798, 1566722163139, 23003, 205, true
11984, 1566722162936, 22800, 1566722163142, 23006, 206, true
11985, 1566722162940, 22804, 1566722163148, 23012, 208, true
11986, 1566722162942, 22806, 1566722163146, 23010, 204, true
11987, 1566722162946, 22810, 1566722163152, 23016, 206, true
11988, 1566722162947, 22811, 1566722163151, 23015, 204, true
11989, 1566722162949, 22813, 1566722163152, 23016, 203, true
11990, 1566722162950, 22814, 1566722163160, 23024, 210, true
11991, 1566722162958, 22822, 1566722163164, 23028, 206, true
11992, 1566722162960, 22824, 1566722163164, 23028, 204, true
11993, 1566722162961, 22825, 1566722163164, 23028, 203, true
11994, 1566722162962, 22826, 1566722163167, 23031, 205, true
11995, 1566722162964, 22828, 1566722163167, 23031, 203, true
11996, 1566722162965, 22829, 1566722163172, 23036, 207, true
11997, 1566722162968, 22832, 1566722163172, 23036, 204, true
11998, 1566722162972, 22836, 1566722163178, 23042, 206, true
11999, 1566722162973, 22837, 1566722163178, 23042, 205, true
12000, 1566722162974, 22838, 1566722163179, 23043, 205, true
12001, 1566722162990, 22854, 1566722163199, 23063, 209, true
12002, 1566722162995, 22859, 1566722163201, 23065, 206, true
12003, 1566722162995, 22859, 1566722163199, 23063, 204, true
12004, 1566722163001, 22865, 1566722163205, 23069, 204, true
12005, 1566722163001, 22865, 1566722163204, 23068, 203, true
12006, 1566722163001, 22865, 1566722163204, 23068, 203, true
12007, 1566722163002, 22866, 1566722163207, 23071, 205, true
12008, 1566722163002, 22866, 1566722163205, 23069, 203, true
12009, 1566722163003, 22867, 1566722163224, 23088, 221, true
12010, 1566722163016, 22880, 1566722163230, 23094, 214, true
12011, 1566722163020, 22884, 1566722163227, 23091, 207, true
12012, 1566722163020, 22884, 1566722163226, 23090, 206, true
12013, 1566722163021, 22885, 1566722163230, 23094, 209, true
12014, 1566722163022, 22886, 1566722163228, 23092, 206, true
12015, 1566722163024, 22888, 1566722163230, 23094, 206, true
12016, 1566722163035, 22899, 1566722163241, 23105, 206, true
12017, 1566722163036, 22900, 1566722163241, 23105, 205, true
12018, 1566722163038, 22902, 1566722163241, 23105, 203, true
12019, 1566722163039, 22903, 1566722163241, 23105, 202, true
12020, 1566722163040, 22904, 1566722163246, 23110, 206, true
12021, 1566722163042, 22906, 1566722163251, 23115, 209, true
12022, 1566722163042, 22906, 1566722163251, 23115, 209, true
12023, 1566722163043, 22907, 1566722163253, 23117, 210, true
12024, 1566722163050, 22914, 1566722163258, 23122, 208, true
12025, 1566722163050, 22914, 1566722163255, 23119, 205, true
12026, 1566722163051, 22915, 1566722163254, 23118, 203, true
12027, 1566722163051, 22915, 1566722163259, 23123, 208, true
12028, 1566722163052, 22916, 1566722163256, 23120, 204, true
12029, 1566722163052, 22916, 1566722163258, 23122, 206, true
12030, 1566722163053, 22917, 1566722163258, 23122, 205, true
12031, 1566722163053, 22917, 1566722163259, 23123, 206, true
12032, 1566722163053, 22917, 1566722163259, 23123, 206, true
12033, 1566722163055, 22919, 1566722163260, 23124, 205, true
12034, 1566722163056, 22920, 1566722163268, 23132, 212, true
12035, 1566722163062, 22926, 1566722163271, 23135, 209, true
12036, 1566722163062, 22926, 1566722163278, 23142, 216, true
12037, 1566722163065, 22929, 1566722163279, 23143, 214, true
12038, 1566722163066, 22930, 1566722163283, 23147, 217, true
12039, 1566722163070, 22934, 1566722163283, 23147, 213, true
12040, 1566722163070, 22934, 1566722163283, 23147, 213, true
12041, 1566722163074, 22938, 1566722163280, 23144, 206, true
12042, 1566722163075, 22939, 1566722163283, 23147, 208, true
12043, 1566722163077, 22941, 1566722163283, 23147, 206, true
12044, 1566722163078, 22942, 1566722163283, 23147, 205, true
12045, 1566722163078, 22942, 1566722163290, 23154, 212, true
12046, 1566722163080, 22944, 1566722163288, 23152, 208, true
12047, 1566722163081, 22945, 1566722163286, 23150, 205, true
12048, 1566722163081, 22945, 1566722163290, 23154, 209, true
12049, 1566722163081, 22945, 1566722163290, 23154, 209, true
12050, 1566722163081, 22945, 1566722163290, 23154, 209, true
12051, 1566722163081, 22945, 1566722163286, 23150, 205, true
12052, 1566722163082, 22946, 1566722163290, 23154, 208, true
12053, 1566722163088, 22952, 1566722163296, 23160, 208, true
12054, 1566722163088, 22952, 1566722163296, 23160, 208, true
12055, 1566722163089, 22953, 1566722163296, 23160, 207, true
12056, 1566722163089, 22953, 1566722163292, 23156, 203, true
12057, 1566722163091, 22955, 1566722163296, 23160, 205, true
12058, 1566722163092, 22956, 1566722163299, 23163, 207, true
12059, 1566722163094, 22958, 1566722163299, 23163, 205, true
12060, 1566722163094, 22958, 1566722163299, 23163, 205, true
12061, 1566722163095, 22959, 1566722163301, 23165, 206, true
12062, 1566722163095, 22959, 1566722163299, 23163, 204, true
12063, 1566722163095, 22959, 1566722163305, 23169, 210, true
12064, 1566722163096, 22960, 1566722163306, 23170, 210, true
12065, 1566722163097, 22961, 1566722163310, 23174, 213, true
12066, 1566722163105, 22969, 1566722163310, 23174, 205, true
12067, 1566722163105, 22969, 1566722163310, 23174, 205, true
12068, 1566722163105, 22969, 1566722163310, 23174, 205, true
12069, 1566722163106, 22970, 1566722163310, 23174, 204, true
12070, 1566722163107, 22971, 1566722163314, 23178, 207, true
12071, 1566722163108, 22972, 1566722163313, 23177, 205, true
12072, 1566722163108, 22972, 1566722163332, 23196, 224, true
12073, 1566722163108, 22972, 1566722163331, 23195, 223, true
12074, 1566722163108, 22972, 1566722163315, 23179, 207, true
12075, 1566722163109, 22973, 1566722163332, 23196, 223, true
12076, 1566722163109, 22973, 1566722163331, 23195, 222, true
12077, 1566722163109, 22973, 1566722163334, 23198, 225, true
12078, 1566722163110, 22974, 1566722163341, 23205, 231, true
12079, 1566722163111, 22975, 1566722163316, 23180, 205, true
12080, 1566722163111, 22975, 1566722163341, 23205, 230, true
12081, 1566722163112, 22976, 1566722163343, 23207, 231, true
12082, 1566722163113, 22977, 1566722163346, 23210, 233, true
12083, 1566722163136, 23000, 1566722163360, 23224, 224, true
12084, 1566722163137, 23001, 1566722163352, 23216, 215, true
12085, 1566722163137, 23001, 1566722163358, 23222, 221, true
12086, 1566722163139, 23003, 1566722163360, 23224, 221, true
12087, 1566722163140, 23004, 1566722163361, 23225, 221, true
12088, 1566722163142, 23006, 1566722163361, 23225, 219, true
12089, 1566722163143, 23007, 1566722163361, 23225, 218, true
12090, 1566722163153, 23017, 1566722163361, 23225, 208, true
12091, 1566722163154, 23018, 1566722163365, 23229, 211, true
12092, 1566722163154, 23018, 1566722163361, 23225, 207, true
12093, 1566722163156, 23020, 1566722163361, 23225, 205, true
12094, 1566722163156, 23020, 1566722163369, 23233, 213, true
12095, 1566722163157, 23021, 1566722163366, 23230, 209, true
12096, 1566722163157, 23021, 1566722163369, 23233, 212, true
12097, 1566722163158, 23022, 1566722163364, 23228, 206, true
12098, 1566722163159, 23023, 1566722163369, 23233, 210, true
12099, 1566722163161, 23025, 1566722163370, 23234, 209, true
12100, 1566722163161, 23025, 1566722163368, 23232, 207, true
12101, 1566722163165, 23029, 1566722163369, 23233, 204, true
12102, 1566722163165, 23029, 1566722163374, 23238, 209, true
12103, 1566722163165, 23029, 1566722163373, 23237, 208, true
12104, 1566722163168, 23032, 1566722163376, 23240, 208, true
12105, 1566722163168, 23032, 1566722163376, 23240, 208, true
12106, 1566722163168, 23032, 1566722163376, 23240, 208, true
12107, 1566722163169, 23033, 1566722163381, 23245, 212, true
12108, 1566722163169, 23033, 1566722163379, 23243, 210, true
12109, 1566722163170, 23034, 1566722163381, 23245, 211, true
12110, 1566722163170, 23034, 1566722163381, 23245, 211, true
12111, 1566722163172, 23036, 1566722163389, 23253, 217, true
12112, 1566722163173, 23037, 1566722163381, 23245, 208, true
12113, 1566722163173, 23037, 1566722163389, 23253, 216, true
12114, 1566722163174, 23038, 1566722163389, 23253, 215, true
12115, 1566722163177, 23041, 1566722163389, 23253, 212, true
12116, 1566722163183, 23047, 1566722163390, 23254, 207, true
12117, 1566722163183, 23047, 1566722163390, 23254, 207, true
12118, 1566722163183, 23047, 1566722163390, 23254, 207, true
12119, 1566722163184, 23048, 1566722163390, 23254, 206, true
12120, 1566722163184, 23048, 1566722163390, 23254, 206, true
12121, 1566722163185, 23049, 1566722163390, 23254, 205, true
12122, 1566722163186, 23050, 1566722163390, 23254, 204, true
12123, 1566722163188, 23052, 1566722163401, 23265, 213, true
12124, 1566722163189, 23053, 1566722163401, 23265, 212, true
12125, 1566722163189, 23053, 1566722163401, 23265, 212, true
12126, 1566722163190, 23054, 1566722163401, 23265, 211, true
12127, 1566722163191, 23055, 1566722163401, 23265, 210, true
12128, 1566722163192, 23056, 1566722163401, 23265, 209, true
12129, 1566722163193, 23057, 1566722163401, 23265, 208, true
12130, 1566722163195, 23059, 1566722163404, 23268, 209, true
12131, 1566722163196, 23060, 1566722163405, 23269, 209, true
12132, 1566722163196, 23060, 1566722163405, 23269, 209, true
12133, 1566722163197, 23061, 1566722163405, 23269, 208, true
12134, 1566722163197, 23061, 1566722163405, 23269, 208, true
12135, 1566722163198, 23062, 1566722163405, 23269, 207, true
12136, 1566722163199, 23063, 1566722163405, 23269, 206, true
12137, 1566722163202, 23066, 1566722163406, 23270, 204, true
12138, 1566722163205, 23069, 1566722163408, 23272, 203, true
12139, 1566722163206, 23070, 1566722163413, 23277, 207, true
12140, 1566722163208, 23072, 1566722163412, 23276, 204, true
12141, 1566722163208, 23072, 1566722163413, 23277, 205, true
12142, 1566722163209, 23073, 1566722163413, 23277, 204, true
12143, 1566722163210, 23074, 1566722163413, 23277, 203, true
12144, 1566722163210, 23074, 1566722163417, 23281, 207, true
12145, 1566722163211, 23075, 1566722163415, 23279, 204, true
12146, 1566722163211, 23075, 1566722163419, 23283, 208, true
12147, 1566722163212, 23076, 1566722163419, 23283, 207, true
12148, 1566722163213, 23077, 1566722163420, 23284, 207, true
12149, 1566722163214, 23078, 1566722163420, 23284, 206, true
12150, 1566722163215, 23079, 1566722163420, 23284, 205, true
12151, 1566722163217, 23081, 1566722163426, 23290, 209, true
12152, 1566722163217, 23081, 1566722163425, 23289, 208, true
12153, 1566722163218, 23082, 1566722163424, 23288, 206, true
12154, 1566722163219, 23083, 1566722163426, 23290, 207, true
12155, 1566722163219, 23083, 1566722163424, 23288, 205, true
12156, 1566722163219, 23083, 1566722163426, 23290, 207, true
12157, 1566722163220, 23084, 1566722163425, 23289, 205, true
12158, 1566722163222, 23086, 1566722163428, 23292, 206, true
12159, 1566722163223, 23087, 1566722163431, 23295, 208, true
12160, 1566722163224, 23088, 1566722163431, 23295, 207, true
12161, 1566722163225, 23089, 1566722163432, 23296, 207, true
12162, 1566722163227, 23091, 1566722163430, 23294, 203, true
12163, 1566722163228, 23092, 1566722163432, 23296, 204, true
12164, 1566722163231, 23095, 1566722163436, 23300, 205, true
12165, 1566722163231, 23095, 1566722163436, 23300, 205, true
12166, 1566722163232, 23096, 1566722163436, 23300, 204, true
12167, 1566722163232, 23096, 1566722163436, 23300, 204, true
12168, 1566722163233, 23097, 1566722163436, 23300, 203, true
12169, 1566722163233, 23097, 1566722163441, 23305, 208, true
12170, 1566722163233, 23097, 1566722163439, 23303, 206, true
12171, 1566722163234, 23098, 1566722163439, 23303, 205, true
12172, 1566722163235, 23099, 1566722163442, 23306, 207, true
12173, 1566722163235, 23099, 1566722163442, 23306, 207, true
12174, 1566722163236, 23100, 1566722163441, 23305, 205, true
12175, 1566722163236, 23100, 1566722163444, 23308, 208, true
12176, 1566722163238, 23102, 1566722163451, 23315, 213, true
12177, 1566722163242, 23106, 1566722163444, 23308, 202, true
12178, 1566722163243, 23107, 1566722163451, 23315, 208, true
12179, 1566722163243, 23107, 1566722163451, 23315, 208, true
12180, 1566722163244, 23108, 1566722163451, 23315, 207, true
12181, 1566722163244, 23108, 1566722163451, 23315, 207, true
12182, 1566722163245, 23109, 1566722163454, 23318, 209, true
12183, 1566722163246, 23110, 1566722163453, 23317, 207, true
12184, 1566722163247, 23111, 1566722163454, 23318, 207, true
12185, 1566722163248, 23112, 1566722163454, 23318, 206, true
12186, 1566722163248, 23112, 1566722163454, 23318, 206, true
12187, 1566722163249, 23113, 1566722163462, 23326, 213, true
12188, 1566722163253, 23117, 1566722163462, 23326, 209, true
12189, 1566722163255, 23119, 1566722163462, 23326, 207, true
12190, 1566722163261, 23125, 1566722163467, 23331, 206, true
12191, 1566722163261, 23125, 1566722163465, 23329, 204, true
12192, 1566722163262, 23126, 1566722163465, 23329, 203, true
12193, 1566722163263, 23127, 1566722163467, 23331, 204, true
12194, 1566722163263, 23127, 1566722163467, 23331, 204, true
12195, 1566722163264, 23128, 1566722163468, 23332, 204, true
12196, 1566722163265, 23129, 1566722163469, 23333, 204, true
12197, 1566722163266, 23130, 1566722163474, 23338, 208, true
12198, 1566722163268, 23132, 1566722163480, 23344, 212, true
12199, 1566722163271, 23135, 1566722163480, 23344, 209, true
12200, 1566722163273, 23137, 1566722163480, 23344, 207, true
12201, 1566722163274, 23138, 1566722163490, 23354, 216, true
12202, 1566722163275, 23139, 1566722163491, 23355, 216, true
12203, 1566722163291, 23155, 1566722163498, 23362, 207, true
12204, 1566722163307, 23171, 1566722163523, 23387, 216, true
12205, 1566722163307, 23171, 1566722163514, 23378, 207, true
12206, 1566722163308, 23172, 1566722163513, 23377, 205, true
12207, 1566722163317, 23181, 1566722163530, 23394, 213, true
12208, 1566722163318, 23182, 1566722163530, 23394, 212, true
12209, 1566722163318, 23182, 1566722163530, 23394, 212, true
12210, 1566722163318, 23182, 1566722163530, 23394, 212, true
12211, 1566722163319, 23183, 1566722163530, 23394, 211, true
12212, 1566722163319, 23183, 1566722163530, 23394, 211, true
12213, 1566722163320, 23184, 1566722163530, 23394, 210, true
12214, 1566722163325, 23189, 1566722163530, 23394, 205, true
12215, 1566722163326, 23190, 1566722163530, 23394, 204, true
12216, 1566722163328, 23192, 1566722163532, 23396, 204, true
12217, 1566722163332, 23196, 1566722163536, 23400, 204, true
12218, 1566722163335, 23199, 1566722163538, 23402, 203, true
12219, 1566722163336, 23200, 1566722163545, 23409, 209, true
12220, 1566722163337, 23201, 1566722163543, 23407, 206, true
12221, 1566722163337, 23201, 1566722163546, 23410, 209, true
12222, 1566722163337, 23201, 1566722163549, 23413, 212, true
12223, 1566722163343, 23207, 1566722163549, 23413, 206, true
12224, 1566722163344, 23208, 1566722163548, 23412, 204, true
12225, 1566722163346, 23210, 1566722163555, 23419, 209, true
12226, 1566722163347, 23211, 1566722163555, 23419, 208, true
12227, 1566722163349, 23213, 1566722163555, 23419, 206, true
12228, 1566722163351, 23215, 1566722163556, 23420, 205, true
12229, 1566722163352, 23216, 1566722163556, 23420, 204, true
12230, 1566722163355, 23219, 1566722163564, 23428, 209, true
12231, 1566722163355, 23219, 1566722163568, 23432, 213, true
12232, 1566722163372, 23236, 1566722163579, 23443, 207, true
12233, 1566722163372, 23236, 1566722163576, 23440, 204, true
12234, 1566722163376, 23240, 1566722163581, 23445, 205, true
12235, 1566722163377, 23241, 1566722163586, 23450, 209, true
12236, 1566722163377, 23241, 1566722163582, 23446, 205, true
12237, 1566722163379, 23243, 1566722163586, 23450, 207, true
12238, 1566722163379, 23243, 1566722163586, 23450, 207, true
12239, 1566722163382, 23246, 1566722163589, 23453, 207, true
12240, 1566722163382, 23246, 1566722163589, 23453, 207, true
12241, 1566722163383, 23247, 1566722163589, 23453, 206, true
12242, 1566722163383, 23247, 1566722163589, 23453, 206, true
12243, 1566722163383, 23247, 1566722163589, 23453, 206, true
12244, 1566722163384, 23248, 1566722163589, 23453, 205, true
12245, 1566722163391, 23255, 1566722163598, 23462, 207, true
12246, 1566722163392, 23256, 1566722163598, 23462, 206, true
12247, 1566722163392, 23256, 1566722163601, 23465, 209, true
12248, 1566722163393, 23257, 1566722163598, 23462, 205, true
12249, 1566722163394, 23258, 1566722163599, 23463, 205, true
12250, 1566722163395, 23259, 1566722163599, 23463, 204, true
12251, 1566722163396, 23260, 1566722163601, 23465, 205, true
12252, 1566722163397, 23261, 1566722163607, 23471, 210, true
12253, 1566722163398, 23262, 1566722163609, 23473, 211, true
12254, 1566722163406, 23270, 1566722163611, 23475, 205, true
12255, 1566722163406, 23270, 1566722163612, 23476, 206, true
12256, 1566722163407, 23271, 1566722163611, 23475, 204, true
12257, 1566722163407, 23271, 1566722163612, 23476, 205, true
12258, 1566722163409, 23273, 1566722163616, 23480, 207, true
12259, 1566722163415, 23279, 1566722163626, 23490, 211, true
12260, 1566722163419, 23283, 1566722163628, 23492, 209, true
12261, 1566722163420, 23284, 1566722163629, 23493, 209, true
12262, 1566722163421, 23285, 1566722163630, 23494, 209, true
12263, 1566722163422, 23286, 1566722163630, 23494, 208, true
12264, 1566722163422, 23286, 1566722163640, 23504, 218, true
12265, 1566722163428, 23292, 1566722163651, 23515, 223, true
12266, 1566722163428, 23292, 1566722163644, 23508, 216, true
12267, 1566722163429, 23293, 1566722163645, 23509, 216, true
12268, 1566722163429, 23293, 1566722163642, 23506, 213, true
12269, 1566722163429, 23293, 1566722163644, 23508, 215, true
12270, 1566722163432, 23296, 1566722163640, 23504, 208, true
12271, 1566722163433, 23297, 1566722163658, 23522, 225, true
12272, 1566722163433, 23297, 1566722163651, 23515, 218, true
12273, 1566722163433, 23297, 1566722163671, 23535, 238, true
12274, 1566722163434, 23298, 1566722163671, 23535, 237, true
12275, 1566722163436, 23300, 1566722163671, 23535, 235, true
12276, 1566722163437, 23301, 1566722163669, 23533, 232, true
12277, 1566722163437, 23301, 1566722163664, 23528, 227, true
12278, 1566722163438, 23302, 1566722163666, 23530, 228, true
12279, 1566722163438, 23302, 1566722163659, 23523, 221, true
12280, 1566722163440, 23304, 1566722163671, 23535, 231, true
12281, 1566722163443, 23307, 1566722163656, 23520, 213, true
12282, 1566722163445, 23309, 1566722163659, 23523, 214, true
12283, 1566722163445, 23309, 1566722163671, 23535, 226, true
12284, 1566722163445, 23309, 1566722163671, 23535, 226, true
12285, 1566722163446, 23310, 1566722163673, 23537, 227, true
12286, 1566722163451, 23315, 1566722163678, 23542, 227, true
12287, 1566722163455, 23319, 1566722163673, 23537, 218, true
12288, 1566722163456, 23320, 1566722163679, 23543, 223, true
12289, 1566722163469, 23333, 1566722163684, 23548, 215, true
12290, 1566722163470, 23334, 1566722163684, 23548, 214, true
12291, 1566722163470, 23334, 1566722163684, 23548, 214, true
12292, 1566722163470, 23334, 1566722163684, 23548, 214, true
12293, 1566722163471, 23335, 1566722163684, 23548, 213, true
12294, 1566722163471, 23335, 1566722163681, 23545, 210, true
12295, 1566722163472, 23336, 1566722163684, 23548, 212, true
12296, 1566722163473, 23337, 1566722163679, 23543, 206, true
12297, 1566722163473, 23337, 1566722163679, 23543, 206, true
12298, 1566722163475, 23339, 1566722163684, 23548, 209, true
12299, 1566722163480, 23344, 1566722163688, 23552, 208, true
12300, 1566722163481, 23345, 1566722163684, 23548, 203, true
12301, 1566722163481, 23345, 1566722163688, 23552, 207, true
12302, 1566722163481, 23345, 1566722163688, 23552, 207, true
12303, 1566722163482, 23346, 1566722163687, 23551, 205, true
12304, 1566722163483, 23347, 1566722163691, 23555, 208, true
12305, 1566722163484, 23348, 1566722163691, 23555, 207, true
12306, 1566722163485, 23349, 1566722163691, 23555, 206, true
12307, 1566722163485, 23349, 1566722163691, 23555, 206, true
12308, 1566722163488, 23352, 1566722163693, 23557, 205, true
12309, 1566722163488, 23352, 1566722163698, 23562, 210, true
12310, 1566722163489, 23353, 1566722163698, 23562, 209, true
12311, 1566722163491, 23355, 1566722163698, 23562, 207, true
12312, 1566722163492, 23356, 1566722163701, 23565, 209, true
12313, 1566722163492, 23356, 1566722163701, 23565, 209, true
12314, 1566722163493, 23357, 1566722163702, 23566, 209, true
12315, 1566722163493, 23357, 1566722163702, 23566, 209, true
12316, 1566722163494, 23358, 1566722163704, 23568, 210, true
12317, 1566722163496, 23360, 1566722163704, 23568, 208, true
12318, 1566722163497, 23361, 1566722163703, 23567, 206, true
12319, 1566722163499, 23363, 1566722163704, 23568, 205, true
12320, 1566722163500, 23364, 1566722163704, 23568, 204, true
12321, 1566722163501, 23365, 1566722163706, 23570, 205, true
12322, 1566722163501, 23365, 1566722163707, 23571, 206, true
12323, 1566722163502, 23366, 1566722163707, 23571, 205, true
12324, 1566722163503, 23367, 1566722163707, 23571, 204, true
12325, 1566722163504, 23368, 1566722163710, 23574, 206, true
12326, 1566722163505, 23369, 1566722163710, 23574, 205, true
12327, 1566722163505, 23369, 1566722163711, 23575, 206, true
12328, 1566722163506, 23370, 1566722163710, 23574, 204, true
12329, 1566722163508, 23372, 1566722163711, 23575, 203, true
12330, 1566722163508, 23372, 1566722163712, 23576, 204, true
12331, 1566722163510, 23374, 1566722163719, 23583, 209, true
12332, 1566722163510, 23374, 1566722163719, 23583, 209, true
12333, 1566722163511, 23375, 1566722163719, 23583, 208, true
12334, 1566722163511, 23375, 1566722163719, 23583, 208, true
12335, 1566722163512, 23376, 1566722163719, 23583, 207, true
12336, 1566722163515, 23379, 1566722163719, 23583, 204, true
12337, 1566722163516, 23380, 1566722163723, 23587, 207, true
12338, 1566722163517, 23381, 1566722163723, 23587, 206, true
12339, 1566722163518, 23382, 1566722163725, 23589, 207, true
12340, 1566722163519, 23383, 1566722163725, 23589, 206, true
12341, 1566722163519, 23383, 1566722163725, 23589, 206, true
12342, 1566722163519, 23383, 1566722163725, 23589, 206, true
12343, 1566722163521, 23385, 1566722163732, 23596, 211, true
12344, 1566722163522, 23386, 1566722163731, 23595, 209, true
12345, 1566722163524, 23388, 1566722163730, 23594, 206, true
12346, 1566722163525, 23389, 1566722163732, 23596, 207, true
12347, 1566722163526, 23390, 1566722163736, 23600, 210, true
12348, 1566722163532, 23396, 1566722163736, 23600, 204, true
12349, 1566722163532, 23396, 1566722163738, 23602, 206, true
12350, 1566722163533, 23397, 1566722163736, 23600, 203, true
12351, 1566722163534, 23398, 1566722163738, 23602, 204, true
12352, 1566722163534, 23398, 1566722163738, 23602, 204, true
12353, 1566722163534, 23398, 1566722163739, 23603, 205, true
12354, 1566722163535, 23399, 1566722163741, 23605, 206, true
12355, 1566722163537, 23401, 1566722163741, 23605, 204, true
12356, 1566722163539, 23403, 1566722163747, 23611, 208, true
12357, 1566722163539, 23403, 1566722163747, 23611, 208, true
12358, 1566722163540, 23404, 1566722163745, 23609, 205, true
12359, 1566722163541, 23405, 1566722163750, 23614, 209, true
12360, 1566722163542, 23406, 1566722163751, 23615, 209, true
12361, 1566722163542, 23406, 1566722163751, 23615, 209, true
12362, 1566722163543, 23407, 1566722163753, 23617, 210, true
12363, 1566722163543, 23407, 1566722163753, 23617, 210, true
12364, 1566722163544, 23408, 1566722163754, 23618, 210, true
12365, 1566722163544, 23408, 1566722163753, 23617, 209, true
12366, 1566722163546, 23410, 1566722163753, 23617, 207, true
12367, 1566722163548, 23412, 1566722163754, 23618, 206, true
12368, 1566722163551, 23415, 1566722163760, 23624, 209, true
12369, 1566722163551, 23415, 1566722163757, 23621, 206, true
12370, 1566722163552, 23416, 1566722163766, 23630, 214, true
12371, 1566722163552, 23416, 1566722163766, 23630, 214, true
12372, 1566722163553, 23417, 1566722163762, 23626, 209, true
12373, 1566722163557, 23421, 1566722163762, 23626, 205, true
12374, 1566722163558, 23422, 1566722163766, 23630, 208, true
12375, 1566722163558, 23422, 1566722163766, 23630, 208, true
12376, 1566722163558, 23422, 1566722163766, 23630, 208, true
12377, 1566722163560, 23424, 1566722163765, 23629, 205, true
12378, 1566722163560, 23424, 1566722163767, 23631, 207, true
12379, 1566722163561, 23425, 1566722163769, 23633, 208, true
12380, 1566722163561, 23425, 1566722163768, 23632, 207, true
12381, 1566722163563, 23427, 1566722163768, 23632, 205, true
12382, 1566722163564, 23428, 1566722163774, 23638, 210, true
12383, 1566722163565, 23429, 1566722163777, 23641, 212, true
12384, 1566722163566, 23430, 1566722163777, 23641, 211, true
12385, 1566722163566, 23430, 1566722163783, 23647, 217, true
12386, 1566722163569, 23433, 1566722163776, 23640, 207, true
12387, 1566722163569, 23433, 1566722163783, 23647, 214, true
12388, 1566722163570, 23434, 1566722163783, 23647, 213, true
12389, 1566722163571, 23435, 1566722163783, 23647, 212, true
12390, 1566722163572, 23436, 1566722163783, 23647, 211, true
12391, 1566722163573, 23437, 1566722163788, 23652, 215, true
12392, 1566722163573, 23437, 1566722163792, 23656, 219, true
12393, 1566722163574, 23438, 1566722163790, 23654, 216, true
12394, 1566722163577, 23441, 1566722163790, 23654, 213, true
12395, 1566722163577, 23441, 1566722163793, 23657, 216, true
12396, 1566722163578, 23442, 1566722163790, 23654, 212, true
12397, 1566722163579, 23443, 1566722163790, 23654, 211, true
12398, 1566722163582, 23446, 1566722163792, 23656, 210, true
12399, 1566722163582, 23446, 1566722163798, 23662, 216, true
12400, 1566722163589, 23453, 1566722163798, 23662, 209, true
12401, 1566722163589, 23453, 1566722163793, 23657, 204, true
12402, 1566722163590, 23454, 1566722163796, 23660, 206, true
12403, 1566722163590, 23454, 1566722163797, 23661, 207, true
12404, 1566722163590, 23454, 1566722163798, 23662, 208, true
12405, 1566722163592, 23456, 1566722163796, 23660, 204, true
12406, 1566722163593, 23457, 1566722163800, 23664, 207, true
12407, 1566722163594, 23458, 1566722163798, 23662, 204, true
12408, 1566722163595, 23459, 1566722163802, 23666, 207, true
12409, 1566722163595, 23459, 1566722163804, 23668, 209, true
12410, 1566722163595, 23459, 1566722163804, 23668, 209, true
12411, 1566722163602, 23466, 1566722163808, 23672, 206, true
12412, 1566722163603, 23467, 1566722163808, 23672, 205, true
12413, 1566722163604, 23468, 1566722163808, 23672, 204, true
12414, 1566722163604, 23468, 1566722163808, 23672, 204, true
12415, 1566722163604, 23468, 1566722163808, 23672, 204, true
12416, 1566722163606, 23470, 1566722163812, 23676, 206, true
12417, 1566722163606, 23470, 1566722163812, 23676, 206, true
12418, 1566722163609, 23473, 1566722163817, 23681, 208, true
12419, 1566722163609, 23473, 1566722163820, 23684, 211, true
12420, 1566722163613, 23477, 1566722163826, 23690, 213, true
12421, 1566722163613, 23477, 1566722163820, 23684, 207, true
12422, 1566722163613, 23477, 1566722163821, 23685, 208, true
12423, 1566722163614, 23478, 1566722163821, 23685, 207, true
12424, 1566722163614, 23478, 1566722163820, 23684, 206, true
12425, 1566722163615, 23479, 1566722163826, 23690, 211, true
12426, 1566722163617, 23481, 1566722163826, 23690, 209, true
12427, 1566722163618, 23482, 1566722163824, 23688, 206, true
12428, 1566722163618, 23482, 1566722163826, 23690, 208, true
12429, 1566722163619, 23483, 1566722163827, 23691, 208, true
12430, 1566722163620, 23484, 1566722163832, 23696, 212, true
12431, 1566722163624, 23488, 1566722163840, 23704, 216, true
12432, 1566722163626, 23490, 1566722163840, 23704, 214, true
12433, 1566722163628, 23492, 1566722163841, 23705, 213, true
12434, 1566722163631, 23495, 1566722163841, 23705, 210, true
12435, 1566722163631, 23495, 1566722163842, 23706, 211, true
12436, 1566722163631, 23495, 1566722163841, 23705, 210, true
12437, 1566722163631, 23495, 1566722163843, 23707, 212, true
12438, 1566722163631, 23495, 1566722163843, 23707, 212, true
12439, 1566722163632, 23496, 1566722163843, 23707, 211, true
12440, 1566722163632, 23496, 1566722163843, 23707, 211, true
12441, 1566722163633, 23497, 1566722163843, 23707, 210, true
12442, 1566722163637, 23501, 1566722163847, 23711, 210, true
12443, 1566722163637, 23501, 1566722163847, 23711, 210, true
12444, 1566722163638, 23502, 1566722163844, 23708, 206, true
12445, 1566722163638, 23502, 1566722163850, 23714, 212, true
12446, 1566722163641, 23505, 1566722163844, 23708, 203, true
12447, 1566722163643, 23507, 1566722163850, 23714, 207, true
12448, 1566722163645, 23509, 1566722163851, 23715, 206, true
12449, 1566722163646, 23510, 1566722163851, 23715, 205, true
12450, 1566722163647, 23511, 1566722163851, 23715, 204, true
12451, 1566722163647, 23511, 1566722163852, 23716, 205, true
12452, 1566722163648, 23512, 1566722163856, 23720, 208, true
12453, 1566722163649, 23513, 1566722163858, 23722, 209, true
12454, 1566722163652, 23516, 1566722163861, 23725, 209, true
12455, 1566722163653, 23517, 1566722163864, 23728, 211, true
12456, 1566722163653, 23517, 1566722163868, 23732, 215, true
12457, 1566722163653, 23517, 1566722163869, 23733, 216, true
12458, 1566722163653, 23517, 1566722163862, 23726, 209, true
12459, 1566722163654, 23518, 1566722163866, 23730, 212, true
12460, 1566722163655, 23519, 1566722163864, 23728, 209, true
12461, 1566722163661, 23525, 1566722163869, 23733, 208, true
12462, 1566722163662, 23526, 1566722163869, 23733, 207, true
12463, 1566722163662, 23526, 1566722163869, 23733, 207, true
12464, 1566722163663, 23527, 1566722163869, 23733, 206, true
12465, 1566722163664, 23528, 1566722163870, 23734, 206, true
12466, 1566722163665, 23529, 1566722163870, 23734, 205, true
12467, 1566722163666, 23530, 1566722163875, 23739, 209, true
12468, 1566722163666, 23530, 1566722163876, 23740, 210, true
12469, 1566722163675, 23539, 1566722163886, 23750, 211, true
12470, 1566722163676, 23540, 1566722163885, 23749, 209, true
12471, 1566722163676, 23540, 1566722163885, 23749, 209, true
12472, 1566722163685, 23549, 1566722163895, 23759, 210, true
12473, 1566722163716, 23580, 1566722163924, 23788, 208, true
12474, 1566722163721, 23585, 1566722163933, 23797, 212, true
12475, 1566722163721, 23585, 1566722163945, 23809, 224, true
12476, 1566722163723, 23587, 1566722163944, 23808, 221, true
12477, 1566722163743, 23607, 1566722163951, 23815, 208, true
12478, 1566722163744, 23608, 1566722163948, 23812, 204, true
12479, 1566722163748, 23612, 1566722163957, 23821, 209, true
12480, 1566722163749, 23613, 1566722163955, 23819, 206, true
12481, 1566722163756, 23620, 1566722163960, 23824, 204, true
12482, 1566722163758, 23622, 1566722163965, 23829, 207, true
12483, 1566722163759, 23623, 1566722163963, 23827, 204, true
12484, 1566722163759, 23623, 1566722163971, 23835, 212, true
12485, 1566722163772, 23636, 1566722163977, 23841, 205, true
12486, 1566722163773, 23637, 1566722163977, 23841, 204, true
12487, 1566722163777, 23641, 1566722163989, 23853, 212, true
12488, 1566722163779, 23643, 1566722163989, 23853, 210, true
12489, 1566722163786, 23650, 1566722163995, 23859, 209, true
12490, 1566722163787, 23651, 1566722163993, 23857, 206, true
12491, 1566722163794, 23658, 1566722164012, 23876, 218, true
12492, 1566722163794, 23658, 1566722164012, 23876, 218, true
12493, 1566722163795, 23659, 1566722164012, 23876, 217, true
12494, 1566722163799, 23663, 1566722164011, 23875, 212, true
12495, 1566722163799, 23663, 1566722164011, 23875, 212, true
12496, 1566722163803, 23667, 1566722164011, 23875, 208, true
12497, 1566722163809, 23673, 1566722164019, 23883, 210, true
12498, 1566722163809, 23673, 1566722164019, 23883, 210, true
12499, 1566722163809, 23673, 1566722164019, 23883, 210, true
12500, 1566722163810, 23674, 1566722164020, 23884, 210, true
12501, 1566722163810, 23674, 1566722164020, 23884, 210, true
12502, 1566722163810, 23674, 1566722164019, 23883, 209, true
12503, 1566722163813, 23677, 1566722164028, 23892, 215, true
12504, 1566722163813, 23677, 1566722164031, 23895, 218, true
12505, 1566722163814, 23678, 1566722164029, 23893, 215, true
12506, 1566722163822, 23686, 1566722164036, 23900, 214, true
12507, 1566722163822, 23686, 1566722164035, 23899, 213, true
12508, 1566722163823, 23687, 1566722164048, 23912, 225, true
12509, 1566722163827, 23691, 1566722164038, 23902, 211, true
12510, 1566722163848, 23712, 1566722164058, 23922, 210, true
12511, 1566722163855, 23719, 1566722164060, 23924, 205, true
12512, 1566722163857, 23721, 1566722164070, 23934, 213, true
12513, 1566722163857, 23721, 1566722164069, 23933, 212, true
12514, 1566722163859, 23723, 1566722164069, 23933, 210, true
12515, 1566722163859, 23723, 1566722164069, 23933, 210, true
12516, 1566722163860, 23724, 1566722164069, 23933, 209, true
12517, 1566722163860, 23724, 1566722164069, 23933, 209, true
12518, 1566722163860, 23724, 1566722164083, 23947, 223, true
12519, 1566722163860, 23724, 1566722164083, 23947, 223, true
12520, 1566722163862, 23726, 1566722164083, 23947, 221, true
12521, 1566722163871, 23735, 1566722164083, 23947, 212, true
12522, 1566722163872, 23736, 1566722164080, 23944, 208, true
12523, 1566722163872, 23736, 1566722164083, 23947, 211, true
12524, 1566722163873, 23737, 1566722164083, 23947, 210, true
12525, 1566722163873, 23737, 1566722164078, 23942, 205, true
12526, 1566722163873, 23737, 1566722164086, 23950, 213, true
12527, 1566722163879, 23743, 1566722164086, 23950, 207, true
12528, 1566722163879, 23743, 1566722164086, 23950, 207, true
12529, 1566722163879, 23743, 1566722164086, 23950, 207, true
12530, 1566722163882, 23746, 1566722164088, 23952, 206, true
12531, 1566722163883, 23747, 1566722164089, 23953, 206, true
12532, 1566722163886, 23750, 1566722164091, 23955, 205, true
12533, 1566722163886, 23750, 1566722164091, 23955, 205, true
12534, 1566722163887, 23751, 1566722164091, 23955, 204, true
12535, 1566722163887, 23751, 1566722164093, 23957, 206, true
12536, 1566722163888, 23752, 1566722164092, 23956, 204, true
12537, 1566722163889, 23753, 1566722164100, 23964, 211, true
12538, 1566722163889, 23753, 1566722164100, 23964, 211, true
12539, 1566722163889, 23753, 1566722164100, 23964, 211, true
12540, 1566722163890, 23754, 1566722164100, 23964, 210, true
12541, 1566722163891, 23755, 1566722164100, 23964, 209, true
12542, 1566722163894, 23758, 1566722164107, 23971, 213, true
12543, 1566722163895, 23759, 1566722164103, 23967, 208, true
12544, 1566722163896, 23760, 1566722164103, 23967, 207, true
12545, 1566722163897, 23761, 1566722164108, 23972, 211, true
12546, 1566722163898, 23762, 1566722164109, 23973, 211, true
12547, 1566722163898, 23762, 1566722164105, 23969, 207, true
12548, 1566722163900, 23764, 1566722164108, 23972, 208, true
12549, 1566722163901, 23765, 1566722164115, 23979, 214, true
12550, 1566722163901, 23765, 1566722164109, 23973, 208, true
12551, 1566722163902, 23766, 1566722164109, 23973, 207, true
12552, 1566722163902, 23766, 1566722164114, 23978, 212, true
12553, 1566722163903, 23767, 1566722164116, 23980, 213, true
12554, 1566722163904, 23768, 1566722164121, 23985, 217, true
12555, 1566722163904, 23768, 1566722164122, 23986, 218, true
12556, 1566722163905, 23769, 1566722164116, 23980, 211, true
12557, 1566722163906, 23770, 1566722164122, 23986, 216, true
12558, 1566722163907, 23771, 1566722164122, 23986, 215, true
12559, 1566722163907, 23771, 1566722164124, 23988, 217, true
12560, 1566722163907, 23771, 1566722164118, 23982, 211, true
12561, 1566722163908, 23772, 1566722164118, 23982, 210, true
12562, 1566722163909, 23773, 1566722164124, 23988, 215, true
12563, 1566722163909, 23773, 1566722164121, 23985, 212, true
12564, 1566722163909, 23773, 1566722164122, 23986, 213, true
12565, 1566722163909, 23773, 1566722164124, 23988, 215, true
12566, 1566722163910, 23774, 1566722164121, 23985, 211, true
12567, 1566722163910, 23774, 1566722164124, 23988, 214, true
12568, 1566722163910, 23774, 1566722164122, 23986, 212, true
12569, 1566722163911, 23775, 1566722164124, 23988, 213, true
12570, 1566722163911, 23775, 1566722164124, 23988, 213, true
12571, 1566722163912, 23776, 1566722164124, 23988, 212, true
12572, 1566722163920, 23784, 1566722164126, 23990, 206, true
12573, 1566722163921, 23785, 1566722164125, 23989, 204, true
12574, 1566722163921, 23785, 1566722164127, 23991, 206, true
12575, 1566722163922, 23786, 1566722164131, 23995, 209, true
12576, 1566722163923, 23787, 1566722164131, 23995, 208, true
12577, 1566722163924, 23788, 1566722164131, 23995, 207, true
12578, 1566722163925, 23789, 1566722164131, 23995, 206, true
12579, 1566722163926, 23790, 1566722164131, 23995, 205, true
12580, 1566722163928, 23792, 1566722164131, 23995, 203, true
12581, 1566722163928, 23792, 1566722164133, 23997, 205, true
12582, 1566722163929, 23793, 1566722164140, 24004, 211, true
12583, 1566722163929, 23793, 1566722164138, 24002, 209, true
12584, 1566722163930, 23794, 1566722164141, 24005, 211, true
12585, 1566722163931, 23795, 1566722164140, 24004, 209, true
12586, 1566722163931, 23795, 1566722164140, 24004, 209, true
12587, 1566722163931, 23795, 1566722164140, 24004, 209, true
12588, 1566722163932, 23796, 1566722164137, 24001, 205, true
12589, 1566722163932, 23796, 1566722164140, 24004, 208, true
12590, 1566722163937, 23801, 1566722164143, 24007, 206, true
12591, 1566722163937, 23801, 1566722164143, 24007, 206, true
12592, 1566722163938, 23802, 1566722164147, 24011, 209, true
12593, 1566722163939, 23803, 1566722164151, 24015, 212, true
12594, 1566722163940, 23804, 1566722164151, 24015, 211, true
12595, 1566722163941, 23805, 1566722164148, 24012, 207, true
12596, 1566722163942, 23806, 1566722164151, 24015, 209, true
12597, 1566722163945, 23809, 1566722164151, 24015, 206, true
12598, 1566722163945, 23809, 1566722164151, 24015, 206, true
12599, 1566722163946, 23810, 1566722164151, 24015, 205, true
12600, 1566722163947, 23811, 1566722164158, 24022, 211, true
12601, 1566722163948, 23812, 1566722164157, 24021, 209, true
12602, 1566722163949, 23813, 1566722164158, 24022, 209, true
12603, 1566722163949, 23813, 1566722164158, 24022, 209, true
12604, 1566722163951, 23815, 1566722164157, 24021, 206, true
12605, 1566722163952, 23816, 1566722164164, 24028, 212, true
12606, 1566722163952, 23816, 1566722164164, 24028, 212, true
12607, 1566722163952, 23816, 1566722164158, 24022, 206, true
12608, 1566722163953, 23817, 1566722164160, 24024, 207, true
12609, 1566722163954, 23818, 1566722164164, 24028, 210, true
12610, 1566722163954, 23818, 1566722164160, 24024, 206, true
12611, 1566722163955, 23819, 1566722164164, 24028, 209, true
12612, 1566722163956, 23820, 1566722164166, 24030, 210, true
12613, 1566722163957, 23821, 1566722164166, 24030, 209, true
12614, 1566722163958, 23822, 1566722164166, 24030, 208, true
12615, 1566722163961, 23825, 1566722164166, 24030, 205, true
12616, 1566722163961, 23825, 1566722164172, 24036, 211, true
12617, 1566722163964, 23828, 1566722164172, 24036, 208, true
12618, 1566722163965, 23829, 1566722164172, 24036, 207, true
12619, 1566722163967, 23831, 1566722164171, 24035, 204, true
12620, 1566722163968, 23832, 1566722164172, 24036, 204, true
12621, 1566722163968, 23832, 1566722164180, 24044, 212, true
12622, 1566722163969, 23833, 1566722164177, 24041, 208, true
12623, 1566722163969, 23833, 1566722164180, 24044, 211, true
12624, 1566722163970, 23834, 1566722164180, 24044, 210, true
12625, 1566722163972, 23836, 1566722164179, 24043, 207, true
12626, 1566722163973, 23837, 1566722164180, 24044, 207, true
12627, 1566722163974, 23838, 1566722164184, 24048, 210, true
12628, 1566722163975, 23839, 1566722164188, 24052, 213, true
12629, 1566722163975, 23839, 1566722164187, 24051, 212, true
12630, 1566722163978, 23842, 1566722164189, 24053, 211, true
12631, 1566722163979, 23843, 1566722164189, 24053, 210, true
12632, 1566722163979, 23843, 1566722164199, 24063, 220, true
12633, 1566722163980, 23844, 1566722164193, 24057, 213, true
12634, 1566722163981, 23845, 1566722164194, 24058, 213, true
12635, 1566722163982, 23846, 1566722164198, 24062, 216, true
12636, 1566722163983, 23847, 1566722164199, 24063, 216, true
12637, 1566722163983, 23847, 1566722164194, 24058, 211, true
12638, 1566722163983, 23847, 1566722164189, 24053, 206, true
12639, 1566722163984, 23848, 1566722164194, 24058, 210, true
12640, 1566722163984, 23848, 1566722164193, 24057, 209, true
12641, 1566722163985, 23849, 1566722164199, 24063, 214, true
12642, 1566722163985, 23849, 1566722164199, 24063, 214, true
12643, 1566722163986, 23850, 1566722164199, 24063, 213, true
12644, 1566722163987, 23851, 1566722164199, 24063, 212, true
12645, 1566722163993, 23857, 1566722164201, 24065, 208, true
12646, 1566722163997, 23861, 1566722164207, 24071, 210, true
12647, 1566722164000, 23864, 1566722164209, 24073, 209, true
12648, 1566722164012, 23876, 1566722164232, 24096, 220, true
12649, 1566722164012, 23876, 1566722164231, 24095, 219, true
12650, 1566722164013, 23877, 1566722164231, 24095, 218, true
12651, 1566722164013, 23877, 1566722164228, 24092, 215, true
12652, 1566722164013, 23877, 1566722164231, 24095, 218, true
12653, 1566722164013, 23877, 1566722164244, 24108, 231, true
12654, 1566722164014, 23878, 1566722164236, 24100, 222, true
12655, 1566722164014, 23878, 1566722164235, 24099, 221, true
12656, 1566722164015, 23879, 1566722164244, 24108, 229, true
12657, 1566722164015, 23879, 1566722164244, 24108, 229, true
12658, 1566722164015, 23879, 1566722164244, 24108, 229, true
12659, 1566722164021, 23885, 1566722164235, 24099, 214, true
12660, 1566722164022, 23886, 1566722164240, 24104, 218, true
12661, 1566722164022, 23886, 1566722164245, 24109, 223, true
12662, 1566722164023, 23887, 1566722164238, 24102, 215, true
12663, 1566722164023, 23887, 1566722164238, 24102, 215, true
12664, 1566722164023, 23887, 1566722164239, 24103, 216, true
12665, 1566722164024, 23888, 1566722164238, 24102, 214, true
12666, 1566722164024, 23888, 1566722164245, 24109, 221, true
12667, 1566722164025, 23889, 1566722164239, 24103, 214, true
12668, 1566722164026, 23890, 1566722164235, 24099, 209, true
12669, 1566722164026, 23890, 1566722164245, 24109, 219, true
12670, 1566722164030, 23894, 1566722164245, 24109, 215, true
12671, 1566722164030, 23894, 1566722164245, 24109, 215, true
12672, 1566722164031, 23895, 1566722164244, 24108, 213, true
12673, 1566722164037, 23901, 1566722164244, 24108, 207, true
12674, 1566722164042, 23906, 1566722164249, 24113, 207, true
12675, 1566722164042, 23906, 1566722164246, 24110, 204, true
12676, 1566722164053, 23917, 1566722164262, 24126, 209, true
12677, 1566722164055, 23919, 1566722164261, 24125, 206, true
12678, 1566722164057, 23921, 1566722164262, 24126, 205, true
12679, 1566722164059, 23923, 1566722164264, 24128, 205, true
12680, 1566722164061, 23925, 1566722164266, 24130, 205, true
12681, 1566722164063, 23927, 1566722164267, 24131, 204, true
12682, 1566722164063, 23927, 1566722164273, 24137, 210, true
12683, 1566722164064, 23928, 1566722164267, 24131, 203, true
12684, 1566722164064, 23928, 1566722164273, 24137, 209, true
12685, 1566722164065, 23929, 1566722164273, 24137, 208, true
12686, 1566722164066, 23930, 1566722164273, 24137, 207, true
12687, 1566722164071, 23935, 1566722164276, 24140, 205, true
12688, 1566722164072, 23936, 1566722164276, 24140, 204, true
12689, 1566722164072, 23936, 1566722164276, 24140, 204, true
12690, 1566722164073, 23937, 1566722164276, 24140, 203, true
12691, 1566722164073, 23937, 1566722164277, 24141, 204, true
12692, 1566722164074, 23938, 1566722164281, 24145, 207, true
12693, 1566722164074, 23938, 1566722164281, 24145, 207, true
12694, 1566722164075, 23939, 1566722164281, 24145, 206, true
12695, 1566722164078, 23942, 1566722164282, 24146, 204, true
12696, 1566722164079, 23943, 1566722164283, 24147, 204, true
12697, 1566722164080, 23944, 1566722164291, 24155, 211, true
12698, 1566722164094, 23958, 1566722164315, 24179, 221, true
12699, 1566722164094, 23958, 1566722164315, 24179, 221, true
12700, 1566722164095, 23959, 1566722164318, 24182, 223, true
12701, 1566722164095, 23959, 1566722164319, 24183, 224, true
12702, 1566722164095, 23959, 1566722164315, 24179, 220, true
12703, 1566722164096, 23960, 1566722164309, 24173, 213, true
12704, 1566722164097, 23961, 1566722164312, 24176, 215, true
12705, 1566722164097, 23961, 1566722164316, 24180, 219, true
12706, 1566722164097, 23961, 1566722164315, 24179, 218, true
12707, 1566722164098, 23962, 1566722164315, 24179, 217, true
12708, 1566722164103, 23967, 1566722164319, 24183, 216, true
12709, 1566722164104, 23968, 1566722164318, 24182, 214, true
12710, 1566722164104, 23968, 1566722164319, 24183, 215, true
12711, 1566722164110, 23974, 1566722164316, 24180, 206, true
12712, 1566722164117, 23981, 1566722164332, 24196, 215, true
12713, 1566722164117, 23981, 1566722164323, 24187, 206, true
12714, 1566722164117, 23981, 1566722164332, 24196, 215, true
12715, 1566722164121, 23985, 1566722164335, 24199, 214, true
12716, 1566722164128, 23992, 1566722164461, 24325, 333, true
12717, 1566722164128, 23992, 1566722164461, 24325, 333, true
12718, 1566722164133, 23997, 1566722164461, 24325, 328, true
12719, 1566722164144, 24008, 1566722164461, 24325, 317, true
12720, 1566722164144, 24008, 1566722164461, 24325, 317, true
12721, 1566722164148, 24012, 1566722164461, 24325, 313, true
12722, 1566722164152, 24016, 1566722164461, 24325, 309, true
12723, 1566722164152, 24016, 1566722164461, 24325, 309, true
12724, 1566722164153, 24017, 1566722164461, 24325, 308, true
12725, 1566722164153, 24017, 1566722164461, 24325, 308, true
12726, 1566722164153, 24017, 1566722164461, 24325, 308, true
12727, 1566722164154, 24018, 1566722164461, 24325, 307, true
12728, 1566722164154, 24018, 1566722164461, 24325, 307, true
12729, 1566722164158, 24022, 1566722164461, 24325, 303, true
12730, 1566722164161, 24025, 1566722164443, 24307, 282, true
12731, 1566722164161, 24025, 1566722164448, 24312, 287, true
12732, 1566722164162, 24026, 1566722164460, 24324, 298, true
12733, 1566722164163, 24027, 1566722164449, 24313, 286, true
12734, 1566722164172, 24036, 1566722164441, 24305, 269, true
12735, 1566722164173, 24037, 1566722164449, 24313, 276, true
12736, 1566722164173, 24037, 1566722164438, 24302, 265, true
12737, 1566722164174, 24038, 1566722164448, 24312, 274, true
12738, 1566722164175, 24039, 1566722164442, 24306, 267, true
12739, 1566722164175, 24039, 1566722164449, 24313, 274, true
12740, 1566722164176, 24040, 1566722164442, 24306, 266, true
12741, 1566722164180, 24044, 1566722164443, 24307, 263, true
12742, 1566722164182, 24046, 1566722164436, 24300, 254, true
12743, 1566722164183, 24047, 1566722164437, 24301, 254, true
12744, 1566722164183, 24047, 1566722164435, 24299, 252, true
12745, 1566722164183, 24047, 1566722164434, 24298, 251, true
12746, 1566722164184, 24048, 1566722164435, 24299, 251, true
12747, 1566722164185, 24049, 1566722164437, 24301, 252, true
12748, 1566722164185, 24049, 1566722164436, 24300, 251, true
12749, 1566722164187, 24051, 1566722164434, 24298, 247, true
12750, 1566722164189, 24053, 1566722164437, 24301, 248, true
12751, 1566722164190, 24054, 1566722164434, 24298, 244, true
12752, 1566722164195, 24059, 1566722164434, 24298, 239, true
12753, 1566722164195, 24059, 1566722164430, 24294, 235, true
12754, 1566722164195, 24059, 1566722164434, 24298, 239, true
12755, 1566722164195, 24059, 1566722164430, 24294, 235, true
12756, 1566722164196, 24060, 1566722164434, 24298, 238, true
12757, 1566722164196, 24060, 1566722164429, 24293, 233, true
12758, 1566722164200, 24064, 1566722164430, 24294, 230, true
12759, 1566722164201, 24065, 1566722164434, 24298, 233, true
12760, 1566722164202, 24066, 1566722164429, 24293, 227, true
12761, 1566722164202, 24066, 1566722164434, 24298, 232, true
12762, 1566722164203, 24067, 1566722164433, 24297, 230, true
12763, 1566722164204, 24068, 1566722164428, 24292, 224, true
12764, 1566722164204, 24068, 1566722164423, 24287, 219, true
12765, 1566722164205, 24069, 1566722164428, 24292, 223, true
12766, 1566722164205, 24069, 1566722164428, 24292, 223, true
12767, 1566722164209, 24073, 1566722164429, 24293, 220, true
12768, 1566722164211, 24075, 1566722164428, 24292, 217, true
12769, 1566722164213, 24077, 1566722164429, 24293, 216, true
12770, 1566722164215, 24079, 1566722164423, 24287, 208, true
12771, 1566722164216, 24080, 1566722164429, 24293, 213, true
12772, 1566722164216, 24080, 1566722164428, 24292, 212, true
12773, 1566722164217, 24081, 1566722164428, 24292, 211, true
12774, 1566722164218, 24082, 1566722164428, 24292, 210, true
12775, 1566722164219, 24083, 1566722164429, 24293, 210, true
12776, 1566722164220, 24084, 1566722164433, 24297, 213, true
12777, 1566722164221, 24085, 1566722164439, 24303, 218, true
12778, 1566722164221, 24085, 1566722164440, 24304, 219, true
12779, 1566722164221, 24085, 1566722164439, 24303, 218, true
12780, 1566722164222, 24086, 1566722164441, 24305, 219, true
12781, 1566722164223, 24087, 1566722164444, 24308, 221, true
12782, 1566722164224, 24088, 1566722164439, 24303, 215, true
12783, 1566722164225, 24089, 1566722164444, 24308, 219, true
12784, 1566722164226, 24090, 1566722164444, 24308, 218, true
12785, 1566722164228, 24092, 1566722164441, 24305, 213, true
12786, 1566722164229, 24093, 1566722164442, 24306, 213, true
12787, 1566722164231, 24095, 1566722164448, 24312, 217, true
12788, 1566722164233, 24097, 1566722164448, 24312, 215, true
12789, 1566722164233, 24097, 1566722164448, 24312, 215, true
12790, 1566722164234, 24098, 1566722164448, 24312, 214, true
12791, 1566722164236, 24100, 1566722164448, 24312, 212, true
12792, 1566722164238, 24102, 1566722164564, 24428, 326, true
12793, 1566722164247, 24111, 1566722164565, 24429, 318, true
12794, 1566722164247, 24111, 1566722164566, 24430, 319, true
12795, 1566722164248, 24112, 1566722164564, 24428, 316, true
12796, 1566722164248, 24112, 1566722164556, 24420, 308, true
12797, 1566722164249, 24113, 1566722164562, 24426, 313, true
12798, 1566722164250, 24114, 1566722164564, 24428, 314, true
12799, 1566722164250, 24114, 1566722164562, 24426, 312, true
12800, 1566722164250, 24114, 1566722164556, 24420, 306, true
12801, 1566722164251, 24115, 1566722164561, 24425, 310, true
12802, 1566722164252, 24116, 1566722164562, 24426, 310, true
12803, 1566722164253, 24117, 1566722164556, 24420, 303, true
12804, 1566722164254, 24118, 1566722164562, 24426, 308, true
12805, 1566722164255, 24119, 1566722164556, 24420, 301, true
12806, 1566722164257, 24121, 1566722164556, 24420, 299, true
12807, 1566722164258, 24122, 1566722164562, 24426, 304, true
12808, 1566722164258, 24122, 1566722164562, 24426, 304, true
12809, 1566722164259, 24123, 1566722164565, 24429, 306, true
12810, 1566722164262, 24126, 1566722164561, 24425, 299, true
12811, 1566722164263, 24127, 1566722164565, 24429, 302, true
12812, 1566722164264, 24128, 1566722164559, 24423, 295, true
12813, 1566722164265, 24129, 1566722164565, 24429, 300, true
12814, 1566722164268, 24132, 1566722164556, 24420, 288, true
12815, 1566722164268, 24132, 1566722164553, 24417, 285, true
12816, 1566722164268, 24132, 1566722164556, 24420, 288, true
12817, 1566722164269, 24133, 1566722164553, 24417, 284, true
12818, 1566722164270, 24134, 1566722164553, 24417, 283, true
12819, 1566722164271, 24135, 1566722164553, 24417, 282, true
12820, 1566722164274, 24138, 1566722164553, 24417, 279, true
12821, 1566722164274, 24138, 1566722164550, 24414, 276, true
12822, 1566722164274, 24138, 1566722164553, 24417, 279, true
12823, 1566722164277, 24141, 1566722164553, 24417, 276, true
12824, 1566722164278, 24142, 1566722164553, 24417, 275, true
12825, 1566722164279, 24143, 1566722164549, 24413, 270, true
12826, 1566722164279, 24143, 1566722164549, 24413, 270, true
12827, 1566722164282, 24146, 1566722164548, 24412, 266, true
12828, 1566722164283, 24147, 1566722164549, 24413, 266, true
12829, 1566722164284, 24148, 1566722164540, 24404, 256, true
12830, 1566722164284, 24148, 1566722164549, 24413, 265, true
12831, 1566722164284, 24148, 1566722164549, 24413, 265, true
12832, 1566722164285, 24149, 1566722164533, 24397, 248, true
12833, 1566722164286, 24150, 1566722164535, 24399, 249, true
12834, 1566722164287, 24151, 1566722164535, 24399, 248, true
12835, 1566722164288, 24152, 1566722164533, 24397, 245, true
12836, 1566722164289, 24153, 1566722164532, 24396, 243, true
12837, 1566722164291, 24155, 1566722164536, 24400, 245, true
12838, 1566722164292, 24156, 1566722164529, 24393, 237, true
12839, 1566722164298, 24162, 1566722164528, 24392, 230, true
12840, 1566722164300, 24164, 1566722164529, 24393, 229, true
12841, 1566722164302, 24166, 1566722164530, 24394, 228, true
12842, 1566722164305, 24169, 1566722164530, 24394, 225, true
12843, 1566722164307, 24171, 1566722164530, 24394, 223, true
12844, 1566722164310, 24174, 1566722164525, 24389, 215, true
12845, 1566722164312, 24176, 1566722164523, 24387, 211, true
12846, 1566722164322, 24186, 1566722164565, 24429, 243, true
12847, 1566722164324, 24188, 1566722164565, 24429, 241, true
12848, 1566722164326, 24190, 1566722164565, 24429, 239, true
12849, 1566722164327, 24191, 1566722164532, 24396, 205, true
12850, 1566722164329, 24193, 1566722164565, 24429, 236, true
12851, 1566722164330, 24194, 1566722164535, 24399, 205, true
12852, 1566722164333, 24197, 1566722164543, 24407, 210, true
12853, 1566722164334, 24198, 1566722164565, 24429, 231, true
12854, 1566722164337, 24201, 1566722164565, 24429, 228, true
12855, 1566722164339, 24203, 1566722164544, 24408, 205, true
12856, 1566722164341, 24205, 1566722164625, 24489, 284, true
12857, 1566722164342, 24206, 1566722164564, 24428, 222, true
12858, 1566722164369, 24233, 1566722164674, 24538, 305, true
12859, 1566722164380, 24244, 1566722164674, 24538, 294, true
12860, 1566722164381, 24245, 1566722164669, 24533, 288, true
12861, 1566722164382, 24246, 1566722164675, 24539, 293, true
12862, 1566722164383, 24247, 1566722164684, 24548, 301, true
12863, 1566722164383, 24247, 1566722164697, 24561, 314, true
12864, 1566722164384, 24248, 1566722164696, 24560, 312, true
12865, 1566722164385, 24249, 1566722164674, 24538, 289, true
12866, 1566722164385, 24249, 1566722164696, 24560, 311, true
12867, 1566722164386, 24250, 1566722164678, 24542, 292, true
12868, 1566722164387, 24251, 1566722164675, 24539, 288, true
12869, 1566722164387, 24251, 1566722164689, 24553, 302, true
12870, 1566722164388, 24252, 1566722164696, 24560, 308, true
12871, 1566722164388, 24252, 1566722164696, 24560, 308, true
12872, 1566722164389, 24253, 1566722164678, 24542, 289, true
12873, 1566722164390, 24254, 1566722164695, 24559, 305, true
12874, 1566722164402, 24266, 1566722164696, 24560, 294, true
12875, 1566722164407, 24271, 1566722164674, 24538, 267, true
12876, 1566722164409, 24273, 1566722164683, 24547, 274, true
12877, 1566722164410, 24274, 1566722164697, 24561, 287, true
12878, 1566722164412, 24276, 1566722164681, 24545, 269, true
12879, 1566722164413, 24277, 1566722164690, 24554, 277, true
12880, 1566722164413, 24277, 1566722164689, 24553, 276, true
12881, 1566722164414, 24278, 1566722164696, 24560, 282, true
12882, 1566722164414, 24278, 1566722164682, 24546, 268, true
12883, 1566722164414, 24278, 1566722164696, 24560, 282, true
12884, 1566722164414, 24278, 1566722164681, 24545, 267, true
12885, 1566722164415, 24279, 1566722164677, 24541, 262, true
12886, 1566722164415, 24279, 1566722164678, 24542, 263, true
12887, 1566722164415, 24279, 1566722164674, 24538, 259, true
12888, 1566722164415, 24279, 1566722164684, 24548, 269, true
12889, 1566722164416, 24280, 1566722164682, 24546, 266, true
12890, 1566722164416, 24280, 1566722164681, 24545, 265, true
12891, 1566722164416, 24280, 1566722164674, 24538, 258, true
12892, 1566722164416, 24280, 1566722164678, 24542, 262, true
12893, 1566722164417, 24281, 1566722164678, 24542, 261, true
12894, 1566722164417, 24281, 1566722164696, 24560, 279, true
12895, 1566722164417, 24281, 1566722164696, 24560, 279, true
12896, 1566722164417, 24281, 1566722164680, 24544, 263, true
12897, 1566722164418, 24282, 1566722164690, 24554, 272, true
12898, 1566722164418, 24282, 1566722164685, 24549, 267, true
12899, 1566722164418, 24282, 1566722164675, 24539, 257, true
12900, 1566722164419, 24283, 1566722164682, 24546, 263, true
12901, 1566722164420, 24284, 1566722164674, 24538, 254, true
12902, 1566722164427, 24291, 1566722164679, 24543, 252, true
12903, 1566722164439, 24303, 1566722164695, 24559, 256, true
12904, 1566722164447, 24311, 1566722164685, 24549, 238, true
12905, 1566722164450, 24314, 1566722164682, 24546, 232, true
12906, 1566722164451, 24315, 1566722164668, 24532, 217, true
12907, 1566722164451, 24315, 1566722164678, 24542, 227, true
12908, 1566722164453, 24317, 1566722164675, 24539, 222, true
12909, 1566722164454, 24318, 1566722164677, 24541, 223, true
12910, 1566722164454, 24318, 1566722164678, 24542, 224, true
12911, 1566722164455, 24319, 1566722164678, 24542, 223, true
12912, 1566722164456, 24320, 1566722164697, 24561, 241, true
12913, 1566722164463, 24327, 1566722164674, 24538, 211, true
12914, 1566722164464, 24328, 1566722164695, 24559, 231, true
12915, 1566722164464, 24328, 1566722164697, 24561, 233, true
12916, 1566722164470, 24334, 1566722164704, 24568, 234, true
12917, 1566722164470, 24334, 1566722164698, 24562, 228, true
12918, 1566722164472, 24336, 1566722164703, 24567, 231, true
12919, 1566722164475, 24339, 1566722164698, 24562, 223, true
12920, 1566722164479, 24343, 1566722164703, 24567, 224, true
12921, 1566722164479, 24343, 1566722164697, 24561, 218, true
12922, 1566722164480, 24344, 1566722164697, 24561, 217, true
12923, 1566722164480, 24344, 1566722164703, 24567, 223, true
12924, 1566722164480, 24344, 1566722164704, 24568, 224, true
12925, 1566722164481, 24345, 1566722164699, 24563, 218, true
12926, 1566722164485, 24349, 1566722164704, 24568, 219, true
12927, 1566722164486, 24350, 1566722164704, 24568, 218, true
12928, 1566722164487, 24351, 1566722164698, 24562, 211, true
12929, 1566722164490, 24354, 1566722164704, 24568, 214, true
12930, 1566722164491, 24355, 1566722164704, 24568, 213, true
12931, 1566722164491, 24355, 1566722164704, 24568, 213, true
12932, 1566722164491, 24355, 1566722164704, 24568, 213, true
12933, 1566722164494, 24358, 1566722164704, 24568, 210, true
12934, 1566722164496, 24360, 1566722164704, 24568, 208, true
12935, 1566722164498, 24362, 1566722164711, 24575, 213, true
12936, 1566722164499, 24363, 1566722164704, 24568, 205, true
12937, 1566722164499, 24363, 1566722164709, 24573, 210, true
12938, 1566722164500, 24364, 1566722164709, 24573, 209, true
12939, 1566722164501, 24365, 1566722164711, 24575, 210, true
12940, 1566722164502, 24366, 1566722164711, 24575, 209, true
12941, 1566722164502, 24366, 1566722164711, 24575, 209, true
12942, 1566722164503, 24367, 1566722164708, 24572, 205, true
12943, 1566722164505, 24369, 1566722164720, 24584, 215, true
12944, 1566722164505, 24369, 1566722164711, 24575, 206, true
12945, 1566722164506, 24370, 1566722164721, 24585, 215, true
12946, 1566722164506, 24370, 1566722164720, 24584, 214, true
12947, 1566722164507, 24371, 1566722164720, 24584, 213, true
12948, 1566722164508, 24372, 1566722164720, 24584, 212, true
12949, 1566722164508, 24372, 1566722164720, 24584, 212, true
12950, 1566722164509, 24373, 1566722164720, 24584, 211, true
12951, 1566722164509, 24373, 1566722164720, 24584, 211, true
12952, 1566722164510, 24374, 1566722164715, 24579, 205, true
12953, 1566722164511, 24375, 1566722164721, 24585, 210, true
12954, 1566722164512, 24376, 1566722164720, 24584, 208, true
12955, 1566722164514, 24378, 1566722164720, 24584, 206, true
12956, 1566722164514, 24378, 1566722164721, 24585, 207, true
12957, 1566722164515, 24379, 1566722164721, 24585, 206, true
12958, 1566722164516, 24380, 1566722164731, 24595, 215, true
12959, 1566722164517, 24381, 1566722164721, 24585, 204, true
12960, 1566722164518, 24382, 1566722164728, 24592, 210, true
12961, 1566722164518, 24382, 1566722164728, 24592, 210, true
12962, 1566722164519, 24383, 1566722164731, 24595, 212, true
12963, 1566722164520, 24384, 1566722164724, 24588, 204, true
12964, 1566722164521, 24385, 1566722164731, 24595, 210, true
12965, 1566722164522, 24386, 1566722164731, 24595, 209, true
12966, 1566722164523, 24387, 1566722164731, 24595, 208, true
12967, 1566722164525, 24389, 1566722164731, 24595, 206, true
12968, 1566722164525, 24389, 1566722164733, 24597, 208, true
12969, 1566722164527, 24391, 1566722164733, 24597, 206, true
12970, 1566722164530, 24394, 1566722164740, 24604, 210, true
12971, 1566722164535, 24399, 1566722164740, 24604, 205, true
12972, 1566722164536, 24400, 1566722164741, 24605, 205, true
12973, 1566722164537, 24401, 1566722164745, 24609, 208, true
12974, 1566722164537, 24401, 1566722164745, 24609, 208, true
12975, 1566722164538, 24402, 1566722164745, 24609, 207, true
12976, 1566722164538, 24402, 1566722164745, 24609, 207, true
12977, 1566722164540, 24404, 1566722164745, 24609, 205, true
12978, 1566722164541, 24405, 1566722164747, 24611, 206, true
12979, 1566722164541, 24405, 1566722164748, 24612, 207, true
12980, 1566722164541, 24405, 1566722164747, 24611, 206, true
12981, 1566722164543, 24407, 1566722164747, 24611, 204, true
12982, 1566722164545, 24409, 1566722164751, 24615, 206, true
12983, 1566722164546, 24410, 1566722164763, 24627, 217, true
12984, 1566722164568, 24432, 1566722164817, 24681, 249, true
12985, 1566722164568, 24432, 1566722164806, 24670, 238, true
12986, 1566722164569, 24433, 1566722164801, 24665, 232, true
12987, 1566722164569, 24433, 1566722164822, 24686, 253, true
12988, 1566722164570, 24434, 1566722164817, 24681, 247, true
12989, 1566722164570, 24434, 1566722164792, 24656, 222, true
12990, 1566722164573, 24437, 1566722164787, 24651, 214, true
12991, 1566722164578, 24442, 1566722164817, 24681, 239, true
12992, 1566722164579, 24443, 1566722164817, 24681, 238, true
12993, 1566722164581, 24445, 1566722164817, 24681, 236, true
12994, 1566722164582, 24446, 1566722164797, 24661, 215, true
12995, 1566722164583, 24447, 1566722164817, 24681, 234, true
12996, 1566722164585, 24449, 1566722164807, 24671, 222, true
12997, 1566722164585, 24449, 1566722164807, 24671, 222, true
12998, 1566722164586, 24450, 1566722164797, 24661, 211, true
12999, 1566722164587, 24451, 1566722164813, 24677, 226, true
13000, 1566722164588, 24452, 1566722164808, 24672, 220, true
13001, 1566722164589, 24453, 1566722164807, 24671, 218, true
13002, 1566722164590, 24454, 1566722164810, 24674, 220, true
13003, 1566722164591, 24455, 1566722164808, 24672, 217, true
13004, 1566722164591, 24455, 1566722164807, 24671, 216, true
13005, 1566722164592, 24456, 1566722164806, 24670, 214, true
13006, 1566722164592, 24456, 1566722164808, 24672, 216, true
13007, 1566722164593, 24457, 1566722164806, 24670, 213, true
13008, 1566722164594, 24458, 1566722164805, 24669, 211, true
13009, 1566722164595, 24459, 1566722164817, 24681, 222, true
13010, 1566722164596, 24460, 1566722164806, 24670, 210, true
13011, 1566722164601, 24465, 1566722164823, 24687, 222, true
13012, 1566722164601, 24465, 1566722164823, 24687, 222, true
13013, 1566722164602, 24466, 1566722164823, 24687, 221, true
13014, 1566722164604, 24468, 1566722164822, 24686, 218, true
13015, 1566722164604, 24468, 1566722164811, 24675, 207, true
13016, 1566722164604, 24468, 1566722164822, 24686, 218, true
13017, 1566722164605, 24469, 1566722164817, 24681, 212, true
13018, 1566722164606, 24470, 1566722164822, 24686, 216, true
13019, 1566722164608, 24472, 1566722164817, 24681, 209, true
13020, 1566722164609, 24473, 1566722164822, 24686, 213, true
13021, 1566722164609, 24473, 1566722164827, 24691, 218, true
13022, 1566722164610, 24474, 1566722164824, 24688, 214, true
13023, 1566722164611, 24475, 1566722164824, 24688, 213, true
13024, 1566722164612, 24476, 1566722164827, 24691, 215, true
13025, 1566722164613, 24477, 1566722164822, 24686, 209, true
13026, 1566722164613, 24477, 1566722164823, 24687, 210, true
13027, 1566722164615, 24479, 1566722164824, 24688, 209, true
13028, 1566722164616, 24480, 1566722164829, 24693, 213, true
13029, 1566722164617, 24481, 1566722164824, 24688, 207, true
13030, 1566722164618, 24482, 1566722164828, 24692, 210, true
13031, 1566722164619, 24483, 1566722164832, 24696, 213, true
13032, 1566722164619, 24483, 1566722164829, 24693, 210, true
13033, 1566722164620, 24484, 1566722164835, 24699, 215, true
13034, 1566722164621, 24485, 1566722164835, 24699, 214, true
13035, 1566722164622, 24486, 1566722164835, 24699, 213, true
13036, 1566722164623, 24487, 1566722164835, 24699, 212, true
13037, 1566722164624, 24488, 1566722164832, 24696, 208, true
13038, 1566722164625, 24489, 1566722164835, 24699, 210, true
13039, 1566722164626, 24490, 1566722164835, 24699, 209, true
13040, 1566722164628, 24492, 1566722164835, 24699, 207, true
13041, 1566722164629, 24493, 1566722164842, 24706, 213, true
13042, 1566722164630, 24494, 1566722164841, 24705, 211, true
13043, 1566722164631, 24495, 1566722164842, 24706, 211, true
13044, 1566722164633, 24497, 1566722164843, 24707, 210, true
13045, 1566722164633, 24497, 1566722164840, 24704, 207, true
13046, 1566722164633, 24497, 1566722164840, 24704, 207, true
13047, 1566722164634, 24498, 1566722164846, 24710, 212, true
13048, 1566722164635, 24499, 1566722164845, 24709, 210, true
13049, 1566722164635, 24499, 1566722164842, 24706, 207, true
13050, 1566722164636, 24500, 1566722164845, 24709, 209, true
13051, 1566722164637, 24501, 1566722164845, 24709, 208, true
13052, 1566722164638, 24502, 1566722164846, 24710, 208, true
13053, 1566722164639, 24503, 1566722164845, 24709, 206, true
13054, 1566722164642, 24506, 1566722164846, 24710, 204, true
13055, 1566722164643, 24507, 1566722164849, 24713, 206, true
13056, 1566722164644, 24508, 1566722164849, 24713, 205, true
13057, 1566722164645, 24509, 1566722164849, 24713, 204, true
13058, 1566722164647, 24511, 1566722164868, 24732, 221, true
13059, 1566722164647, 24511, 1566722164864, 24728, 217, true
13060, 1566722164648, 24512, 1566722164864, 24728, 216, true
13061, 1566722164648, 24512, 1566722164864, 24728, 216, true
13062, 1566722164649, 24513, 1566722164864, 24728, 215, true
13063, 1566722164649, 24513, 1566722164864, 24728, 215, true
13064, 1566722164649, 24513, 1566722164868, 24732, 219, true
13065, 1566722164650, 24514, 1566722164861, 24725, 211, true
13066, 1566722164650, 24514, 1566722164868, 24732, 218, true
13067, 1566722164650, 24514, 1566722164864, 24728, 214, true
13068, 1566722164651, 24515, 1566722164869, 24733, 218, true
13069, 1566722164651, 24515, 1566722164868, 24732, 217, true
13070, 1566722164652, 24516, 1566722164862, 24726, 210, true
13071, 1566722164652, 24516, 1566722164861, 24725, 209, true
13072, 1566722164652, 24516, 1566722164868, 24732, 216, true
13073, 1566722164653, 24517, 1566722164861, 24725, 208, true
13074, 1566722164653, 24517, 1566722164864, 24728, 211, true
13075, 1566722164654, 24518, 1566722164868, 24732, 214, true
13076, 1566722164655, 24519, 1566722164868, 24732, 213, true
13077, 1566722164655, 24519, 1566722164868, 24732, 213, true
13078, 1566722164655, 24519, 1566722164868, 24732, 213, true
13079, 1566722164656, 24520, 1566722164869, 24733, 213, true
13080, 1566722164662, 24526, 1566722164870, 24734, 208, true
13081, 1566722164663, 24527, 1566722164870, 24734, 207, true
13082, 1566722164664, 24528, 1566722164917, 24781, 253, true
13083, 1566722164664, 24528, 1566722164875, 24739, 211, true
13084, 1566722164665, 24529, 1566722164871, 24735, 206, true
13085, 1566722164665, 24529, 1566722164870, 24734, 205, true
13086, 1566722164666, 24530, 1566722164944, 24808, 278, true
13087, 1566722164666, 24530, 1566722164940, 24804, 274, true
13088, 1566722164667, 24531, 1566722164940, 24804, 273, true
13089, 1566722164669, 24533, 1566722164929, 24793, 260, true
13090, 1566722164670, 24534, 1566722164948, 24812, 278, true
13091, 1566722164687, 24551, 1566722164940, 24804, 253, true
13092, 1566722164712, 24576, 1566722164940, 24804, 228, true
13093, 1566722164724, 24588, 1566722164958, 24822, 234, true
13094, 1566722164725, 24589, 1566722164959, 24823, 234, true
13095, 1566722164725, 24589, 1566722164951, 24815, 226, true
13096, 1566722164727, 24591, 1566722164959, 24823, 232, true
13097, 1566722164744, 24608, 1566722164962, 24826, 218, true
13098, 1566722164745, 24609, 1566722164962, 24826, 217, true
13099, 1566722164748, 24612, 1566722164962, 24826, 214, true
13100, 1566722164751, 24615, 1566722164962, 24826, 211, true
13101, 1566722164752, 24616, 1566722164962, 24826, 210, true
13102, 1566722164752, 24616, 1566722164962, 24826, 210, true
13103, 1566722164752, 24616, 1566722164962, 24826, 210, true
13104, 1566722164754, 24618, 1566722164962, 24826, 208, true
13105, 1566722164759, 24623, 1566722164965, 24829, 206, true
13106, 1566722164759, 24623, 1566722164980, 24844, 221, true
13107, 1566722164760, 24624, 1566722164972, 24836, 212, true
13108, 1566722164761, 24625, 1566722164965, 24829, 204, true
13109, 1566722164763, 24627, 1566722164972, 24836, 209, true
13110, 1566722164764, 24628, 1566722164972, 24836, 208, true
13111, 1566722164765, 24629, 1566722164972, 24836, 207, true
13112, 1566722164766, 24630, 1566722164973, 24837, 207, true
13113, 1566722164768, 24632, 1566722164972, 24836, 204, true
13114, 1566722164768, 24632, 1566722164973, 24837, 205, true
13115, 1566722164770, 24634, 1566722164980, 24844, 210, true
13116, 1566722164771, 24635, 1566722164980, 24844, 209, true
13117, 1566722164771, 24635, 1566722164980, 24844, 209, true
13118, 1566722164771, 24635, 1566722164980, 24844, 209, true
13119, 1566722164772, 24636, 1566722164980, 24844, 208, true
13120, 1566722164772, 24636, 1566722164980, 24844, 208, true
13121, 1566722164775, 24639, 1566722164984, 24848, 209, true
13122, 1566722164776, 24640, 1566722164984, 24848, 208, true
13123, 1566722164776, 24640, 1566722164987, 24851, 211, true
13124, 1566722164777, 24641, 1566722164987, 24851, 210, true
13125, 1566722164777, 24641, 1566722164984, 24848, 207, true
13126, 1566722164778, 24642, 1566722164987, 24851, 209, true
13127, 1566722164778, 24642, 1566722164986, 24850, 208, true
13128, 1566722164778, 24642, 1566722164989, 24853, 211, true
13129, 1566722164779, 24643, 1566722164990, 24854, 211, true
13130, 1566722164779, 24643, 1566722164987, 24851, 208, true
13131, 1566722164780, 24644, 1566722164990, 24854, 210, true
13132, 1566722164781, 24645, 1566722164987, 24851, 206, true
13133, 1566722164781, 24645, 1566722164990, 24854, 209, true
13134, 1566722164782, 24646, 1566722164990, 24854, 208, true
13135, 1566722164783, 24647, 1566722164990, 24854, 207, true
13136, 1566722164785, 24649, 1566722164990, 24854, 205, true
13137, 1566722164787, 24651, 1566722164991, 24855, 204, true
13138, 1566722164788, 24652, 1566722164994, 24858, 206, true
13139, 1566722164788, 24652, 1566722164991, 24855, 203, true
13140, 1566722164789, 24653, 1566722164994, 24858, 205, true
13141, 1566722164791, 24655, 1566722164996, 24860, 205, true
13142, 1566722164791, 24655, 1566722164997, 24861, 206, true
13143, 1566722164792, 24656, 1566722164995, 24859, 203, true
13144, 1566722164793, 24657, 1566722164997, 24861, 204, true
13145, 1566722164794, 24658, 1566722164998, 24862, 204, true
13146, 1566722164797, 24661, 1566722165000, 24864, 203, true
13147, 1566722164799, 24663, 1566722165003, 24867, 204, true
13148, 1566722164800, 24664, 1566722165009, 24873, 209, true
13149, 1566722164802, 24666, 1566722165009, 24873, 207, true
13150, 1566722164803, 24667, 1566722165013, 24877, 210, true
13151, 1566722164825, 24689, 1566722165050, 24914, 225, true
13152, 1566722164826, 24690, 1566722165050, 24914, 224, true
13153, 1566722164836, 24700, 1566722165050, 24914, 214, true
13154, 1566722164838, 24702, 1566722165050, 24914, 212, true
13155, 1566722164851, 24715, 1566722165064, 24928, 213, true
13156, 1566722164853, 24717, 1566722165068, 24932, 215, true
13157, 1566722164854, 24718, 1566722165068, 24932, 214, true
13158, 1566722164855, 24719, 1566722165064, 24928, 209, true
13159, 1566722164856, 24720, 1566722165064, 24928, 208, true
13160, 1566722164857, 24721, 1566722165064, 24928, 207, true
13161, 1566722164878, 24742, 1566722165085, 24949, 207, true
13162, 1566722164879, 24743, 1566722165085, 24949, 206, true
13163, 1566722164880, 24744, 1566722165085, 24949, 205, true
13164, 1566722164881, 24745, 1566722165085, 24949, 204, true
13165, 1566722164883, 24747, 1566722165088, 24952, 205, true
13166, 1566722164885, 24749, 1566722165090, 24954, 205, true
13167, 1566722164887, 24751, 1566722165093, 24957, 206, true
13168, 1566722164889, 24753, 1566722165094, 24958, 205, true
13169, 1566722164891, 24755, 1566722165099, 24963, 208, true
13170, 1566722164893, 24757, 1566722165100, 24964, 207, true
13171, 1566722164895, 24759, 1566722165100, 24964, 205, true
13172, 1566722164896, 24760, 1566722165100, 24964, 204, true
13173, 1566722164898, 24762, 1566722165103, 24967, 205, true
13174, 1566722164900, 24764, 1566722165103, 24967, 203, true
13175, 1566722164903, 24767, 1566722165109, 24973, 206, true
13176, 1566722164904, 24768, 1566722165110, 24974, 206, true
13177, 1566722164906, 24770, 1566722165110, 24974, 204, true
13178, 1566722164908, 24772, 1566722165114, 24978, 206, true
13179, 1566722164908, 24772, 1566722165115, 24979, 207, true
13180, 1566722164910, 24774, 1566722165114, 24978, 204, true
13181, 1566722164912, 24776, 1566722165115, 24979, 203, true
13182, 1566722164914, 24778, 1566722165118, 24982, 204, true
13183, 1566722164916, 24780, 1566722165120, 24984, 204, true
13184, 1566722164918, 24782, 1566722165122, 24986, 204, true
13185, 1566722164919, 24783, 1566722165125, 24989, 206, true
13186, 1566722164919, 24783, 1566722165127, 24991, 208, true
13187, 1566722164919, 24783, 1566722165128, 24992, 209, true
13188, 1566722164920, 24784, 1566722165128, 24992, 208, true
13189, 1566722164921, 24785, 1566722165126, 24990, 205, true
13190, 1566722164922, 24786, 1566722165126, 24990, 204, true
13191, 1566722164923, 24787, 1566722165129, 24993, 206, true
13192, 1566722164924, 24788, 1566722165135, 24999, 211, true
13193, 1566722164925, 24789, 1566722165134, 24998, 209, true
13194, 1566722164926, 24790, 1566722165134, 24998, 208, true
13195, 1566722164926, 24790, 1566722165134, 24998, 208, true
13196, 1566722164930, 24794, 1566722165139, 25003, 209, true
13197, 1566722164931, 24795, 1566722165140, 25004, 209, true
13198, 1566722164931, 24795, 1566722165139, 25003, 208, true
13199, 1566722164932, 24796, 1566722165139, 25003, 207, true
13200, 1566722164932, 24796, 1566722165140, 25004, 208, true
13201, 1566722164933, 24797, 1566722165139, 25003, 206, true
13202, 1566722164935, 24799, 1566722165144, 25008, 209, true
13203, 1566722164936, 24800, 1566722165144, 25008, 208, true
13204, 1566722164936, 24800, 1566722165144, 25008, 208, true
13205, 1566722164937, 24801, 1566722165150, 25014, 213, true
13206, 1566722164938, 24802, 1566722165151, 25015, 213, true
13207, 1566722164941, 24805, 1566722165150, 25014, 209, true
13208, 1566722164941, 24805, 1566722165150, 25014, 209, true
13209, 1566722164942, 24806, 1566722165147, 25011, 205, true
13210, 1566722164942, 24806, 1566722165150, 25014, 208, true
13211, 1566722164945, 24809, 1566722165157, 25021, 212, true
13212, 1566722164945, 24809, 1566722165152, 25016, 207, true
13213, 1566722164947, 24811, 1566722165152, 25016, 205, true
13214, 1566722164948, 24812, 1566722165152, 25016, 204, true
13215, 1566722164949, 24813, 1566722165159, 25023, 210, true
13216, 1566722164953, 24817, 1566722165170, 25034, 217, true
13217, 1566722164954, 24818, 1566722165186, 25050, 232, true
13218, 1566722164954, 24818, 1566722165169, 25033, 215, true
13219, 1566722164955, 24819, 1566722165169, 25033, 214, true
13220, 1566722164963, 24827, 1566722165171, 25035, 208, true
13221, 1566722164963, 24827, 1566722165185, 25049, 222, true
13222, 1566722164964, 24828, 1566722165171, 25035, 207, true
13223, 1566722164964, 24828, 1566722165175, 25039, 211, true
13224, 1566722164966, 24830, 1566722165201, 25065, 235, true
13225, 1566722164966, 24830, 1566722165187, 25051, 221, true
13226, 1566722164967, 24831, 1566722165186, 25050, 219, true
13227, 1566722164968, 24832, 1566722165187, 25051, 219, true
13228, 1566722164968, 24832, 1566722165196, 25060, 228, true
13229, 1566722164969, 24833, 1566722165200, 25064, 231, true
13230, 1566722164973, 24837, 1566722165199, 25063, 226, true
13231, 1566722164974, 24838, 1566722165205, 25069, 231, true
13232, 1566722164974, 24838, 1566722165205, 25069, 231, true
13233, 1566722164975, 24839, 1566722165200, 25064, 225, true
13234, 1566722164975, 24839, 1566722165195, 25059, 220, true
13235, 1566722164975, 24839, 1566722165204, 25068, 229, true
13236, 1566722164977, 24841, 1566722165199, 25063, 222, true
13237, 1566722165003, 24867, 1566722165220, 25084, 217, true
13238, 1566722165004, 24868, 1566722165221, 25085, 217, true
13239, 1566722165004, 24868, 1566722165221, 25085, 217, true
13240, 1566722165004, 24868, 1566722165221, 25085, 217, true
13241, 1566722165004, 24868, 1566722165221, 25085, 217, true
13242, 1566722165004, 24868, 1566722165221, 25085, 217, true
13243, 1566722165005, 24869, 1566722165221, 25085, 216, true
13244, 1566722165005, 24869, 1566722165221, 25085, 216, true
13245, 1566722165010, 24874, 1566722165221, 25085, 211, true
13246, 1566722165010, 24874, 1566722165221, 25085, 211, true
13247, 1566722165015, 24879, 1566722165221, 25085, 206, true
13248, 1566722165016, 24880, 1566722165221, 25085, 205, true
13249, 1566722165017, 24881, 1566722165221, 25085, 204, true
13250, 1566722165018, 24882, 1566722165223, 25087, 205, true
13251, 1566722165019, 24883, 1566722165223, 25087, 204, true
13252, 1566722165020, 24884, 1566722165227, 25091, 207, true
13253, 1566722165020, 24884, 1566722165232, 25096, 212, true
13254, 1566722165021, 24885, 1566722165233, 25097, 212, true
13255, 1566722165021, 24885, 1566722165233, 25097, 212, true
13256, 1566722165021, 24885, 1566722165230, 25094, 209, true
13257, 1566722165022, 24886, 1566722165232, 25096, 210, true
13258, 1566722165022, 24886, 1566722165232, 25096, 210, true
13259, 1566722165022, 24886, 1566722165232, 25096, 210, true
13260, 1566722165023, 24887, 1566722165233, 25097, 210, true
13261, 1566722165024, 24888, 1566722165230, 25094, 206, true
13262, 1566722165027, 24891, 1566722165257, 25121, 230, true
13263, 1566722165027, 24891, 1566722165257, 25121, 230, true
13264, 1566722165028, 24892, 1566722165233, 25097, 205, true
13265, 1566722165028, 24892, 1566722165277, 25141, 249, true
13266, 1566722165029, 24893, 1566722165265, 25129, 236, true
13267, 1566722165030, 24894, 1566722165277, 25141, 247, true
13268, 1566722165030, 24894, 1566722165278, 25142, 248, true
13269, 1566722165030, 24894, 1566722165278, 25142, 248, true
13270, 1566722165030, 24894, 1566722165278, 25142, 248, true
13271, 1566722165031, 24895, 1566722165278, 25142, 247, true
13272, 1566722165032, 24896, 1566722165277, 25141, 245, true
13273, 1566722165032, 24896, 1566722165265, 25129, 233, true
13274, 1566722165032, 24896, 1566722165278, 25142, 246, true
13275, 1566722165033, 24897, 1566722165277, 25141, 244, true
13276, 1566722165033, 24897, 1566722165277, 25141, 244, true
13277, 1566722165033, 24897, 1566722165266, 25130, 233, true
13278, 1566722165034, 24898, 1566722165264, 25128, 230, true
13279, 1566722165034, 24898, 1566722165279, 25143, 245, true
13280, 1566722165034, 24898, 1566722165265, 25129, 231, true
13281, 1566722165034, 24898, 1566722165266, 25130, 232, true
13282, 1566722165035, 24899, 1566722165265, 25129, 230, true
13283, 1566722165035, 24899, 1566722165256, 25120, 221, true
13284, 1566722165035, 24899, 1566722165266, 25130, 231, true
13285, 1566722165035, 24899, 1566722165266, 25130, 231, true
13286, 1566722165035, 24899, 1566722165276, 25140, 241, true
13287, 1566722165036, 24900, 1566722165277, 25141, 241, true
13288, 1566722165037, 24901, 1566722165266, 25130, 229, true
13289, 1566722165037, 24901, 1566722165266, 25130, 229, true
13290, 1566722165038, 24902, 1566722165277, 25141, 239, true
13291, 1566722165038, 24902, 1566722165277, 25141, 239, true
13292, 1566722165038, 24902, 1566722165265, 25129, 227, true
13293, 1566722165038, 24902, 1566722165276, 25140, 238, true
13294, 1566722165039, 24903, 1566722165265, 25129, 226, true
13295, 1566722165039, 24903, 1566722165277, 25141, 238, true
13296, 1566722165039, 24903, 1566722165265, 25129, 226, true
13297, 1566722165039, 24903, 1566722165277, 25141, 238, true
13298, 1566722165040, 24904, 1566722165264, 25128, 224, true
13299, 1566722165040, 24904, 1566722165276, 25140, 236, true
13300, 1566722165040, 24904, 1566722165278, 25142, 238, true
13301, 1566722165041, 24905, 1566722165279, 25143, 238, true
13302, 1566722165041, 24905, 1566722165257, 25121, 216, true
13303, 1566722165041, 24905, 1566722165279, 25143, 238, true
13304, 1566722165042, 24906, 1566722165276, 25140, 234, true
13305, 1566722165042, 24906, 1566722165265, 25129, 223, true
13306, 1566722165042, 24906, 1566722165277, 25141, 235, true
13307, 1566722165043, 24907, 1566722165276, 25140, 233, true
13308, 1566722165043, 24907, 1566722165266, 25130, 223, true
13309, 1566722165044, 24908, 1566722165278, 25142, 234, true
13310, 1566722165044, 24908, 1566722165265, 25129, 221, true
13311, 1566722165045, 24909, 1566722165264, 25128, 219, true
13312, 1566722165046, 24910, 1566722165278, 25142, 232, true
13313, 1566722165046, 24910, 1566722165276, 25140, 230, true
13314, 1566722165047, 24911, 1566722165259, 25123, 212, true
13315, 1566722165047, 24911, 1566722165277, 25141, 230, true
13316, 1566722165047, 24911, 1566722165276, 25140, 229, true
13317, 1566722165048, 24912, 1566722165279, 25143, 231, true
13318, 1566722165048, 24912, 1566722165278, 25142, 230, true
13319, 1566722165048, 24912, 1566722165276, 25140, 228, true
13320, 1566722165051, 24915, 1566722165279, 25143, 228, true
13321, 1566722165066, 24930, 1566722165279, 25143, 213, true
13322, 1566722165068, 24932, 1566722165279, 25143, 211, true
13323, 1566722165069, 24933, 1566722165279, 25143, 210, true
13324, 1566722165070, 24934, 1566722165279, 25143, 209, true
13325, 1566722165071, 24935, 1566722165280, 25144, 209, true
13326, 1566722165071, 24935, 1566722165279, 25143, 208, true
13327, 1566722165072, 24936, 1566722165283, 25147, 211, true
13328, 1566722165072, 24936, 1566722165280, 25144, 208, true
13329, 1566722165074, 24938, 1566722165283, 25147, 209, true
13330, 1566722165074, 24938, 1566722165283, 25147, 209, true
13331, 1566722165074, 24938, 1566722165283, 25147, 209, true
13332, 1566722165075, 24939, 1566722165283, 25147, 208, true
13333, 1566722165076, 24940, 1566722165283, 25147, 207, true
13334, 1566722165076, 24940, 1566722165283, 25147, 207, true
13335, 1566722165076, 24940, 1566722165283, 25147, 207, true
13336, 1566722165078, 24942, 1566722165285, 25149, 207, true
13337, 1566722165079, 24943, 1566722165286, 25150, 207, true
13338, 1566722165081, 24945, 1566722165288, 25152, 207, true
13339, 1566722165081, 24945, 1566722165288, 25152, 207, true
13340, 1566722165081, 24945, 1566722165293, 25157, 212, true
13341, 1566722165082, 24946, 1566722165295, 25159, 213, true
13342, 1566722165083, 24947, 1566722165293, 25157, 210, true
13343, 1566722165086, 24950, 1566722165292, 25156, 206, true
13344, 1566722165086, 24950, 1566722165292, 25156, 206, true
13345, 1566722165086, 24950, 1566722165292, 25156, 206, true
13346, 1566722165091, 24955, 1566722165298, 25162, 207, true
13347, 1566722165093, 24957, 1566722165298, 25162, 205, true
13348, 1566722165095, 24959, 1566722165306, 25170, 211, true
13349, 1566722165095, 24959, 1566722165306, 25170, 211, true
13350, 1566722165095, 24959, 1566722165303, 25167, 208, true
13351, 1566722165095, 24959, 1566722165312, 25176, 217, true
13352, 1566722165096, 24960, 1566722165312, 25176, 216, true
13353, 1566722165096, 24960, 1566722165312, 25176, 216, true
13354, 1566722165097, 24961, 1566722165306, 25170, 209, true
13355, 1566722165103, 24967, 1566722165311, 25175, 208, true
13356, 1566722165104, 24968, 1566722165307, 25171, 203, true
13357, 1566722165105, 24969, 1566722165315, 25179, 210, true
13358, 1566722165105, 24969, 1566722165315, 25179, 210, true
13359, 1566722165106, 24970, 1566722165312, 25176, 206, true
13360, 1566722165107, 24971, 1566722165315, 25179, 208, true
13361, 1566722165107, 24971, 1566722165315, 25179, 208, true
13362, 1566722165107, 24971, 1566722165315, 25179, 208, true
13363, 1566722165111, 24975, 1566722165325, 25189, 214, true
13364, 1566722165111, 24975, 1566722165315, 25179, 204, true
13365, 1566722165111, 24975, 1566722165316, 25180, 205, true
13366, 1566722165112, 24976, 1566722165321, 25185, 209, true
13367, 1566722165116, 24980, 1566722165325, 25189, 209, true
13368, 1566722165118, 24982, 1566722165324, 25188, 206, true
13369, 1566722165118, 24982, 1566722165325, 25189, 207, true
13370, 1566722165118, 24982, 1566722165325, 25189, 207, true
13371, 1566722165119, 24983, 1566722165326, 25190, 207, true
13372, 1566722165120, 24984, 1566722165326, 25190, 206, true
13373, 1566722165122, 24986, 1566722165327, 25191, 205, true
13374, 1566722165122, 24986, 1566722165327, 25191, 205, true
13375, 1566722165123, 24987, 1566722165332, 25196, 209, true
13376, 1566722165129, 24993, 1566722165339, 25203, 210, true
13377, 1566722165131, 24995, 1566722165335, 25199, 204, true
13378, 1566722165131, 24995, 1566722165335, 25199, 204, true
13379, 1566722165131, 24995, 1566722165339, 25203, 208, true
13380, 1566722165132, 24996, 1566722165339, 25203, 207, true
13381, 1566722165132, 24996, 1566722165339, 25203, 207, true
13382, 1566722165135, 24999, 1566722165342, 25206, 207, true
13383, 1566722165136, 25000, 1566722165341, 25205, 205, true
13384, 1566722165137, 25001, 1566722165342, 25206, 205, true
13385, 1566722165140, 25004, 1566722165347, 25211, 207, true
13386, 1566722165141, 25005, 1566722165347, 25211, 206, true
13387, 1566722165141, 25005, 1566722165348, 25212, 207, true
13388, 1566722165145, 25009, 1566722165351, 25215, 206, true
13389, 1566722165147, 25011, 1566722165360, 25224, 213, true
13390, 1566722165150, 25014, 1566722165359, 25223, 209, true
13391, 1566722165154, 25018, 1566722165359, 25223, 205, true
13392, 1566722165154, 25018, 1566722165362, 25226, 208, true
13393, 1566722165155, 25019, 1566722165359, 25223, 204, true
13394, 1566722165156, 25020, 1566722165386, 25250, 230, true
13395, 1566722165160, 25024, 1566722165372, 25236, 212, true
13396, 1566722165161, 25025, 1566722165384, 25248, 223, true
13397, 1566722165162, 25026, 1566722165386, 25250, 224, true
13398, 1566722165167, 25031, 1566722165392, 25256, 225, true
13399, 1566722165167, 25031, 1566722165392, 25256, 225, true
13400, 1566722165168, 25032, 1566722165377, 25241, 209, true
13401, 1566722165173, 25037, 1566722165382, 25246, 209, true
13402, 1566722165174, 25038, 1566722165392, 25256, 218, true
13403, 1566722165176, 25040, 1566722165384, 25248, 208, true
13404, 1566722165177, 25041, 1566722165390, 25254, 213, true
13405, 1566722165178, 25042, 1566722165390, 25254, 212, true
13406, 1566722165180, 25044, 1566722165384, 25248, 204, true
13407, 1566722165181, 25045, 1566722165390, 25254, 209, true
13408, 1566722165183, 25047, 1566722165387, 25251, 204, true
13409, 1566722165188, 25052, 1566722165392, 25256, 204, true
13410, 1566722165189, 25053, 1566722165392, 25256, 203, true
13411, 1566722165191, 25055, 1566722165397, 25261, 206, true
13412, 1566722165192, 25056, 1566722165394, 25258, 202, true
13413, 1566722165193, 25057, 1566722165400, 25264, 207, true
13414, 1566722165202, 25066, 1566722165409, 25273, 207, true
13415, 1566722165202, 25066, 1566722165417, 25281, 215, true
13416, 1566722165202, 25066, 1566722165417, 25281, 215, true
13417, 1566722165203, 25067, 1566722165417, 25281, 214, true
13418, 1566722165206, 25070, 1566722165417, 25281, 211, true
13419, 1566722165206, 25070, 1566722165420, 25284, 214, true
13420, 1566722165206, 25070, 1566722165422, 25286, 216, true
13421, 1566722165207, 25071, 1566722165422, 25286, 215, true
13422, 1566722165207, 25071, 1566722165418, 25282, 211, true
13423, 1566722165208, 25072, 1566722165417, 25281, 209, true
13424, 1566722165209, 25073, 1566722165428, 25292, 219, true
13425, 1566722165210, 25074, 1566722165428, 25292, 218, true
13426, 1566722165210, 25074, 1566722165434, 25298, 224, true
13427, 1566722165211, 25075, 1566722165432, 25296, 221, true
13428, 1566722165211, 25075, 1566722165432, 25296, 221, true
13429, 1566722165212, 25076, 1566722165433, 25297, 221, true
13430, 1566722165212, 25076, 1566722165432, 25296, 220, true
13431, 1566722165213, 25077, 1566722165434, 25298, 221, true
13432, 1566722165214, 25078, 1566722165433, 25297, 219, true
13433, 1566722165214, 25078, 1566722165433, 25297, 219, true
13434, 1566722165235, 25099, 1566722165440, 25304, 205, true
13435, 1566722165235, 25099, 1566722165445, 25309, 210, true
13436, 1566722165235, 25099, 1566722165445, 25309, 210, true
13437, 1566722165236, 25100, 1566722165445, 25309, 209, true
13438, 1566722165236, 25100, 1566722165445, 25309, 209, true
13439, 1566722165238, 25102, 1566722165441, 25305, 203, true
13440, 1566722165240, 25104, 1566722165445, 25309, 205, true
13441, 1566722165240, 25104, 1566722165447, 25311, 207, true
13442, 1566722165241, 25105, 1566722165454, 25318, 213, true
13443, 1566722165241, 25105, 1566722165448, 25312, 207, true
13444, 1566722165242, 25106, 1566722165454, 25318, 212, true
13445, 1566722165243, 25107, 1566722165447, 25311, 204, true
13446, 1566722165244, 25108, 1566722165457, 25321, 213, true
13447, 1566722165245, 25109, 1566722165462, 25326, 217, true
13448, 1566722165245, 25109, 1566722165459, 25323, 214, true
13449, 1566722165246, 25110, 1566722165462, 25326, 216, true
13450, 1566722165247, 25111, 1566722165457, 25321, 210, true
13451, 1566722165248, 25112, 1566722165462, 25326, 214, true
13452, 1566722165248, 25112, 1566722165462, 25326, 214, true
13453, 1566722165248, 25112, 1566722165457, 25321, 209, true
13454, 1566722165249, 25113, 1566722165462, 25326, 213, true
13455, 1566722165249, 25113, 1566722165462, 25326, 213, true
13456, 1566722165249, 25113, 1566722165462, 25326, 213, true
13457, 1566722165250, 25114, 1566722165462, 25326, 212, true
13458, 1566722165250, 25114, 1566722165464, 25328, 214, true
13459, 1566722165250, 25114, 1566722165489, 25353, 239, true
13460, 1566722165251, 25115, 1566722165467, 25331, 216, true
13461, 1566722165251, 25115, 1566722165478, 25342, 227, true
13462, 1566722165252, 25116, 1566722165478, 25342, 226, true
13463, 1566722165252, 25116, 1566722165478, 25342, 226, true
13464, 1566722165252, 25116, 1566722165488, 25352, 236, true
13465, 1566722165294, 25158, 1566722165499, 25363, 205, true
13466, 1566722165294, 25158, 1566722165500, 25364, 206, true
13467, 1566722165295, 25159, 1566722165535, 25399, 240, true
13468, 1566722165298, 25162, 1566722165534, 25398, 236, true
13469, 1566722165304, 25168, 1566722165537, 25401, 233, true
13470, 1566722165304, 25168, 1566722165532, 25396, 228, true
13471, 1566722165304, 25168, 1566722165540, 25404, 236, true
13472, 1566722165304, 25168, 1566722165546, 25410, 242, true
13473, 1566722165305, 25169, 1566722165536, 25400, 231, true
13474, 1566722165317, 25181, 1566722165534, 25398, 217, true
13475, 1566722165317, 25181, 1566722165525, 25389, 208, true
13476, 1566722165318, 25182, 1566722165534, 25398, 216, true
13477, 1566722165318, 25182, 1566722165534, 25398, 216, true
13478, 1566722165319, 25183, 1566722165530, 25394, 211, true
13479, 1566722165320, 25184, 1566722165550, 25414, 230, true
13480, 1566722165321, 25185, 1566722165546, 25410, 225, true
13481, 1566722165322, 25186, 1566722165553, 25417, 231, true
13482, 1566722165323, 25187, 1566722165550, 25414, 227, true
13483, 1566722165327, 25191, 1566722165550, 25414, 223, true
13484, 1566722165328, 25192, 1566722165549, 25413, 221, true
13485, 1566722165328, 25192, 1566722165556, 25420, 228, true
13486, 1566722165330, 25194, 1566722165552, 25416, 222, true
13487, 1566722165332, 25196, 1566722165550, 25414, 218, true
13488, 1566722165334, 25198, 1566722165553, 25417, 219, true
13489, 1566722165335, 25199, 1566722165550, 25414, 215, true
13490, 1566722165336, 25200, 1566722165552, 25416, 216, true
13491, 1566722165336, 25200, 1566722165549, 25413, 213, true
13492, 1566722165339, 25203, 1566722165554, 25418, 215, true
13493, 1566722165340, 25204, 1566722165553, 25417, 213, true
13494, 1566722165342, 25206, 1566722165556, 25420, 214, true
13495, 1566722165345, 25209, 1566722165556, 25420, 211, true
13496, 1566722165349, 25213, 1566722165555, 25419, 206, true
13497, 1566722165349, 25213, 1566722165556, 25420, 207, true
13498, 1566722165350, 25214, 1566722165559, 25423, 209, true
13499, 1566722165351, 25215, 1566722165555, 25419, 204, true
13500, 1566722165352, 25216, 1566722165559, 25423, 207, true
13501, 1566722165352, 25216, 1566722165559, 25423, 207, true
13502, 1566722165353, 25217, 1566722165559, 25423, 206, true
13503, 1566722165353, 25217, 1566722165564, 25428, 211, true
13504, 1566722165354, 25218, 1566722165564, 25428, 210, true
13505, 1566722165356, 25220, 1566722165566, 25430, 210, true
13506, 1566722165357, 25221, 1566722165566, 25430, 209, true
13507, 1566722165360, 25224, 1566722165566, 25430, 206, true
13508, 1566722165361, 25225, 1566722165566, 25430, 205, true
13509, 1566722165363, 25227, 1566722165569, 25433, 206, true
13510, 1566722165364, 25228, 1566722165575, 25439, 211, true
13511, 1566722165364, 25228, 1566722165571, 25435, 207, true
13512, 1566722165364, 25228, 1566722165579, 25443, 215, true
13513, 1566722165364, 25228, 1566722165582, 25446, 218, true
13514, 1566722165365, 25229, 1566722165582, 25446, 217, true
13515, 1566722165365, 25229, 1566722165578, 25442, 213, true
13516, 1566722165368, 25232, 1566722165578, 25442, 210, true
13517, 1566722165370, 25234, 1566722165582, 25446, 212, true
13518, 1566722165370, 25234, 1566722165582, 25446, 212, true
13519, 1566722165373, 25237, 1566722165583, 25447, 210, true
13520, 1566722165373, 25237, 1566722165583, 25447, 210, true
13521, 1566722165374, 25238, 1566722165585, 25449, 211, true
13522, 1566722165374, 25238, 1566722165590, 25454, 216, true
13523, 1566722165374, 25238, 1566722165589, 25453, 215, true
13524, 1566722165375, 25239, 1566722165590, 25454, 215, true
13525, 1566722165376, 25240, 1566722165587, 25451, 211, true
13526, 1566722165377, 25241, 1566722165585, 25449, 208, true
13527, 1566722165378, 25242, 1566722165595, 25459, 217, true
13528, 1566722165379, 25243, 1566722165590, 25454, 211, true
13529, 1566722165380, 25244, 1566722165598, 25462, 218, true
13530, 1566722165381, 25245, 1566722165592, 25456, 211, true
13531, 1566722165381, 25245, 1566722165598, 25462, 217, true
13532, 1566722165383, 25247, 1566722165596, 25460, 213, true
13533, 1566722165386, 25250, 1566722165590, 25454, 204, true
13534, 1566722165393, 25257, 1566722165601, 25465, 208, true
13535, 1566722165394, 25258, 1566722165603, 25467, 209, true
13536, 1566722165395, 25259, 1566722165602, 25466, 207, true
13537, 1566722165395, 25259, 1566722165605, 25469, 210, true
13538, 1566722165398, 25262, 1566722165608, 25472, 210, true
13539, 1566722165398, 25262, 1566722165613, 25477, 215, true
13540, 1566722165399, 25263, 1566722165606, 25470, 207, true
13541, 1566722165400, 25264, 1566722165605, 25469, 205, true
13542, 1566722165401, 25265, 1566722165626, 25490, 225, true
13543, 1566722165402, 25266, 1566722165626, 25490, 224, true
13544, 1566722165402, 25266, 1566722165626, 25490, 224, true
13545, 1566722165403, 25267, 1566722165626, 25490, 223, true
13546, 1566722165404, 25268, 1566722165626, 25490, 222, true
13547, 1566722165404, 25268, 1566722165626, 25490, 222, true
13548, 1566722165405, 25269, 1566722165626, 25490, 221, true
13549, 1566722165405, 25269, 1566722165627, 25491, 222, true
13550, 1566722165405, 25269, 1566722165615, 25479, 210, true
13551, 1566722165406, 25270, 1566722165620, 25484, 214, true
13552, 1566722165406, 25270, 1566722165626, 25490, 220, true
13553, 1566722165406, 25270, 1566722165620, 25484, 214, true
13554, 1566722165407, 25271, 1566722165626, 25490, 219, true
13555, 1566722165409, 25273, 1566722165626, 25490, 217, true
13556, 1566722165413, 25277, 1566722165627, 25491, 214, true
13557, 1566722165413, 25277, 1566722165626, 25490, 213, true
13558, 1566722165413, 25277, 1566722165626, 25490, 213, true
13559, 1566722165414, 25278, 1566722165627, 25491, 213, true
13560, 1566722165414, 25278, 1566722165627, 25491, 213, true
13561, 1566722165417, 25281, 1566722165627, 25491, 210, true
13562, 1566722165423, 25287, 1566722165628, 25492, 205, true
13563, 1566722165424, 25288, 1566722165629, 25493, 205, true
13564, 1566722165425, 25289, 1566722165628, 25492, 203, true
13565, 1566722165428, 25292, 1566722165633, 25497, 205, true
13566, 1566722165435, 25299, 1566722165638, 25502, 203, true
13567, 1566722165436, 25300, 1566722165647, 25511, 211, true
13568, 1566722165438, 25302, 1566722165647, 25511, 209, true
13569, 1566722165441, 25305, 1566722165653, 25517, 212, true
13570, 1566722165449, 25313, 1566722165653, 25517, 204, true
13571, 1566722165451, 25315, 1566722165654, 25518, 203, true
13572, 1566722165452, 25316, 1566722165657, 25521, 205, true
13573, 1566722165455, 25319, 1566722165659, 25523, 204, true
13574, 1566722165459, 25323, 1566722165667, 25531, 208, true
13575, 1566722165465, 25329, 1566722165669, 25533, 204, true
13576, 1566722165466, 25330, 1566722165669, 25533, 203, true
13577, 1566722165467, 25331, 1566722165671, 25535, 204, true
13578, 1566722165468, 25332, 1566722165672, 25536, 204, true
13579, 1566722165469, 25333, 1566722165672, 25536, 203, true
13580, 1566722165469, 25333, 1566722165672, 25536, 203, true
13581, 1566722165470, 25334, 1566722165679, 25543, 209, true
13582, 1566722165470, 25334, 1566722165679, 25543, 209, true
13583, 1566722165470, 25334, 1566722165685, 25549, 215, true
13584, 1566722165472, 25336, 1566722165699, 25563, 227, true
13585, 1566722165473, 25337, 1566722165697, 25561, 224, true
13586, 1566722165474, 25338, 1566722165697, 25561, 223, true
13587, 1566722165474, 25338, 1566722165689, 25553, 215, true
13588, 1566722165475, 25339, 1566722165697, 25561, 222, true
13589, 1566722165476, 25340, 1566722165697, 25561, 221, true
13590, 1566722165479, 25343, 1566722165697, 25561, 218, true
13591, 1566722165480, 25344, 1566722165697, 25561, 217, true
13592, 1566722165480, 25344, 1566722165697, 25561, 217, true
13593, 1566722165481, 25345, 1566722165690, 25554, 209, true
13594, 1566722165482, 25346, 1566722165690, 25554, 208, true
13595, 1566722165482, 25346, 1566722165697, 25561, 215, true
13596, 1566722165483, 25347, 1566722165689, 25553, 206, true
13597, 1566722165483, 25347, 1566722165689, 25553, 206, true
13598, 1566722165484, 25348, 1566722165722, 25586, 238, true
13599, 1566722165485, 25349, 1566722165697, 25561, 212, true
13600, 1566722165489, 25353, 1566722165697, 25561, 208, true
13601, 1566722165490, 25354, 1566722165722, 25586, 232, true
13602, 1566722165490, 25354, 1566722165722, 25586, 232, true
13603, 1566722165491, 25355, 1566722165698, 25562, 207, true
13604, 1566722165492, 25356, 1566722165722, 25586, 230, true
13605, 1566722165493, 25357, 1566722165708, 25572, 215, true
13606, 1566722165494, 25358, 1566722165731, 25595, 237, true
13607, 1566722165495, 25359, 1566722165731, 25595, 236, true
13608, 1566722165496, 25360, 1566722165702, 25566, 206, true
13609, 1566722165497, 25361, 1566722165704, 25568, 207, true
13610, 1566722165500, 25364, 1566722165727, 25591, 227, true
13611, 1566722165500, 25364, 1566722165706, 25570, 206, true
13612, 1566722165501, 25365, 1566722165707, 25571, 206, true
13613, 1566722165502, 25366, 1566722165722, 25586, 220, true
13614, 1566722165503, 25367, 1566722165722, 25586, 219, true
13615, 1566722165504, 25368, 1566722165722, 25586, 218, true
13616, 1566722165505, 25369, 1566722165722, 25586, 217, true
13617, 1566722165506, 25370, 1566722165722, 25586, 216, true
13618, 1566722165507, 25371, 1566722165722, 25586, 215, true
13619, 1566722165508, 25372, 1566722165734, 25598, 226, true
13620, 1566722165509, 25373, 1566722165722, 25586, 213, true
13621, 1566722165510, 25374, 1566722165734, 25598, 224, true
13622, 1566722165514, 25378, 1566722165727, 25591, 213, true
13623, 1566722165515, 25379, 1566722165734, 25598, 219, true
13624, 1566722165520, 25384, 1566722165734, 25598, 214, true
13625, 1566722165521, 25385, 1566722165734, 25598, 213, true
13626, 1566722165522, 25386, 1566722165732, 25596, 210, true
13627, 1566722165524, 25388, 1566722165734, 25598, 210, true
13628, 1566722165527, 25391, 1566722165734, 25598, 207, true
13629, 1566722165527, 25391, 1566722165738, 25602, 211, true
13630, 1566722165527, 25391, 1566722165740, 25604, 213, true
13631, 1566722165528, 25392, 1566722165736, 25600, 208, true
13632, 1566722165528, 25392, 1566722165740, 25604, 212, true
13633, 1566722165529, 25393, 1566722165740, 25604, 211, true
13634, 1566722165530, 25394, 1566722165741, 25605, 211, true
13635, 1566722165531, 25395, 1566722165747, 25611, 216, true
13636, 1566722165532, 25396, 1566722165741, 25605, 209, true
13637, 1566722165538, 25402, 1566722165747, 25611, 209, true
13638, 1566722165539, 25403, 1566722165747, 25611, 208, true
13639, 1566722165539, 25403, 1566722165747, 25611, 208, true
13640, 1566722165539, 25403, 1566722165747, 25611, 208, true
13641, 1566722165542, 25406, 1566722165747, 25611, 205, true
13642, 1566722165543, 25407, 1566722165751, 25615, 208, true
13643, 1566722165543, 25407, 1566722165751, 25615, 208, true
13644, 1566722165544, 25408, 1566722165749, 25613, 205, true
13645, 1566722165547, 25411, 1566722165755, 25619, 208, true
13646, 1566722165553, 25417, 1566722165769, 25633, 216, true
13647, 1566722165557, 25421, 1566722165769, 25633, 212, true
13648, 1566722165558, 25422, 1566722165853, 25717, 295, true
13649, 1566722165559, 25423, 1566722165785, 25649, 226, true
13650, 1566722165560, 25424, 1566722165854, 25718, 294, true
13651, 1566722165560, 25424, 1566722165774, 25638, 214, true
13652, 1566722165560, 25424, 1566722165772, 25636, 212, true
13653, 1566722165560, 25424, 1566722165774, 25638, 214, true
13654, 1566722165560, 25424, 1566722165774, 25638, 214, true
13655, 1566722165560, 25424, 1566722165772, 25636, 212, true
13656, 1566722165561, 25425, 1566722165858, 25722, 297, true
13657, 1566722165566, 25430, 1566722165915, 25779, 349, true
13658, 1566722165567, 25431, 1566722165934, 25798, 367, true
13659, 1566722165568, 25432, 1566722165915, 25779, 347, true
13660, 1566722165569, 25433, 1566722165898, 25762, 329, true
13661, 1566722165571, 25435, 1566722165894, 25758, 323, true
13662, 1566722165572, 25436, 1566722165904, 25768, 332, true
13663, 1566722165572, 25436, 1566722165905, 25769, 333, true
13664, 1566722165573, 25437, 1566722165894, 25758, 321, true
13665, 1566722165573, 25437, 1566722165933, 25797, 360, true
13666, 1566722165573, 25437, 1566722165917, 25781, 344, true
13667, 1566722165574, 25438, 1566722165903, 25767, 329, true
13668, 1566722165575, 25439, 1566722165892, 25756, 317, true
13669, 1566722165576, 25440, 1566722165892, 25756, 316, true
13670, 1566722165577, 25441, 1566722165933, 25797, 356, true
13671, 1566722165577, 25441, 1566722165907, 25771, 330, true
13672, 1566722165579, 25443, 1566722165915, 25779, 336, true
13673, 1566722165583, 25447, 1566722165933, 25797, 350, true
13674, 1566722165583, 25447, 1566722165893, 25757, 310, true
13675, 1566722165584, 25448, 1566722165915, 25779, 331, true
13676, 1566722165584, 25448, 1566722165893, 25757, 309, true
13677, 1566722165585, 25449, 1566722165882, 25746, 297, true
13678, 1566722165585, 25449, 1566722165897, 25761, 312, true
13679, 1566722165586, 25450, 1566722165905, 25769, 319, true
13680, 1566722165586, 25450, 1566722165898, 25762, 312, true
13681, 1566722165586, 25450, 1566722165894, 25758, 308, true
13682, 1566722165587, 25451, 1566722165897, 25761, 310, true
13683, 1566722165590, 25454, 1566722165884, 25748, 294, true
13684, 1566722165590, 25454, 1566722165883, 25747, 293, true
13685, 1566722165591, 25455, 1566722165882, 25746, 291, true
13686, 1566722165591, 25455, 1566722165894, 25758, 303, true
13687, 1566722165592, 25456, 1566722165903, 25767, 311, true
13688, 1566722165592, 25456, 1566722165903, 25767, 311, true
13689, 1566722165593, 25457, 1566722165903, 25767, 310, true
13690, 1566722165593, 25457, 1566722165925, 25789, 332, true
13691, 1566722165594, 25458, 1566722165916, 25780, 322, true
13692, 1566722165595, 25459, 1566722165882, 25746, 287, true
13693, 1566722165595, 25459, 1566722165893, 25757, 298, true
13694, 1566722165596, 25460, 1566722165892, 25756, 296, true
13695, 1566722165597, 25461, 1566722165892, 25756, 295, true
13696, 1566722165597, 25461, 1566722165920, 25784, 323, true
13697, 1566722165598, 25462, 1566722165916, 25780, 318, true
13698, 1566722165599, 25463, 1566722165897, 25761, 298, true
13699, 1566722165599, 25463, 1566722165934, 25798, 335, true
13700, 1566722165600, 25464, 1566722165882, 25746, 282, true
13701, 1566722165601, 25465, 1566722165914, 25778, 313, true
13702, 1566722165602, 25466, 1566722165892, 25756, 290, true
13703, 1566722165602, 25466, 1566722165884, 25748, 282, true
13704, 1566722165603, 25467, 1566722165909, 25773, 306, true
13705, 1566722165603, 25467, 1566722165932, 25796, 329, true
13706, 1566722165605, 25469, 1566722165933, 25797, 328, true
13707, 1566722165606, 25470, 1566722165876, 25740, 270, true
13708, 1566722165606, 25470, 1566722165883, 25747, 277, true
13709, 1566722165607, 25471, 1566722165894, 25758, 287, true
13710, 1566722165607, 25471, 1566722165898, 25762, 291, true
13711, 1566722165608, 25472, 1566722165903, 25767, 295, true
13712, 1566722165609, 25473, 1566722165877, 25741, 268, true
13713, 1566722165610, 25474, 1566722165916, 25780, 306, true
13714, 1566722165611, 25475, 1566722165910, 25774, 299, true
13715, 1566722165611, 25475, 1566722165893, 25757, 282, true
13716, 1566722165612, 25476, 1566722165882, 25746, 270, true
13717, 1566722165613, 25477, 1566722165915, 25779, 302, true
13718, 1566722165614, 25478, 1566722165934, 25798, 320, true
13719, 1566722165614, 25478, 1566722165917, 25781, 303, true
13720, 1566722165615, 25479, 1566722165899, 25763, 284, true
13721, 1566722165616, 25480, 1566722165910, 25774, 294, true
13722, 1566722165616, 25480, 1566722165893, 25757, 277, true
13723, 1566722165617, 25481, 1566722165881, 25745, 264, true
13724, 1566722165618, 25482, 1566722165891, 25755, 273, true
13725, 1566722165619, 25483, 1566722165892, 25756, 273, true
13726, 1566722165619, 25483, 1566722165898, 25762, 279, true
13727, 1566722165620, 25484, 1566722165893, 25757, 273, true
13728, 1566722165628, 25492, 1566722165883, 25747, 255, true
13729, 1566722165629, 25493, 1566722165909, 25773, 280, true
13730, 1566722165629, 25493, 1566722165894, 25758, 265, true
13731, 1566722165630, 25494, 1566722165882, 25746, 252, true
13732, 1566722165630, 25494, 1566722165894, 25758, 264, true
13733, 1566722165631, 25495, 1566722165903, 25767, 272, true
13734, 1566722165631, 25495, 1566722165903, 25767, 272, true
13735, 1566722165631, 25495, 1566722165915, 25779, 284, true
13736, 1566722165632, 25496, 1566722165910, 25774, 278, true
13737, 1566722165633, 25497, 1566722165895, 25759, 262, true
13738, 1566722165634, 25498, 1566722165892, 25756, 258, true
13739, 1566722165635, 25499, 1566722165898, 25762, 263, true
13740, 1566722165635, 25499, 1566722165894, 25758, 259, true
13741, 1566722165635, 25499, 1566722165895, 25759, 260, true
13742, 1566722165636, 25500, 1566722165934, 25798, 298, true
13743, 1566722165636, 25500, 1566722165909, 25773, 273, true
13744, 1566722165637, 25501, 1566722165897, 25761, 260, true
13745, 1566722165638, 25502, 1566722165881, 25745, 243, true
13746, 1566722165639, 25503, 1566722165915, 25779, 276, true
13747, 1566722165639, 25503, 1566722165905, 25769, 266, true
13748, 1566722165639, 25503, 1566722165874, 25738, 235, true
13749, 1566722165640, 25504, 1566722165893, 25757, 253, true
13750, 1566722165640, 25504, 1566722165881, 25745, 241, true
13751, 1566722165641, 25505, 1566722165882, 25746, 241, true
13752, 1566722165641, 25505, 1566722165903, 25767, 262, true
13753, 1566722165641, 25505, 1566722165907, 25771, 266, true
13754, 1566722165641, 25505, 1566722165915, 25779, 274, true
13755, 1566722165642, 25506, 1566722165892, 25756, 250, true
13756, 1566722165643, 25507, 1566722165893, 25757, 250, true
13757, 1566722165644, 25508, 1566722165903, 25767, 259, true
13758, 1566722165644, 25508, 1566722165881, 25745, 237, true
13759, 1566722165645, 25509, 1566722165892, 25756, 247, true
13760, 1566722165646, 25510, 1566722165883, 25747, 237, true
13761, 1566722165647, 25511, 1566722165903, 25767, 256, true
13762, 1566722165648, 25512, 1566722165933, 25797, 285, true
13763, 1566722165648, 25512, 1566722165903, 25767, 255, true
13764, 1566722165648, 25512, 1566722165881, 25745, 233, true
13765, 1566722165649, 25513, 1566722165875, 25739, 226, true
13766, 1566722165649, 25513, 1566722165894, 25758, 245, true
13767, 1566722165650, 25514, 1566722165895, 25759, 245, true
13768, 1566722165651, 25515, 1566722165933, 25797, 282, true
13769, 1566722165652, 25516, 1566722165921, 25785, 269, true
13770, 1566722165653, 25517, 1566722165937, 25801, 284, true
13771, 1566722165655, 25519, 1566722165933, 25797, 278, true
13772, 1566722165655, 25519, 1566722165931, 25795, 276, true
13773, 1566722165655, 25519, 1566722165932, 25796, 277, true
13774, 1566722165655, 25519, 1566722165932, 25796, 277, true
13775, 1566722165655, 25519, 1566722165921, 25785, 266, true
13776, 1566722165656, 25520, 1566722165932, 25796, 276, true
13777, 1566722165657, 25521, 1566722165921, 25785, 264, true
13778, 1566722165657, 25521, 1566722165934, 25798, 277, true
13779, 1566722165657, 25521, 1566722165934, 25798, 277, true
13780, 1566722165658, 25522, 1566722165932, 25796, 274, true
13781, 1566722165659, 25523, 1566722165924, 25788, 265, true
13782, 1566722165659, 25523, 1566722165921, 25785, 262, true
13783, 1566722165659, 25523, 1566722165933, 25797, 274, true
13784, 1566722165660, 25524, 1566722165921, 25785, 261, true
13785, 1566722165660, 25524, 1566722165932, 25796, 272, true
13786, 1566722165660, 25524, 1566722165932, 25796, 272, true
13787, 1566722165661, 25525, 1566722165933, 25797, 272, true
13788, 1566722165661, 25525, 1566722165933, 25797, 272, true
13789, 1566722165662, 25526, 1566722165932, 25796, 270, true
13790, 1566722165664, 25528, 1566722165918, 25782, 254, true
13791, 1566722165664, 25528, 1566722165933, 25797, 269, true
13792, 1566722165664, 25528, 1566722165934, 25798, 270, true
13793, 1566722165665, 25529, 1566722165932, 25796, 267, true
13794, 1566722165665, 25529, 1566722165933, 25797, 268, true
13795, 1566722165665, 25529, 1566722165932, 25796, 267, true
13796, 1566722165666, 25530, 1566722165933, 25797, 267, true
13797, 1566722165667, 25531, 1566722165933, 25797, 266, true
13798, 1566722165667, 25531, 1566722165921, 25785, 254, true
13799, 1566722165742, 25606, 1566722165951, 25815, 209, true
13800, 1566722165743, 25607, 1566722165947, 25811, 204, true
13801, 1566722165744, 25608, 1566722165949, 25813, 205, true
13802, 1566722165748, 25612, 1566722165952, 25816, 204, true
13803, 1566722165749, 25613, 1566722165959, 25823, 210, true
13804, 1566722165752, 25616, 1566722165959, 25823, 207, true
13805, 1566722165753, 25617, 1566722165959, 25823, 206, true
13806, 1566722165755, 25619, 1566722165961, 25825, 206, true
13807, 1566722165757, 25621, 1566722165961, 25825, 204, true
13808, 1566722165758, 25622, 1566722165961, 25825, 203, true
13809, 1566722165759, 25623, 1566722165966, 25830, 207, true
13810, 1566722165760, 25624, 1566722165967, 25831, 207, true
13811, 1566722165762, 25626, 1566722165967, 25831, 205, true
13812, 1566722165763, 25627, 1566722165967, 25831, 204, true
13813, 1566722165765, 25629, 1566722165969, 25833, 204, true
13814, 1566722165767, 25631, 1566722165973, 25837, 206, true
13815, 1566722165770, 25634, 1566722165975, 25839, 205, true
13816, 1566722165774, 25638, 1566722165979, 25843, 205, true
13817, 1566722165775, 25639, 1566722165981, 25845, 206, true
13818, 1566722165777, 25641, 1566722165981, 25845, 204, true
13819, 1566722165778, 25642, 1566722165988, 25852, 210, true
13820, 1566722165780, 25644, 1566722165990, 25854, 210, true
13821, 1566722165781, 25645, 1566722166004, 25868, 223, true
13822, 1566722165783, 25647, 1566722166000, 25864, 217, true
13823, 1566722165789, 25653, 1566722166013, 25877, 224, true
13824, 1566722165790, 25654, 1566722166002, 25866, 212, true
13825, 1566722165794, 25658, 1566722166013, 25877, 219, true
13826, 1566722165794, 25658, 1566722166008, 25872, 214, true
13827, 1566722165794, 25658, 1566722166036, 25900, 242, true
13828, 1566722165795, 25659, 1566722166008, 25872, 213, true
13829, 1566722165796, 25660, 1566722166008, 25872, 212, true
13830, 1566722165797, 25661, 1566722166004, 25868, 207, true
13831, 1566722165797, 25661, 1566722166003, 25867, 206, true
13832, 1566722165798, 25662, 1566722166008, 25872, 210, true
13833, 1566722165798, 25662, 1566722166008, 25872, 210, true
13834, 1566722165799, 25663, 1566722166013, 25877, 214, true
13835, 1566722165800, 25664, 1566722166038, 25902, 238, true
13836, 1566722165802, 25666, 1566722166011, 25875, 209, true
13837, 1566722165802, 25666, 1566722166014, 25878, 212, true
13838, 1566722165803, 25667, 1566722166013, 25877, 210, true
13839, 1566722165804, 25668, 1566722166011, 25875, 207, true
13840, 1566722165805, 25669, 1566722166014, 25878, 209, true
13841, 1566722165805, 25669, 1566722166027, 25891, 222, true
13842, 1566722165805, 25669, 1566722166014, 25878, 209, true
13843, 1566722165810, 25674, 1566722166040, 25904, 230, true
13844, 1566722165810, 25674, 1566722166022, 25886, 212, true
13845, 1566722165811, 25675, 1566722166039, 25903, 228, true
13846, 1566722165811, 25675, 1566722166039, 25903, 228, true
13847, 1566722165813, 25677, 1566722166039, 25903, 226, true
13848, 1566722165814, 25678, 1566722166038, 25902, 224, true
13849, 1566722165817, 25681, 1566722166041, 25905, 224, true
13850, 1566722165817, 25681, 1566722166037, 25901, 220, true
13851, 1566722165818, 25682, 1566722166038, 25902, 220, true
13852, 1566722165818, 25682, 1566722166036, 25900, 218, true
13853, 1566722165819, 25683, 1566722166034, 25898, 215, true
13854, 1566722165820, 25684, 1566722166037, 25901, 217, true
13855, 1566722165821, 25685, 1566722166036, 25900, 215, true
13856, 1566722165822, 25686, 1566722166037, 25901, 215, true
13857, 1566722165828, 25692, 1566722166036, 25900, 208, true
13858, 1566722165828, 25692, 1566722166038, 25902, 210, true
13859, 1566722165829, 25693, 1566722166036, 25900, 207, true
13860, 1566722165829, 25693, 1566722166066, 25930, 237, true
13861, 1566722165830, 25694, 1566722166068, 25932, 238, true
13862, 1566722165831, 25695, 1566722166081, 25945, 250, true
13863, 1566722165832, 25696, 1566722166078, 25942, 246, true
13864, 1566722165833, 25697, 1566722166077, 25941, 244, true
13865, 1566722165833, 25697, 1566722166067, 25931, 234, true
13866, 1566722165833, 25697, 1566722166057, 25921, 224, true
13867, 1566722165834, 25698, 1566722166057, 25921, 223, true
13868, 1566722165834, 25698, 1566722166078, 25942, 244, true
13869, 1566722165834, 25698, 1566722166078, 25942, 244, true
13870, 1566722165835, 25699, 1566722166062, 25926, 227, true
13871, 1566722165835, 25699, 1566722166067, 25931, 232, true
13872, 1566722165836, 25700, 1566722166077, 25941, 241, true
13873, 1566722165836, 25700, 1566722166066, 25930, 230, true
13874, 1566722165837, 25701, 1566722166067, 25931, 230, true
13875, 1566722165838, 25702, 1566722166077, 25941, 239, true
13876, 1566722165838, 25702, 1566722166067, 25931, 229, true
13877, 1566722165838, 25702, 1566722166067, 25931, 229, true
13878, 1566722165839, 25703, 1566722166068, 25932, 229, true
13879, 1566722165839, 25703, 1566722166077, 25941, 238, true
13880, 1566722165839, 25703, 1566722166067, 25931, 228, true
13881, 1566722165840, 25704, 1566722166077, 25941, 237, true
13882, 1566722165840, 25704, 1566722166067, 25931, 227, true
13883, 1566722165841, 25705, 1566722166078, 25942, 237, true
13884, 1566722165841, 25705, 1566722166078, 25942, 237, true
13885, 1566722165841, 25705, 1566722166062, 25926, 221, true
13886, 1566722165842, 25706, 1566722166062, 25926, 220, true
13887, 1566722165842, 25706, 1566722166078, 25942, 236, true
13888, 1566722165842, 25706, 1566722166077, 25941, 235, true
13889, 1566722165842, 25706, 1566722166078, 25942, 236, true
13890, 1566722165843, 25707, 1566722166078, 25942, 235, true
13891, 1566722165843, 25707, 1566722166077, 25941, 234, true
13892, 1566722165843, 25707, 1566722166067, 25931, 224, true
13893, 1566722165844, 25708, 1566722166067, 25931, 223, true
13894, 1566722165844, 25708, 1566722166077, 25941, 233, true
13895, 1566722165844, 25708, 1566722166068, 25932, 224, true
13896, 1566722165845, 25709, 1566722166076, 25940, 231, true
13897, 1566722165845, 25709, 1566722166077, 25941, 232, true
13898, 1566722165846, 25710, 1566722166068, 25932, 222, true
13899, 1566722165846, 25710, 1566722166054, 25918, 208, true
13900, 1566722165847, 25711, 1566722166078, 25942, 231, true
13901, 1566722165848, 25712, 1566722166062, 25926, 214, true
13902, 1566722165848, 25712, 1566722166066, 25930, 218, true
13903, 1566722165848, 25712, 1566722166143, 26007, 295, true
13904, 1566722165849, 25713, 1566722166106, 25970, 257, true
13905, 1566722165849, 25713, 1566722166144, 26008, 295, true
13906, 1566722165849, 25713, 1566722166143, 26007, 294, true
13907, 1566722165862, 25726, 1566722166143, 26007, 281, true
13908, 1566722165863, 25727, 1566722166149, 26013, 286, true
13909, 1566722165864, 25728, 1566722166150, 26014, 286, true
13910, 1566722165865, 25729, 1566722166143, 26007, 278, true
13911, 1566722165866, 25730, 1566722166081, 25945, 215, true
13912, 1566722165867, 25731, 1566722166081, 25945, 214, true
13913, 1566722165868, 25732, 1566722166143, 26007, 275, true
13914, 1566722165868, 25732, 1566722166120, 25984, 252, true
13915, 1566722165869, 25733, 1566722166089, 25953, 220, true
13916, 1566722165869, 25733, 1566722166143, 26007, 274, true
13917, 1566722165870, 25734, 1566722166143, 26007, 273, true
13918, 1566722165871, 25735, 1566722166143, 26007, 272, true
13919, 1566722165872, 25736, 1566722166160, 26024, 288, true
13920, 1566722165872, 25736, 1566722166165, 26029, 293, true
13921, 1566722165873, 25737, 1566722166177, 26041, 304, true
13922, 1566722165944, 25808, 1566722166185, 26049, 241, true
13923, 1566722165944, 25808, 1566722166184, 26048, 240, true
13924, 1566722165945, 25809, 1566722166184, 26048, 239, true
13925, 1566722165945, 25809, 1566722166184, 26048, 239, true
13926, 1566722165945, 25809, 1566722166184, 26048, 239, true
13927, 1566722165946, 25810, 1566722166184, 26048, 238, true
13928, 1566722165949, 25813, 1566722166185, 26049, 236, true
13929, 1566722165949, 25813, 1566722166184, 26048, 235, true
13930, 1566722165950, 25814, 1566722166185, 26049, 235, true
13931, 1566722165973, 25837, 1566722166187, 26051, 214, true
13932, 1566722165976, 25840, 1566722166191, 26055, 215, true
13933, 1566722165977, 25841, 1566722166187, 26051, 210, true
13934, 1566722165977, 25841, 1566722166192, 26056, 215, true
13935, 1566722165978, 25842, 1566722166191, 26055, 213, true
13936, 1566722165978, 25842, 1566722166191, 26055, 213, true
13937, 1566722165979, 25843, 1566722166191, 26055, 212, true
13938, 1566722165983, 25847, 1566722166191, 26055, 208, true
13939, 1566722165984, 25848, 1566722166192, 26056, 208, true
13940, 1566722165984, 25848, 1566722166191, 26055, 207, true
13941, 1566722165985, 25849, 1566722166192, 26056, 207, true
13942, 1566722165986, 25850, 1566722166193, 26057, 207, true
13943, 1566722165986, 25850, 1566722166194, 26058, 208, true
13944, 1566722165987, 25851, 1566722166194, 26058, 207, true
13945, 1566722165988, 25852, 1566722166194, 26058, 206, true
13946, 1566722165990, 25854, 1566722166197, 26061, 207, true
13947, 1566722165990, 25854, 1566722166197, 26061, 207, true
13948, 1566722165991, 25855, 1566722166202, 26066, 211, true
13949, 1566722165992, 25856, 1566722166198, 26062, 206, true
13950, 1566722165993, 25857, 1566722166202, 26066, 209, true
13951, 1566722165993, 25857, 1566722166202, 26066, 209, true
13952, 1566722165993, 25857, 1566722166198, 26062, 205, true
13953, 1566722165994, 25858, 1566722166209, 26073, 215, true
13954, 1566722165995, 25859, 1566722166209, 26073, 214, true
13955, 1566722165995, 25859, 1566722166202, 26066, 207, true
13956, 1566722165996, 25860, 1566722166204, 26068, 208, true
13957, 1566722165997, 25861, 1566722166202, 26066, 205, true
13958, 1566722165997, 25861, 1566722166209, 26073, 212, true
13959, 1566722165998, 25862, 1566722166202, 26066, 204, true
13960, 1566722165999, 25863, 1566722166209, 26073, 210, true
13961, 1566722166004, 25868, 1566722166219, 26083, 215, true
13962, 1566722166005, 25869, 1566722166214, 26078, 209, true
13963, 1566722166005, 25869, 1566722166209, 26073, 204, true
13964, 1566722166007, 25871, 1566722166218, 26082, 211, true
13965, 1566722166008, 25872, 1566722166212, 26076, 204, true
13966, 1566722166009, 25873, 1566722166221, 26085, 212, true
13967, 1566722166010, 25874, 1566722166221, 26085, 211, true
13968, 1566722166010, 25874, 1566722166219, 26083, 209, true
13969, 1566722166017, 25881, 1566722166221, 26085, 204, true
13970, 1566722166017, 25881, 1566722166221, 26085, 204, true
13971, 1566722166017, 25881, 1566722166221, 26085, 204, true
13972, 1566722166017, 25881, 1566722166222, 26086, 205, true
13973, 1566722166018, 25882, 1566722166222, 26086, 204, true
13974, 1566722166019, 25883, 1566722166222, 26086, 203, true
13975, 1566722166020, 25884, 1566722166224, 26088, 204, true
13976, 1566722166021, 25885, 1566722166225, 26089, 204, true
13977, 1566722166023, 25887, 1566722166226, 26090, 203, true
13978, 1566722166023, 25887, 1566722166228, 26092, 205, true
13979, 1566722166023, 25887, 1566722166230, 26094, 207, true
13980, 1566722166024, 25888, 1566722166231, 26095, 207, true
13981, 1566722166024, 25888, 1566722166231, 26095, 207, true
13982, 1566722166025, 25889, 1566722166229, 26093, 204, true
13983, 1566722166025, 25889, 1566722166235, 26099, 210, true
13984, 1566722166025, 25889, 1566722166239, 26103, 214, true
13985, 1566722166027, 25891, 1566722166239, 26103, 212, true
13986, 1566722166029, 25893, 1566722166238, 26102, 209, true
13987, 1566722166029, 25893, 1566722166238, 26102, 209, true
13988, 1566722166030, 25894, 1566722166249, 26113, 219, true
13989, 1566722166030, 25894, 1566722166249, 26113, 219, true
13990, 1566722166031, 25895, 1566722166251, 26115, 220, true
13991, 1566722166031, 25895, 1566722166251, 26115, 220, true
13992, 1566722166032, 25896, 1566722166251, 26115, 219, true
13993, 1566722166032, 25896, 1566722166249, 26113, 217, true
13994, 1566722166033, 25897, 1566722166251, 26115, 218, true
13995, 1566722166049, 25913, 1566722166256, 26120, 207, true
13996, 1566722166051, 25915, 1566722166256, 26120, 205, true
13997, 1566722166052, 25916, 1566722166257, 26121, 205, true
13998, 1566722166054, 25918, 1566722166257, 26121, 203, true
13999, 1566722166055, 25919, 1566722166260, 26124, 205, true
14000, 1566722166057, 25921, 1566722166261, 26125, 204, true
14001, 1566722166059, 25923, 1566722166265, 26129, 206, true
14002, 1566722166090, 25954, 1566722166292, 26156, 202, true
14003, 1566722166091, 25955, 1566722166299, 26163, 208, true
14004, 1566722166092, 25956, 1566722166299, 26163, 207, true
14005, 1566722166093, 25957, 1566722166300, 26164, 207, true
14006, 1566722166094, 25958, 1566722166299, 26163, 205, true
14007, 1566722166096, 25960, 1566722166299, 26163, 203, true
14008, 1566722166097, 25961, 1566722166302, 26166, 205, true
14009, 1566722166100, 25964, 1566722166304, 26168, 204, true
14010, 1566722166102, 25966, 1566722166311, 26175, 209, true
14011, 1566722166104, 25968, 1566722166310, 26174, 206, true
14012, 1566722166106, 25970, 1566722166314, 26178, 208, true
14013, 1566722166108, 25972, 1566722166314, 26178, 206, true
14014, 1566722166109, 25973, 1566722166314, 26178, 205, true
14015, 1566722166111, 25975, 1566722166319, 26183, 208, true
14016, 1566722166113, 25977, 1566722166316, 26180, 203, true
14017, 1566722166115, 25979, 1566722166319, 26183, 204, true
14018, 1566722166117, 25981, 1566722166323, 26187, 206, true
14019, 1566722166119, 25983, 1566722166323, 26187, 204, true
14020, 1566722166122, 25986, 1566722166328, 26192, 206, true
14021, 1566722166123, 25987, 1566722166328, 26192, 205, true
14022, 1566722166124, 25988, 1566722166329, 26193, 205, true
14023, 1566722166126, 25990, 1566722166330, 26194, 204, true
14024, 1566722166128, 25992, 1566722166332, 26196, 204, true
14025, 1566722166130, 25994, 1566722166338, 26202, 208, true
14026, 1566722166132, 25996, 1566722166342, 26206, 210, true
14027, 1566722166134, 25998, 1566722166339, 26203, 205, true
14028, 1566722166136, 26000, 1566722166343, 26207, 207, true
14029, 1566722166137, 26001, 1566722166340, 26204, 203, true
14030, 1566722166139, 26003, 1566722166348, 26212, 209, true
14031, 1566722166154, 26018, 1566722166358, 26222, 204, true
14032, 1566722166155, 26019, 1566722166363, 26227, 208, true
14033, 1566722166157, 26021, 1566722166363, 26227, 206, true
14034, 1566722166158, 26022, 1566722166363, 26227, 205, true
14035, 1566722166159, 26023, 1566722166363, 26227, 204, true
14036, 1566722166160, 26024, 1566722166363, 26227, 203, true
14037, 1566722166161, 26025, 1566722166370, 26234, 209, true
14038, 1566722166163, 26027, 1566722166368, 26232, 205, true
14039, 1566722166166, 26030, 1566722166370, 26234, 204, true
14040, 1566722166167, 26031, 1566722166372, 26236, 205, true
14041, 1566722166168, 26032, 1566722166380, 26244, 212, true
14042, 1566722166168, 26032, 1566722166380, 26244, 212, true
14043, 1566722166169, 26033, 1566722166372, 26236, 203, true
14044, 1566722166169, 26033, 1566722166380, 26244, 211, true
14045, 1566722166170, 26034, 1566722166380, 26244, 210, true
14046, 1566722166171, 26035, 1566722166380, 26244, 209, true
14047, 1566722166172, 26036, 1566722166380, 26244, 208, true
14048, 1566722166173, 26037, 1566722166380, 26244, 207, true
14049, 1566722166174, 26038, 1566722166380, 26244, 206, true
14050, 1566722166175, 26039, 1566722166381, 26245, 206, true
14051, 1566722166175, 26039, 1566722166383, 26247, 208, true
14052, 1566722166177, 26041, 1566722166381, 26245, 204, true
14053, 1566722166178, 26042, 1566722166383, 26247, 205, true
14054, 1566722166178, 26042, 1566722166383, 26247, 205, true
14055, 1566722166180, 26044, 1566722166399, 26263, 219, true
14056, 1566722166180, 26044, 1566722166390, 26254, 210, true
14057, 1566722166180, 26044, 1566722166387, 26251, 207, true
14058, 1566722166181, 26045, 1566722166409, 26273, 228, true
14059, 1566722166186, 26050, 1566722166419, 26283, 233, true
14060, 1566722166198, 26062, 1566722166408, 26272, 210, true
14061, 1566722166199, 26063, 1566722166419, 26283, 220, true
14062, 1566722166199, 26063, 1566722166419, 26283, 220, true
14063, 1566722166199, 26063, 1566722166431, 26295, 232, true
14064, 1566722166200, 26064, 1566722166419, 26283, 219, true
14065, 1566722166203, 26067, 1566722166419, 26283, 216, true
14066, 1566722166203, 26067, 1566722166430, 26294, 227, true
14067, 1566722166204, 26068, 1566722166419, 26283, 215, true
14068, 1566722166206, 26070, 1566722166427, 26291, 221, true
14069, 1566722166209, 26073, 1566722166419, 26283, 210, true
14070, 1566722166210, 26074, 1566722166439, 26303, 229, true
14071, 1566722166210, 26074, 1566722166445, 26309, 235, true
14072, 1566722166210, 26074, 1566722166440, 26304, 230, true
14073, 1566722166210, 26074, 1566722166452, 26316, 242, true
14074, 1566722166211, 26075, 1566722166441, 26305, 230, true
14075, 1566722166211, 26075, 1566722166440, 26304, 229, true
14076, 1566722166211, 26075, 1566722166442, 26306, 231, true
14077, 1566722166213, 26077, 1566722166446, 26310, 233, true
14078, 1566722166214, 26078, 1566722166445, 26309, 231, true
14079, 1566722166214, 26078, 1566722166449, 26313, 235, true
14080, 1566722166215, 26079, 1566722166441, 26305, 226, true
14081, 1566722166216, 26080, 1566722166446, 26310, 230, true
14082, 1566722166223, 26087, 1566722166447, 26311, 224, true
14083, 1566722166226, 26090, 1566722166436, 26300, 210, true
14084, 1566722166227, 26091, 1566722166438, 26302, 211, true
14085, 1566722166228, 26092, 1566722166448, 26312, 220, true
14086, 1566722166231, 26095, 1566722166457, 26321, 226, true
14087, 1566722166232, 26096, 1566722166470, 26334, 238, true
14088, 1566722166232, 26096, 1566722166464, 26328, 232, true
14089, 1566722166232, 26096, 1566722166466, 26330, 234, true
14090, 1566722166233, 26097, 1566722166464, 26328, 231, true
14091, 1566722166234, 26098, 1566722166466, 26330, 232, true
14092, 1566722166235, 26099, 1566722166471, 26335, 236, true
14093, 1566722166236, 26100, 1566722166467, 26331, 231, true
14094, 1566722166240, 26104, 1566722166474, 26338, 234, true
14095, 1566722166240, 26104, 1566722166469, 26333, 229, true
14096, 1566722166242, 26106, 1566722166469, 26333, 227, true
14097, 1566722166242, 26106, 1566722166468, 26332, 226, true
14098, 1566722166243, 26107, 1566722166472, 26336, 229, true
14099, 1566722166243, 26107, 1566722166460, 26324, 217, true
14100, 1566722166243, 26107, 1566722166466, 26330, 223, true
14101, 1566722166245, 26109, 1566722166455, 26319, 210, true
14102, 1566722166246, 26110, 1566722166458, 26322, 212, true
14103, 1566722166247, 26111, 1566722166462, 26326, 215, true
14104, 1566722166247, 26111, 1566722166468, 26332, 221, true
14105, 1566722166251, 26115, 1566722166488, 26352, 237, true
14106, 1566722166252, 26116, 1566722166471, 26335, 219, true
14107, 1566722166252, 26116, 1566722166478, 26342, 226, true
14108, 1566722166254, 26118, 1566722166488, 26352, 234, true
14109, 1566722166257, 26121, 1566722166471, 26335, 214, true
14110, 1566722166257, 26121, 1566722166473, 26337, 216, true
14111, 1566722166258, 26122, 1566722166472, 26336, 214, true
14112, 1566722166258, 26122, 1566722166478, 26342, 220, true
14113, 1566722166258, 26122, 1566722166473, 26337, 215, true
14114, 1566722166259, 26123, 1566722166470, 26334, 211, true
14115, 1566722166262, 26126, 1566722166478, 26342, 216, true
14116, 1566722166263, 26127, 1566722166483, 26347, 220, true
14117, 1566722166267, 26131, 1566722166488, 26352, 221, true
14118, 1566722166268, 26132, 1566722166484, 26348, 216, true
14119, 1566722166270, 26134, 1566722166488, 26352, 218, true
14120, 1566722166271, 26135, 1566722166482, 26346, 211, true
14121, 1566722166273, 26137, 1566722166482, 26346, 209, true
14122, 1566722166274, 26138, 1566722166488, 26352, 214, true
14123, 1566722166275, 26139, 1566722166483, 26347, 208, true
14124, 1566722166276, 26140, 1566722166484, 26348, 208, true
14125, 1566722166277, 26141, 1566722166484, 26348, 207, true
14126, 1566722166279, 26143, 1566722166491, 26355, 212, true
14127, 1566722166279, 26143, 1566722166484, 26348, 205, true
14128, 1566722166280, 26144, 1566722166489, 26353, 209, true
14129, 1566722166280, 26144, 1566722166492, 26356, 212, true
14130, 1566722166281, 26145, 1566722166491, 26355, 210, true
14131, 1566722166282, 26146, 1566722166491, 26355, 209, true
14132, 1566722166283, 26147, 1566722166496, 26360, 213, true
14133, 1566722166284, 26148, 1566722166496, 26360, 212, true
14134, 1566722166285, 26149, 1566722166498, 26362, 213, true
14135, 1566722166286, 26150, 1566722166491, 26355, 205, true
14136, 1566722166287, 26151, 1566722166501, 26365, 214, true
14137, 1566722166287, 26151, 1566722166502, 26366, 215, true
14138, 1566722166287, 26151, 1566722166498, 26362, 211, true
14139, 1566722166288, 26152, 1566722166502, 26366, 214, true
14140, 1566722166288, 26152, 1566722166504, 26368, 216, true
14141, 1566722166289, 26153, 1566722166502, 26366, 213, true
14142, 1566722166289, 26153, 1566722166497, 26361, 208, true
14143, 1566722166289, 26153, 1566722166501, 26365, 212, true
14144, 1566722166290, 26154, 1566722166503, 26367, 213, true
14145, 1566722166290, 26154, 1566722166499, 26363, 209, true
14146, 1566722166291, 26155, 1566722166499, 26363, 208, true
14147, 1566722166292, 26156, 1566722166502, 26366, 210, true
14148, 1566722166293, 26157, 1566722166499, 26363, 206, true
14149, 1566722166293, 26157, 1566722166508, 26372, 215, true
14150, 1566722166296, 26160, 1566722166508, 26372, 212, true
14151, 1566722166300, 26164, 1566722166509, 26373, 209, true
14152, 1566722166301, 26165, 1566722166504, 26368, 203, true
14153, 1566722166301, 26165, 1566722166508, 26372, 207, true
14154, 1566722166301, 26165, 1566722166508, 26372, 207, true
14155, 1566722166302, 26166, 1566722166510, 26374, 208, true
14156, 1566722166304, 26168, 1566722166509, 26373, 205, true
14157, 1566722166305, 26169, 1566722166526, 26390, 221, true
14158, 1566722166305, 26169, 1566722166511, 26375, 206, true
14159, 1566722166306, 26170, 1566722166526, 26390, 220, true
14160, 1566722166307, 26171, 1566722166521, 26385, 214, true
14161, 1566722166307, 26171, 1566722166529, 26393, 222, true
14162, 1566722166308, 26172, 1566722166526, 26390, 218, true
14163, 1566722166308, 26172, 1566722166526, 26390, 218, true
14164, 1566722166308, 26172, 1566722166522, 26386, 214, true
14165, 1566722166309, 26173, 1566722166526, 26390, 217, true
14166, 1566722166309, 26173, 1566722166521, 26385, 212, true
14167, 1566722166309, 26173, 1566722166521, 26385, 212, true
14168, 1566722166310, 26174, 1566722166521, 26385, 211, true
14169, 1566722166311, 26175, 1566722166519, 26383, 208, true
14170, 1566722166311, 26175, 1566722166526, 26390, 215, true
14171, 1566722166312, 26176, 1566722166526, 26390, 214, true
14172, 1566722166312, 26176, 1566722166521, 26385, 209, true
14173, 1566722166315, 26179, 1566722166529, 26393, 214, true
14174, 1566722166319, 26183, 1566722166526, 26390, 207, true
14175, 1566722166320, 26184, 1566722166528, 26392, 208, true
14176, 1566722166320, 26184, 1566722166532, 26396, 212, true
14177, 1566722166320, 26184, 1566722166528, 26392, 208, true
14178, 1566722166324, 26188, 1566722166539, 26403, 215, true
14179, 1566722166324, 26188, 1566722166533, 26397, 209, true
14180, 1566722166325, 26189, 1566722166540, 26404, 215, true
14181, 1566722166325, 26189, 1566722166532, 26396, 207, true
14182, 1566722166327, 26191, 1566722166533, 26397, 206, true
14183, 1566722166332, 26196, 1566722166539, 26403, 207, true
14184, 1566722166332, 26196, 1566722166539, 26403, 207, true
14185, 1566722166332, 26196, 1566722166540, 26404, 208, true
14186, 1566722166334, 26198, 1566722166539, 26403, 205, true
14187, 1566722166334, 26198, 1566722166536, 26400, 202, true
14188, 1566722166335, 26199, 1566722166544, 26408, 209, true
14189, 1566722166335, 26199, 1566722166540, 26404, 205, true
14190, 1566722166335, 26199, 1566722166542, 26406, 207, true
14191, 1566722166336, 26200, 1566722166543, 26407, 207, true
14192, 1566722166336, 26200, 1566722166543, 26407, 207, true
14193, 1566722166341, 26205, 1566722166548, 26412, 207, true
14194, 1566722166344, 26208, 1566722166548, 26412, 204, true
14195, 1566722166344, 26208, 1566722166548, 26412, 204, true
14196, 1566722166346, 26210, 1566722166550, 26414, 204, true
14197, 1566722166348, 26212, 1566722166555, 26419, 207, true
14198, 1566722166349, 26213, 1566722166555, 26419, 206, true
14199, 1566722166349, 26213, 1566722166556, 26420, 207, true
14200, 1566722166350, 26214, 1566722166553, 26417, 203, true
14201, 1566722166351, 26215, 1566722166560, 26424, 209, true
14202, 1566722166352, 26216, 1566722166560, 26424, 208, true
14203, 1566722166352, 26216, 1566722166560, 26424, 208, true
14204, 1566722166355, 26219, 1566722166560, 26424, 205, true
14205, 1566722166356, 26220, 1566722166563, 26427, 207, true
14206, 1566722166357, 26221, 1566722166567, 26431, 210, true
14207, 1566722166358, 26222, 1566722166563, 26427, 205, true
14208, 1566722166359, 26223, 1566722166563, 26427, 204, true
14209, 1566722166359, 26223, 1566722166563, 26427, 204, true
14210, 1566722166363, 26227, 1566722166571, 26435, 208, true
14211, 1566722166364, 26228, 1566722166571, 26435, 207, true
14212, 1566722166364, 26228, 1566722166569, 26433, 205, true
14213, 1566722166366, 26230, 1566722166579, 26443, 213, true
14214, 1566722166383, 26247, 1566722166588, 26452, 205, true
14215, 1566722166384, 26248, 1566722166590, 26454, 206, true
14216, 1566722166387, 26251, 1566722166590, 26454, 203, true
14217, 1566722166388, 26252, 1566722166593, 26457, 205, true
14218, 1566722166389, 26253, 1566722166595, 26459, 206, true
14219, 1566722166390, 26254, 1566722166595, 26459, 205, true
14220, 1566722166390, 26254, 1566722166598, 26462, 208, true
14221, 1566722166391, 26255, 1566722166595, 26459, 204, true
14222, 1566722166391, 26255, 1566722166598, 26462, 207, true
14223, 1566722166392, 26256, 1566722166598, 26462, 206, true
14224, 1566722166393, 26257, 1566722166598, 26462, 205, true
14225, 1566722166394, 26258, 1566722166598, 26462, 204, true
14226, 1566722166396, 26260, 1566722166609, 26473, 213, true
14227, 1566722166396, 26260, 1566722166609, 26473, 213, true
14228, 1566722166398, 26262, 1566722166604, 26468, 206, true
14229, 1566722166400, 26264, 1566722166605, 26469, 205, true
14230, 1566722166400, 26264, 1566722166605, 26469, 205, true
14231, 1566722166401, 26265, 1566722166611, 26475, 210, true
14232, 1566722166404, 26268, 1566722166619, 26483, 215, true
14233, 1566722166404, 26268, 1566722166609, 26473, 205, true
14234, 1566722166405, 26269, 1566722166619, 26483, 214, true
14235, 1566722166406, 26270, 1566722166619, 26483, 213, true
14236, 1566722166407, 26271, 1566722166619, 26483, 212, true
14237, 1566722166410, 26274, 1566722166619, 26483, 209, true
14238, 1566722166410, 26274, 1566722166619, 26483, 209, true
14239, 1566722166411, 26275, 1566722166619, 26483, 208, true
14240, 1566722166412, 26276, 1566722166619, 26483, 207, true
14241, 1566722166413, 26277, 1566722166619, 26483, 206, true
14242, 1566722166413, 26277, 1566722166620, 26484, 207, true
14243, 1566722166414, 26278, 1566722166626, 26490, 212, true
14244, 1566722166414, 26278, 1566722166625, 26489, 211, true
14245, 1566722166415, 26279, 1566722166626, 26490, 211, true
14246, 1566722166415, 26279, 1566722166629, 26493, 214, true
14247, 1566722166415, 26279, 1566722166626, 26490, 211, true
14248, 1566722166424, 26288, 1566722166628, 26492, 204, true
14249, 1566722166424, 26288, 1566722166635, 26499, 211, true
14250, 1566722166425, 26289, 1566722166636, 26500, 211, true
14251, 1566722166425, 26289, 1566722166635, 26499, 210, true
14252, 1566722166426, 26290, 1566722166636, 26500, 210, true
14253, 1566722166428, 26292, 1566722166640, 26504, 212, true
14254, 1566722166428, 26292, 1566722166640, 26504, 212, true
14255, 1566722166428, 26292, 1566722166641, 26505, 213, true
14256, 1566722166429, 26293, 1566722166641, 26505, 212, true
14257, 1566722166432, 26296, 1566722166641, 26505, 209, true
14258, 1566722166433, 26297, 1566722166641, 26505, 208, true
14259, 1566722166433, 26297, 1566722166642, 26506, 209, true
14260, 1566722166434, 26298, 1566722166642, 26506, 208, true
14261, 1566722166436, 26300, 1566722166642, 26506, 206, true
14262, 1566722166441, 26305, 1566722166646, 26510, 205, true
14263, 1566722166443, 26307, 1566722166650, 26514, 207, true
14264, 1566722166450, 26314, 1566722166659, 26523, 209, true
14265, 1566722166450, 26314, 1566722166658, 26522, 208, true
14266, 1566722166451, 26315, 1566722166660, 26524, 209, true
14267, 1566722166452, 26316, 1566722166664, 26528, 212, true
14268, 1566722166453, 26317, 1566722166665, 26529, 212, true
14269, 1566722166453, 26317, 1566722166663, 26527, 210, true
14270, 1566722166455, 26319, 1566722166665, 26529, 210, true
14271, 1566722166458, 26322, 1566722166665, 26529, 207, true
14272, 1566722166460, 26324, 1566722166668, 26532, 208, true
14273, 1566722166464, 26328, 1566722166676, 26540, 212, true
14274, 1566722166465, 26329, 1566722166676, 26540, 211, true
14275, 1566722166465, 26329, 1566722166671, 26535, 206, true
14276, 1566722166475, 26339, 1566722166688, 26552, 213, true
14277, 1566722166476, 26340, 1566722166687, 26551, 211, true
14278, 1566722166476, 26340, 1566722166685, 26549, 209, true
14279, 1566722166478, 26342, 1566722166688, 26552, 210, true
14280, 1566722166479, 26343, 1566722166695, 26559, 216, true
14281, 1566722166479, 26343, 1566722166695, 26559, 216, true
14282, 1566722166480, 26344, 1566722166695, 26559, 215, true
14283, 1566722166494, 26358, 1566722166708, 26572, 214, true
14284, 1566722166512, 26376, 1566722166718, 26582, 206, true
14285, 1566722166513, 26377, 1566722166719, 26583, 206, true
14286, 1566722166515, 26379, 1566722166723, 26587, 208, true
14287, 1566722166515, 26379, 1566722166723, 26587, 208, true
14288, 1566722166515, 26379, 1566722166723, 26587, 208, true
14289, 1566722166516, 26380, 1566722166727, 26591, 211, true
14290, 1566722166516, 26380, 1566722166727, 26591, 211, true
14291, 1566722166517, 26381, 1566722166725, 26589, 208, true
14292, 1566722166522, 26386, 1566722166744, 26608, 222, true
14293, 1566722166530, 26394, 1566722166743, 26607, 213, true
14294, 1566722166534, 26398, 1566722166745, 26609, 211, true
14295, 1566722166541, 26405, 1566722166748, 26612, 207, true
14296, 1566722166546, 26410, 1566722166756, 26620, 210, true
14297, 1566722166546, 26410, 1566722166752, 26616, 206, true
14298, 1566722166546, 26410, 1566722166755, 26619, 209, true
14299, 1566722166549, 26413, 1566722166757, 26621, 208, true
14300, 1566722166551, 26415, 1566722166762, 26626, 211, true
14301, 1566722166551, 26415, 1566722166761, 26625, 210, true
14302, 1566722166552, 26416, 1566722166757, 26621, 205, true
14303, 1566722166552, 26416, 1566722166762, 26626, 210, true
14304, 1566722166556, 26420, 1566722166760, 26624, 204, true
14305, 1566722166557, 26421, 1566722166765, 26629, 208, true
14306, 1566722166557, 26421, 1566722166765, 26629, 208, true
14307, 1566722166558, 26422, 1566722166763, 26627, 205, true
14308, 1566722166560, 26424, 1566722166771, 26635, 211, true
14309, 1566722166560, 26424, 1566722166770, 26634, 210, true
14310, 1566722166560, 26424, 1566722166770, 26634, 210, true
14311, 1566722166565, 26429, 1566722166774, 26638, 209, true
14312, 1566722166565, 26429, 1566722166774, 26638, 209, true
14313, 1566722166566, 26430, 1566722166771, 26635, 205, true
14314, 1566722166566, 26430, 1566722166773, 26637, 207, true
14315, 1566722166569, 26433, 1566722166777, 26641, 208, true
14316, 1566722166572, 26436, 1566722166779, 26643, 207, true
14317, 1566722166572, 26436, 1566722166780, 26644, 208, true
14318, 1566722166572, 26436, 1566722166782, 26646, 210, true
14319, 1566722166573, 26437, 1566722166781, 26645, 208, true
14320, 1566722166573, 26437, 1566722166780, 26644, 207, true
14321, 1566722166576, 26440, 1566722166782, 26646, 206, true
14322, 1566722166578, 26442, 1566722166783, 26647, 205, true
14323, 1566722166580, 26444, 1566722166791, 26655, 211, true
14324, 1566722166580, 26444, 1566722166784, 26648, 204, true
14325, 1566722166582, 26446, 1566722166786, 26650, 204, true
14326, 1566722166585, 26449, 1566722166789, 26653, 204, true
14327, 1566722166587, 26451, 1566722166792, 26656, 205, true
14328, 1566722166589, 26453, 1566722166800, 26664, 211, true
14329, 1566722166591, 26455, 1566722166800, 26664, 209, true
14330, 1566722166591, 26455, 1566722166801, 26665, 210, true
14331, 1566722166591, 26455, 1566722166802, 26666, 211, true
14332, 1566722166591, 26455, 1566722166800, 26664, 209, true
14333, 1566722166591, 26455, 1566722166800, 26664, 209, true
14334, 1566722166595, 26459, 1566722166836, 26700, 241, true
14335, 1566722166599, 26463, 1566722166836, 26700, 237, true
14336, 1566722166599, 26463, 1566722166836, 26700, 237, true
14337, 1566722166600, 26464, 1566722166836, 26700, 236, true
14338, 1566722166600, 26464, 1566722166829, 26693, 229, true
14339, 1566722166600, 26464, 1566722166836, 26700, 236, true
14340, 1566722166600, 26464, 1566722166838, 26702, 238, true
14341, 1566722166600, 26464, 1566722166836, 26700, 236, true
14342, 1566722166601, 26465, 1566722166836, 26700, 235, true
14343, 1566722166601, 26465, 1566722166835, 26699, 234, true
14344, 1566722166601, 26465, 1566722166836, 26700, 235, true
14345, 1566722166601, 26465, 1566722166838, 26702, 237, true
14346, 1566722166601, 26465, 1566722166836, 26700, 235, true
14347, 1566722166601, 26465, 1566722166836, 26700, 235, true
14348, 1566722166602, 26466, 1566722166835, 26699, 233, true
14349, 1566722166602, 26466, 1566722166835, 26699, 233, true
14350, 1566722166602, 26466, 1566722166836, 26700, 234, true
14351, 1566722166602, 26466, 1566722166835, 26699, 233, true
14352, 1566722166604, 26468, 1566722166836, 26700, 232, true
14353, 1566722166604, 26468, 1566722166836, 26700, 232, true
14354, 1566722166604, 26468, 1566722166828, 26692, 224, true
14355, 1566722166604, 26468, 1566722166810, 26674, 206, true
14356, 1566722166606, 26470, 1566722166817, 26681, 211, true
14357, 1566722166606, 26470, 1566722166817, 26681, 211, true
14358, 1566722166607, 26471, 1566722166825, 26689, 218, true
14359, 1566722166607, 26471, 1566722166814, 26678, 207, true
14360, 1566722166609, 26473, 1566722166826, 26690, 217, true
14361, 1566722166610, 26474, 1566722166835, 26699, 225, true
14362, 1566722166644, 26508, 1566722166850, 26714, 206, true
14363, 1566722166646, 26510, 1566722166851, 26715, 205, true
14364, 1566722166646, 26510, 1566722166858, 26722, 212, true
14365, 1566722166646, 26510, 1566722166851, 26715, 205, true
14366, 1566722166646, 26510, 1566722166851, 26715, 205, true
14367, 1566722166647, 26511, 1566722166851, 26715, 204, true
14368, 1566722166647, 26511, 1566722166857, 26721, 210, true
14369, 1566722166654, 26518, 1566722166859, 26723, 205, true
14370, 1566722166654, 26518, 1566722166869, 26733, 215, true
14371, 1566722166654, 26518, 1566722166869, 26733, 215, true
14372, 1566722166655, 26519, 1566722166869, 26733, 214, true
14373, 1566722166655, 26519, 1566722166866, 26730, 211, true
14374, 1566722166655, 26519, 1566722166869, 26733, 214, true
14375, 1566722166656, 26520, 1566722166869, 26733, 213, true
14376, 1566722166657, 26521, 1566722166870, 26734, 213, true
14377, 1566722166661, 26525, 1566722166869, 26733, 208, true
14378, 1566722166669, 26533, 1566722166875, 26739, 206, true
14379, 1566722166671, 26535, 1566722166884, 26748, 213, true
14380, 1566722166671, 26535, 1566722166886, 26750, 215, true
14381, 1566722166672, 26536, 1566722166877, 26741, 205, true
14382, 1566722166672, 26536, 1566722166886, 26750, 214, true
14383, 1566722166673, 26537, 1566722166877, 26741, 204, true
14384, 1566722166673, 26537, 1566722166886, 26750, 213, true
14385, 1566722166674, 26538, 1566722166885, 26749, 211, true
14386, 1566722166677, 26541, 1566722166889, 26753, 212, true
14387, 1566722166678, 26542, 1566722166888, 26752, 210, true
14388, 1566722166678, 26542, 1566722166886, 26750, 208, true
14389, 1566722166679, 26543, 1566722166889, 26753, 210, true
14390, 1566722166680, 26544, 1566722166897, 26761, 217, true
14391, 1566722166680, 26544, 1566722166891, 26755, 211, true
14392, 1566722166680, 26544, 1566722166890, 26754, 210, true
14393, 1566722166681, 26545, 1566722166897, 26761, 216, true
14394, 1566722166681, 26545, 1566722166893, 26757, 212, true
14395, 1566722166681, 26545, 1566722166895, 26759, 214, true
14396, 1566722166682, 26546, 1566722166899, 26763, 217, true
14397, 1566722166683, 26547, 1566722166899, 26763, 216, true
14398, 1566722166684, 26548, 1566722166897, 26761, 213, true
14399, 1566722166689, 26553, 1566722166899, 26763, 210, true
14400, 1566722166690, 26554, 1566722166899, 26763, 209, true
14401, 1566722166691, 26555, 1566722166899, 26763, 208, true
14402, 1566722166691, 26555, 1566722166895, 26759, 204, true
14403, 1566722166692, 26556, 1566722166899, 26763, 207, true
14404, 1566722166693, 26557, 1566722166903, 26767, 210, true
14405, 1566722166697, 26561, 1566722166903, 26767, 206, true
14406, 1566722166698, 26562, 1566722166912, 26776, 214, true
14407, 1566722166698, 26562, 1566722166916, 26780, 218, true
14408, 1566722166698, 26562, 1566722166905, 26769, 207, true
14409, 1566722166698, 26562, 1566722166912, 26776, 214, true
14410, 1566722166699, 26563, 1566722166903, 26767, 204, true
14411, 1566722166699, 26563, 1566722166916, 26780, 217, true
14412, 1566722166700, 26564, 1566722167004, 26868, 304, true
14413, 1566722166701, 26565, 1566722167004, 26868, 303, true
14414, 1566722166702, 26566, 1566722167003, 26867, 301, true
14415, 1566722166703, 26567, 1566722167004, 26868, 301, true
14416, 1566722166704, 26568, 1566722166916, 26780, 212, true
14417, 1566722166704, 26568, 1566722167053, 26917, 349, true
14418, 1566722166705, 26569, 1566722167039, 26903, 334, true
14419, 1566722166705, 26569, 1566722167039, 26903, 334, true
14420, 1566722166706, 26570, 1566722167030, 26894, 324, true
14421, 1566722166707, 26571, 1566722167038, 26902, 331, true
14422, 1566722166708, 26572, 1566722167041, 26905, 333, true
14423, 1566722166708, 26572, 1566722167041, 26905, 333, true
14424, 1566722166708, 26572, 1566722167029, 26893, 321, true
14425, 1566722166709, 26573, 1566722167055, 26919, 346, true
14426, 1566722166709, 26573, 1566722167039, 26903, 330, true
14427, 1566722166709, 26573, 1566722167052, 26916, 343, true
14428, 1566722166710, 26574, 1566722167028, 26892, 318, true
14429, 1566722166710, 26574, 1566722167045, 26909, 335, true
14430, 1566722166710, 26574, 1566722167045, 26909, 335, true
14431, 1566722166710, 26574, 1566722167062, 26926, 352, true
14432, 1566722166711, 26575, 1566722167053, 26917, 342, true
14433, 1566722166711, 26575, 1566722167043, 26907, 332, true
14434, 1566722166711, 26575, 1566722167040, 26904, 329, true
14435, 1566722166711, 26575, 1566722167054, 26918, 343, true
14436, 1566722166712, 26576, 1566722167040, 26904, 328, true
14437, 1566722166712, 26576, 1566722167040, 26904, 328, true
14438, 1566722166712, 26576, 1566722167043, 26907, 331, true
14439, 1566722166712, 26576, 1566722167040, 26904, 328, true
14440, 1566722166713, 26577, 1566722167041, 26905, 328, true
14441, 1566722166713, 26577, 1566722167062, 26926, 349, true
14442, 1566722166714, 26578, 1566722167054, 26918, 340, true
14443, 1566722166714, 26578, 1566722167043, 26907, 329, true
14444, 1566722166714, 26578, 1566722167028, 26892, 314, true
14445, 1566722166714, 26578, 1566722167029, 26893, 315, true
14446, 1566722166715, 26579, 1566722167042, 26906, 327, true
14447, 1566722166715, 26579, 1566722167053, 26917, 338, true
14448, 1566722166715, 26579, 1566722167030, 26894, 315, true
14449, 1566722166716, 26580, 1566722167043, 26907, 327, true
14450, 1566722166716, 26580, 1566722167041, 26905, 325, true
14451, 1566722166716, 26580, 1566722167030, 26894, 314, true
14452, 1566722166716, 26580, 1566722167040, 26904, 324, true
14453, 1566722166716, 26580, 1566722167055, 26919, 339, true
14454, 1566722166716, 26580, 1566722167041, 26905, 325, true
14455, 1566722166716, 26580, 1566722167053, 26917, 337, true
14456, 1566722166717, 26581, 1566722167045, 26909, 328, true
14457, 1566722166717, 26581, 1566722167009, 26873, 292, true
14458, 1566722166717, 26581, 1566722167012, 26876, 295, true
14459, 1566722166718, 26582, 1566722167040, 26904, 322, true
14460, 1566722166719, 26583, 1566722167055, 26919, 336, true
14461, 1566722166719, 26583, 1566722167041, 26905, 322, true
14462, 1566722166719, 26583, 1566722167041, 26905, 322, true
14463, 1566722166720, 26584, 1566722167014, 26878, 294, true
14464, 1566722166721, 26585, 1566722167028, 26892, 307, true
14465, 1566722166722, 26586, 1566722167039, 26903, 317, true
14466, 1566722166724, 26588, 1566722167040, 26904, 316, true
14467, 1566722166724, 26588, 1566722167029, 26893, 305, true
14468, 1566722166725, 26589, 1566722167047, 26911, 322, true
14469, 1566722166726, 26590, 1566722167041, 26905, 315, true
14470, 1566722166727, 26591, 1566722167046, 26910, 319, true
14471, 1566722166728, 26592, 1566722167029, 26893, 301, true
14472, 1566722166728, 26592, 1566722167043, 26907, 315, true
14473, 1566722166729, 26593, 1566722167042, 26906, 313, true
14474, 1566722166729, 26593, 1566722167040, 26904, 311, true
14475, 1566722166730, 26594, 1566722167054, 26918, 324, true
14476, 1566722166731, 26595, 1566722167054, 26918, 323, true
14477, 1566722166731, 26595, 1566722167045, 26909, 314, true
14478, 1566722166732, 26596, 1566722167061, 26925, 329, true
14479, 1566722166732, 26596, 1566722167053, 26917, 321, true
14480, 1566722166733, 26597, 1566722167054, 26918, 321, true
14481, 1566722166733, 26597, 1566722167043, 26907, 310, true
14482, 1566722166733, 26597, 1566722167031, 26895, 298, true
14483, 1566722166733, 26597, 1566722167009, 26873, 276, true
14484, 1566722166734, 26598, 1566722167029, 26893, 295, true
14485, 1566722166734, 26598, 1566722167039, 26903, 305, true
14486, 1566722166734, 26598, 1566722167043, 26907, 309, true
14487, 1566722166734, 26598, 1566722167038, 26902, 304, true
14488, 1566722166735, 26599, 1566722167011, 26875, 276, true
14489, 1566722166736, 26600, 1566722167040, 26904, 304, true
14490, 1566722166736, 26600, 1566722167053, 26917, 317, true
14491, 1566722166736, 26600, 1566722167041, 26905, 305, true
14492, 1566722166736, 26600, 1566722167062, 26926, 326, true
14493, 1566722166737, 26601, 1566722167062, 26926, 325, true
14494, 1566722166737, 26601, 1566722167054, 26918, 317, true
14495, 1566722166737, 26601, 1566722167029, 26893, 292, true
14496, 1566722166738, 26602, 1566722167042, 26906, 304, true
14497, 1566722166738, 26602, 1566722167042, 26906, 304, true
14498, 1566722166738, 26602, 1566722167046, 26910, 308, true
14499, 1566722166738, 26602, 1566722167038, 26902, 300, true
14500, 1566722166739, 26603, 1566722167029, 26893, 290, true
14501, 1566722166739, 26603, 1566722167055, 26919, 316, true
14502, 1566722166739, 26603, 1566722167054, 26918, 315, true
14503, 1566722166739, 26603, 1566722167042, 26906, 303, true
14504, 1566722166740, 26604, 1566722167089, 26953, 349, true
14505, 1566722166740, 26604, 1566722167040, 26904, 300, true
14506, 1566722166740, 26604, 1566722167043, 26907, 303, true
14507, 1566722166741, 26605, 1566722167054, 26918, 313, true
14508, 1566722166741, 26605, 1566722167028, 26892, 287, true
14509, 1566722166741, 26605, 1566722167014, 26878, 273, true
14510, 1566722166741, 26605, 1566722167081, 26945, 340, true
14511, 1566722166742, 26606, 1566722167069, 26933, 327, true
14512, 1566722166742, 26606, 1566722167066, 26930, 324, true
14513, 1566722166743, 26607, 1566722167029, 26893, 286, true
14514, 1566722166744, 26608, 1566722167030, 26894, 286, true
14515, 1566722166745, 26609, 1566722167063, 26927, 318, true
14516, 1566722166745, 26609, 1566722167054, 26918, 309, true
14517, 1566722166745, 26609, 1566722167078, 26942, 333, true
14518, 1566722166746, 26610, 1566722167066, 26930, 320, true
14519, 1566722166746, 26610, 1566722167062, 26926, 316, true
14520, 1566722166746, 26610, 1566722167070, 26934, 324, true
14521, 1566722166747, 26611, 1566722167063, 26927, 316, true
14522, 1566722166747, 26611, 1566722167063, 26927, 316, true
14523, 1566722166748, 26612, 1566722167040, 26904, 292, true
14524, 1566722166748, 26612, 1566722167067, 26931, 319, true
14525, 1566722166749, 26613, 1566722167067, 26931, 318, true
14526, 1566722166749, 26613, 1566722167063, 26927, 314, true
14527, 1566722166750, 26614, 1566722167063, 26927, 313, true
14528, 1566722166750, 26614, 1566722167064, 26928, 314, true
14529, 1566722166751, 26615, 1566722167072, 26936, 321, true
14530, 1566722166752, 26616, 1566722167042, 26906, 290, true
14531, 1566722166752, 26616, 1566722167078, 26942, 326, true
14532, 1566722166753, 26617, 1566722167078, 26942, 325, true
14533, 1566722166753, 26617, 1566722167081, 26945, 328, true
14534, 1566722166753, 26617, 1566722167070, 26934, 317, true
14535, 1566722166754, 26618, 1566722167063, 26927, 309, true
14536, 1566722166754, 26618, 1566722167076, 26940, 322, true
14537, 1566722166756, 26620, 1566722167040, 26904, 284, true
14538, 1566722166757, 26621, 1566722167042, 26906, 285, true
14539, 1566722166757, 26621, 1566722167028, 26892, 271, true
14540, 1566722166757, 26621, 1566722167062, 26926, 305, true
14541, 1566722166758, 26622, 1566722167069, 26933, 311, true
14542, 1566722166758, 26622, 1566722167063, 26927, 305, true
14543, 1566722166758, 26622, 1566722167071, 26935, 313, true
14544, 1566722166758, 26622, 1566722167070, 26934, 312, true
14545, 1566722166759, 26623, 1566722167070, 26934, 311, true
14546, 1566722166759, 26623, 1566722167063, 26927, 304, true
14547, 1566722166760, 26624, 1566722167066, 26930, 306, true
14548, 1566722166761, 26625, 1566722167040, 26904, 279, true
14549, 1566722166761, 26625, 1566722167053, 26917, 292, true
14550, 1566722166762, 26626, 1566722167029, 26893, 267, true
14551, 1566722166762, 26626, 1566722167040, 26904, 278, true
14552, 1566722166763, 26627, 1566722167076, 26940, 313, true
14553, 1566722166764, 26628, 1566722167039, 26903, 275, true
14554, 1566722166764, 26628, 1566722167070, 26934, 306, true
14555, 1566722166765, 26629, 1566722167055, 26919, 290, true
14556, 1566722166766, 26630, 1566722167038, 26902, 272, true
14557, 1566722166766, 26630, 1566722167075, 26939, 309, true
14558, 1566722166767, 26631, 1566722167075, 26939, 308, true
14559, 1566722166768, 26632, 1566722167081, 26945, 313, true
14560, 1566722166768, 26632, 1566722167070, 26934, 302, true
14561, 1566722166768, 26632, 1566722167070, 26934, 302, true
14562, 1566722166769, 26633, 1566722167063, 26927, 294, true
14563, 1566722166770, 26634, 1566722167030, 26894, 260, true
14564, 1566722166771, 26635, 1566722167041, 26905, 270, true
14565, 1566722166771, 26635, 1566722167039, 26903, 268, true
14566, 1566722166772, 26636, 1566722167042, 26906, 270, true
14567, 1566722166772, 26636, 1566722167071, 26935, 299, true
14568, 1566722166773, 26637, 1566722167031, 26895, 258, true
14569, 1566722166774, 26638, 1566722167062, 26926, 288, true
14570, 1566722166774, 26638, 1566722167039, 26903, 265, true
14571, 1566722166775, 26639, 1566722167071, 26935, 296, true
14572, 1566722166775, 26639, 1566722167063, 26927, 288, true
14573, 1566722166776, 26640, 1566722167066, 26930, 290, true
14574, 1566722166776, 26640, 1566722167063, 26927, 287, true
14575, 1566722166777, 26641, 1566722167081, 26945, 304, true
14576, 1566722166778, 26642, 1566722167055, 26919, 277, true
14577, 1566722166778, 26642, 1566722167063, 26927, 285, true
14578, 1566722166779, 26643, 1566722167055, 26919, 276, true
14579, 1566722166780, 26644, 1566722167055, 26919, 275, true
14580, 1566722166780, 26644, 1566722167010, 26874, 230, true
14581, 1566722166781, 26645, 1566722167077, 26941, 296, true
14582, 1566722166782, 26646, 1566722167042, 26906, 260, true
14583, 1566722166783, 26647, 1566722167053, 26917, 270, true
14584, 1566722166783, 26647, 1566722167009, 26873, 226, true
14585, 1566722166785, 26649, 1566722167010, 26874, 225, true
14586, 1566722166785, 26649, 1566722167053, 26917, 268, true
14587, 1566722166785, 26649, 1566722167070, 26934, 285, true
14588, 1566722166786, 26650, 1566722167040, 26904, 254, true
14589, 1566722166787, 26651, 1566722167070, 26934, 283, true
14590, 1566722166787, 26651, 1566722167066, 26930, 279, true
14591, 1566722166788, 26652, 1566722167078, 26942, 290, true
14592, 1566722166788, 26652, 1566722167063, 26927, 275, true
14593, 1566722166789, 26653, 1566722167055, 26919, 266, true
14594, 1566722166790, 26654, 1566722167078, 26942, 288, true
14595, 1566722166791, 26655, 1566722167055, 26919, 264, true
14596, 1566722166791, 26655, 1566722167062, 26926, 271, true
14597, 1566722166792, 26656, 1566722167039, 26903, 247, true
14598, 1566722166793, 26657, 1566722167064, 26928, 271, true
14599, 1566722166793, 26657, 1566722167174, 27038, 381, true
14600, 1566722166881, 26745, 1566722167088, 26952, 207, true
14601, 1566722166883, 26747, 1566722167088, 26952, 205, true
14602, 1566722166887, 26751, 1566722167092, 26956, 205, true
14603, 1566722166892, 26756, 1566722167096, 26960, 204, true
14604, 1566722166894, 26758, 1566722167101, 26965, 207, true
14605, 1566722166907, 26771, 1566722167112, 26976, 205, true
14606, 1566722166909, 26773, 1566722167113, 26977, 204, true
14607, 1566722166910, 26774, 1566722167113, 26977, 203, true
14608, 1566722166922, 26786, 1566722167142, 27006, 220, true
14609, 1566722166923, 26787, 1566722167202, 27066, 279, true
14610, 1566722166923, 26787, 1566722167202, 27066, 279, true
14611, 1566722166923, 26787, 1566722167202, 27066, 279, true
14612, 1566722166923, 26787, 1566722167210, 27074, 287, true
14613, 1566722166924, 26788, 1566722167206, 27070, 282, true
14614, 1566722166924, 26788, 1566722167209, 27073, 285, true
14615, 1566722166924, 26788, 1566722167211, 27075, 287, true
14616, 1566722166925, 26789, 1566722167201, 27065, 276, true
14617, 1566722166926, 26790, 1566722167208, 27072, 282, true
14618, 1566722166926, 26790, 1566722167209, 27073, 283, true
14619, 1566722166926, 26790, 1566722167206, 27070, 280, true
14620, 1566722166927, 26791, 1566722167210, 27074, 283, true
14621, 1566722166928, 26792, 1566722167201, 27065, 273, true
14622, 1566722166929, 26793, 1566722167201, 27065, 272, true
14623, 1566722166931, 26795, 1566722167207, 27071, 276, true
14624, 1566722166935, 26799, 1566722167146, 27010, 211, true
14625, 1566722166935, 26799, 1566722167201, 27065, 266, true
14626, 1566722166936, 26800, 1566722167142, 27006, 206, true
14627, 1566722166936, 26800, 1566722167201, 27065, 265, true
14628, 1566722166937, 26801, 1566722167201, 27065, 264, true
14629, 1566722166938, 26802, 1566722167201, 27065, 263, true
14630, 1566722166940, 26804, 1566722167154, 27018, 214, true
14631, 1566722166940, 26804, 1566722167201, 27065, 261, true
14632, 1566722166941, 26805, 1566722167201, 27065, 260, true
14633, 1566722166945, 26809, 1566722167159, 27023, 214, true
14634, 1566722166949, 26813, 1566722167201, 27065, 252, true
14635, 1566722166951, 26815, 1566722167201, 27065, 250, true
14636, 1566722166952, 26816, 1566722167184, 27048, 232, true
14637, 1566722166952, 26816, 1566722167167, 27031, 215, true
14638, 1566722166953, 26817, 1566722167201, 27065, 248, true
14639, 1566722166953, 26817, 1566722167179, 27043, 226, true
14640, 1566722166954, 26818, 1566722167182, 27046, 228, true
14641, 1566722166954, 26818, 1566722167184, 27048, 230, true
14642, 1566722166955, 26819, 1566722167178, 27042, 223, true
14643, 1566722166960, 26824, 1566722167167, 27031, 207, true
14644, 1566722166960, 26824, 1566722167185, 27049, 225, true
14645, 1566722166960, 26824, 1566722167167, 27031, 207, true
14646, 1566722166961, 26825, 1566722167174, 27038, 213, true
14647, 1566722166962, 26826, 1566722167177, 27041, 215, true
14648, 1566722166967, 26831, 1566722167175, 27039, 208, true
14649, 1566722166967, 26831, 1566722167211, 27075, 244, true
14650, 1566722166968, 26832, 1566722167211, 27075, 243, true
14651, 1566722166968, 26832, 1566722167202, 27066, 234, true
14652, 1566722166969, 26833, 1566722167201, 27065, 232, true
14653, 1566722166970, 26834, 1566722167203, 27067, 233, true
14654, 1566722166970, 26834, 1566722167204, 27068, 234, true
14655, 1566722166971, 26835, 1566722167202, 27066, 231, true
14656, 1566722166971, 26835, 1566722167202, 27066, 231, true
14657, 1566722166972, 26836, 1566722167202, 27066, 230, true
14658, 1566722166973, 26837, 1566722167218, 27082, 245, true
14659, 1566722166973, 26837, 1566722167202, 27066, 229, true
14660, 1566722166974, 26838, 1566722167205, 27069, 231, true
14661, 1566722166975, 26839, 1566722167202, 27066, 227, true
14662, 1566722166979, 26843, 1566722167201, 27065, 222, true
14663, 1566722166980, 26844, 1566722167215, 27079, 235, true
14664, 1566722166981, 26845, 1566722167219, 27083, 238, true
14665, 1566722166981, 26845, 1566722167219, 27083, 238, true
14666, 1566722166982, 26846, 1566722167202, 27066, 220, true
14667, 1566722166982, 26846, 1566722167212, 27076, 230, true
14668, 1566722166983, 26847, 1566722167218, 27082, 235, true
14669, 1566722166984, 26848, 1566722167218, 27082, 234, true
14670, 1566722166985, 26849, 1566722167215, 27079, 230, true
14671, 1566722166987, 26851, 1566722167220, 27084, 233, true
14672, 1566722166988, 26852, 1566722167218, 27082, 230, true
14673, 1566722166989, 26853, 1566722167221, 27085, 232, true
14674, 1566722166991, 26855, 1566722167222, 27086, 231, true
14675, 1566722166991, 26855, 1566722167222, 27086, 231, true
14676, 1566722166992, 26856, 1566722167221, 27085, 229, true
14677, 1566722166993, 26857, 1566722167223, 27087, 230, true
14678, 1566722166993, 26857, 1566722167224, 27088, 231, true
14679, 1566722166996, 26860, 1566722167223, 27087, 227, true
14680, 1566722166996, 26860, 1566722167226, 27090, 230, true
14681, 1566722166997, 26861, 1566722167227, 27091, 230, true
14682, 1566722166997, 26861, 1566722167233, 27097, 236, true
14683, 1566722166997, 26861, 1566722167234, 27098, 237, true
14684, 1566722166998, 26862, 1566722167233, 27097, 235, true
14685, 1566722166998, 26862, 1566722167239, 27103, 241, true
14686, 1566722166999, 26863, 1566722167233, 27097, 234, true
14687, 1566722167000, 26864, 1566722167234, 27098, 234, true
14688, 1566722167000, 26864, 1566722167234, 27098, 234, true
14689, 1566722167001, 26865, 1566722167235, 27099, 234, true
14690, 1566722167002, 26866, 1566722167235, 27099, 233, true
14691, 1566722167004, 26868, 1566722167233, 27097, 229, true
14692, 1566722167015, 26879, 1566722167236, 27100, 221, true
14693, 1566722167015, 26879, 1566722167239, 27103, 224, true
14694, 1566722167016, 26880, 1566722167240, 27104, 224, true
14695, 1566722167118, 26982, 1566722167364, 27228, 246, true
14696, 1566722167119, 26983, 1566722167364, 27228, 245, true
14697, 1566722167120, 26984, 1566722167364, 27228, 244, true
14698, 1566722167121, 26985, 1566722167362, 27226, 241, true
14699, 1566722167122, 26986, 1566722167363, 27227, 241, true
14700, 1566722167123, 26987, 1566722167362, 27226, 239, true
14701, 1566722167124, 26988, 1566722167359, 27223, 235, true
14702, 1566722167126, 26990, 1566722167332, 27196, 206, true
14703, 1566722167128, 26992, 1566722167358, 27222, 230, true
14704, 1566722167128, 26992, 1566722167356, 27220, 228, true
14705, 1566722167130, 26994, 1566722167356, 27220, 226, true
14706, 1566722167133, 26997, 1566722167354, 27218, 221, true
14707, 1566722167133, 26997, 1566722167356, 27220, 223, true
14708, 1566722167133, 26997, 1566722167353, 27217, 220, true
14709, 1566722167134, 26998, 1566722167356, 27220, 222, true
14710, 1566722167136, 27000, 1566722167353, 27217, 217, true
14711, 1566722167137, 27001, 1566722167377, 27241, 240, true
14712, 1566722167138, 27002, 1566722167353, 27217, 215, true
14713, 1566722167139, 27003, 1566722167380, 27244, 241, true
14714, 1566722167140, 27004, 1566722167348, 27212, 208, true
14715, 1566722167143, 27007, 1566722167378, 27242, 235, true
14716, 1566722167143, 27007, 1566722167380, 27244, 237, true
14717, 1566722167143, 27007, 1566722167377, 27241, 234, true
14718, 1566722167144, 27008, 1566722167378, 27242, 234, true
14719, 1566722167148, 27012, 1566722167378, 27242, 230, true
14720, 1566722167149, 27013, 1566722167377, 27241, 228, true
14721, 1566722167151, 27015, 1566722167377, 27241, 226, true
14722, 1566722167152, 27016, 1566722167377, 27241, 225, true
14723, 1566722167155, 27019, 1566722167377, 27241, 222, true
14724, 1566722167157, 27021, 1566722167377, 27241, 220, true
14725, 1566722167159, 27023, 1566722167377, 27241, 218, true
14726, 1566722167160, 27024, 1566722167377, 27241, 217, true
14727, 1566722167162, 27026, 1566722167368, 27232, 206, true
14728, 1566722167164, 27028, 1566722167373, 27237, 209, true
14729, 1566722167165, 27029, 1566722167380, 27244, 215, true
14730, 1566722167168, 27032, 1566722167373, 27237, 205, true
14731, 1566722167168, 27032, 1566722167449, 27313, 281, true
14732, 1566722167169, 27033, 1566722167380, 27244, 211, true
14733, 1566722167169, 27033, 1566722167476, 27340, 307, true
14734, 1566722167170, 27034, 1566722167380, 27244, 210, true
14735, 1566722167170, 27034, 1566722167380, 27244, 210, true
14736, 1566722167171, 27035, 1566722167476, 27340, 305, true
14737, 1566722167172, 27036, 1566722167480, 27344, 308, true
14738, 1566722167172, 27036, 1566722167385, 27249, 213, true
14739, 1566722167173, 27037, 1566722167476, 27340, 303, true
14740, 1566722167173, 27037, 1566722167393, 27257, 220, true
14741, 1566722167175, 27039, 1566722167475, 27339, 300, true
14742, 1566722167175, 27039, 1566722167388, 27252, 213, true
14743, 1566722167176, 27040, 1566722167475, 27339, 299, true
14744, 1566722167176, 27040, 1566722167476, 27340, 300, true
14745, 1566722167177, 27041, 1566722167476, 27340, 299, true
14746, 1566722167178, 27042, 1566722167397, 27261, 219, true
14747, 1566722167178, 27042, 1566722167476, 27340, 298, true
14748, 1566722167179, 27043, 1566722167475, 27339, 296, true
14749, 1566722167179, 27043, 1566722167475, 27339, 296, true
14750, 1566722167180, 27044, 1566722167397, 27261, 217, true
14751, 1566722167181, 27045, 1566722167475, 27339, 294, true
14752, 1566722167181, 27045, 1566722167475, 27339, 294, true
14753, 1566722167183, 27047, 1566722167397, 27261, 214, true
14754, 1566722167183, 27047, 1566722167469, 27333, 286, true
14755, 1566722167184, 27048, 1566722167408, 27272, 224, true
14756, 1566722167185, 27049, 1566722167475, 27339, 290, true
14757, 1566722167185, 27049, 1566722167474, 27338, 289, true
14758, 1566722167186, 27050, 1566722167428, 27292, 242, true
14759, 1566722167186, 27050, 1566722167475, 27339, 289, true
14760, 1566722167187, 27051, 1566722167475, 27339, 288, true
14761, 1566722167188, 27052, 1566722167468, 27332, 280, true
14762, 1566722167189, 27053, 1566722167433, 27297, 244, true
14763, 1566722167203, 27067, 1566722167468, 27332, 265, true
14764, 1566722167204, 27068, 1566722167461, 27325, 257, true
14765, 1566722167204, 27068, 1566722167433, 27297, 229, true
14766, 1566722167205, 27069, 1566722167467, 27331, 262, true
14767, 1566722167205, 27069, 1566722167468, 27332, 263, true
14768, 1566722167206, 27070, 1566722167467, 27331, 261, true
14769, 1566722167207, 27071, 1566722167438, 27302, 231, true
14770, 1566722167208, 27072, 1566722167461, 27325, 253, true
14771, 1566722167209, 27073, 1566722167467, 27331, 258, true
14772, 1566722167209, 27073, 1566722167442, 27306, 233, true
14773, 1566722167210, 27074, 1566722167467, 27331, 257, true
14774, 1566722167211, 27075, 1566722167467, 27331, 256, true
14775, 1566722167211, 27075, 1566722167458, 27322, 247, true
14776, 1566722167212, 27076, 1566722167467, 27331, 255, true
14777, 1566722167213, 27077, 1566722167467, 27331, 254, true
14778, 1566722167213, 27077, 1566722167438, 27302, 225, true
14779, 1566722167213, 27077, 1566722167484, 27348, 271, true
14780, 1566722167214, 27078, 1566722167469, 27333, 255, true
14781, 1566722167214, 27078, 1566722167461, 27325, 247, true
14782, 1566722167215, 27079, 1566722167433, 27297, 218, true
14783, 1566722167219, 27083, 1566722167467, 27331, 248, true
14784, 1566722167220, 27084, 1566722167461, 27325, 241, true
14785, 1566722167220, 27084, 1566722167458, 27322, 238, true
14786, 1566722167221, 27085, 1566722167442, 27306, 221, true
14787, 1566722167221, 27085, 1566722167461, 27325, 240, true
14788, 1566722167222, 27086, 1566722167445, 27309, 223, true
14789, 1566722167222, 27086, 1566722167439, 27303, 217, true
14790, 1566722167223, 27087, 1566722167445, 27309, 222, true
14791, 1566722167224, 27088, 1566722167461, 27325, 237, true
14792, 1566722167224, 27088, 1566722167463, 27327, 239, true
14793, 1566722167225, 27089, 1566722167461, 27325, 236, true
14794, 1566722167225, 27089, 1566722167461, 27325, 236, true
14795, 1566722167225, 27089, 1566722167463, 27327, 238, true
14796, 1566722167226, 27090, 1566722167466, 27330, 240, true
14797, 1566722167227, 27091, 1566722167442, 27306, 215, true
14798, 1566722167228, 27092, 1566722167462, 27326, 234, true
14799, 1566722167228, 27092, 1566722167445, 27309, 217, true
14800, 1566722167229, 27093, 1566722167455, 27319, 226, true
14801, 1566722167234, 27098, 1566722167456, 27320, 222, true
14802, 1566722167235, 27099, 1566722167446, 27310, 211, true
14803, 1566722167235, 27099, 1566722167467, 27331, 232, true
14804, 1566722167236, 27100, 1566722167463, 27327, 227, true
14805, 1566722167240, 27104, 1566722167446, 27310, 206, true
14806, 1566722167240, 27104, 1566722167449, 27313, 209, true
14807, 1566722167242, 27106, 1566722167482, 27346, 240, true
14808, 1566722167242, 27106, 1566722167449, 27313, 207, true
14809, 1566722167242, 27106, 1566722167481, 27345, 239, true
14810, 1566722167243, 27107, 1566722167482, 27346, 239, true
14811, 1566722167243, 27107, 1566722167483, 27347, 240, true
14812, 1566722167244, 27108, 1566722167483, 27347, 239, true
14813, 1566722167245, 27109, 1566722167451, 27315, 206, true
14814, 1566722167245, 27109, 1566722167483, 27347, 238, true
14815, 1566722167246, 27110, 1566722167480, 27344, 234, true
14816, 1566722167246, 27110, 1566722167451, 27315, 205, true
14817, 1566722167247, 27111, 1566722167452, 27316, 205, true
14818, 1566722167248, 27112, 1566722167454, 27318, 206, true
14819, 1566722167249, 27113, 1566722167458, 27322, 209, true
14820, 1566722167249, 27113, 1566722167458, 27322, 209, true
14821, 1566722167257, 27121, 1566722167476, 27340, 219, true
14822, 1566722167257, 27121, 1566722167468, 27332, 211, true
14823, 1566722167259, 27123, 1566722167475, 27339, 216, true
14824, 1566722167276, 27140, 1566722167483, 27347, 207, true
14825, 1566722167278, 27142, 1566722167491, 27355, 213, true
14826, 1566722167278, 27142, 1566722167488, 27352, 210, true
14827, 1566722167279, 27143, 1566722167491, 27355, 212, true
14828, 1566722167280, 27144, 1566722167491, 27355, 211, true
14829, 1566722167281, 27145, 1566722167491, 27355, 210, true
14830, 1566722167281, 27145, 1566722167491, 27355, 210, true
14831, 1566722167282, 27146, 1566722167491, 27355, 209, true
14832, 1566722167283, 27147, 1566722167488, 27352, 205, true
14833, 1566722167284, 27148, 1566722167488, 27352, 204, true
14834, 1566722167285, 27149, 1566722167491, 27355, 206, true
14835, 1566722167286, 27150, 1566722167494, 27358, 208, true
14836, 1566722167287, 27151, 1566722167494, 27358, 207, true
14837, 1566722167288, 27152, 1566722167492, 27356, 204, true
14838, 1566722167288, 27152, 1566722167501, 27365, 213, true
14839, 1566722167289, 27153, 1566722167499, 27363, 210, true
14840, 1566722167290, 27154, 1566722167499, 27363, 209, true
14841, 1566722167291, 27155, 1566722167499, 27363, 208, true
14842, 1566722167291, 27155, 1566722167499, 27363, 208, true
14843, 1566722167292, 27156, 1566722167499, 27363, 207, true
14844, 1566722167293, 27157, 1566722167499, 27363, 206, true
14845, 1566722167293, 27157, 1566722167499, 27363, 206, true
14846, 1566722167300, 27164, 1566722167505, 27369, 205, true
14847, 1566722167301, 27165, 1566722167507, 27371, 206, true
14848, 1566722167302, 27166, 1566722167506, 27370, 204, true
14849, 1566722167304, 27168, 1566722167509, 27373, 205, true
14850, 1566722167305, 27169, 1566722167509, 27373, 204, true
14851, 1566722167307, 27171, 1566722167513, 27377, 206, true
14852, 1566722167308, 27172, 1566722167513, 27377, 205, true
14853, 1566722167308, 27172, 1566722167513, 27377, 205, true
14854, 1566722167311, 27175, 1566722167517, 27381, 206, true
14855, 1566722167312, 27176, 1566722167517, 27381, 205, true
14856, 1566722167314, 27178, 1566722167522, 27386, 208, true
14857, 1566722167314, 27178, 1566722167522, 27386, 208, true
14858, 1566722167315, 27179, 1566722167523, 27387, 208, true
14859, 1566722167320, 27184, 1566722167529, 27393, 209, true
14860, 1566722167321, 27185, 1566722167529, 27393, 208, true
14861, 1566722167322, 27186, 1566722167529, 27393, 207, true
14862, 1566722167324, 27188, 1566722167543, 27407, 219, true
14863, 1566722167325, 27189, 1566722167536, 27400, 211, true
14864, 1566722167326, 27190, 1566722167542, 27406, 216, true
14865, 1566722167326, 27190, 1566722167535, 27399, 209, true
14866, 1566722167327, 27191, 1566722167543, 27407, 216, true
14867, 1566722167328, 27192, 1566722167542, 27406, 214, true
14868, 1566722167328, 27192, 1566722167542, 27406, 214, true
14869, 1566722167329, 27193, 1566722167542, 27406, 213, true
14870, 1566722167330, 27194, 1566722167543, 27407, 213, true
14871, 1566722167335, 27199, 1566722167543, 27407, 208, true
14872, 1566722167336, 27200, 1566722167544, 27408, 208, true
14873, 1566722167337, 27201, 1566722167543, 27407, 206, true
14874, 1566722167338, 27202, 1566722167544, 27408, 206, true
14875, 1566722167341, 27205, 1566722167546, 27410, 205, true
14876, 1566722167343, 27207, 1566722167552, 27416, 209, true
14877, 1566722167344, 27208, 1566722167557, 27421, 213, true
14878, 1566722167345, 27209, 1566722167552, 27416, 207, true
14879, 1566722167346, 27210, 1566722167553, 27417, 207, true
14880, 1566722167348, 27212, 1566722167553, 27417, 205, true
14881, 1566722167351, 27215, 1566722167574, 27438, 223, true
14882, 1566722167370, 27234, 1566722167581, 27445, 211, true
14883, 1566722167382, 27246, 1566722167592, 27456, 210, true
14884, 1566722167386, 27250, 1566722167594, 27458, 208, true
14885, 1566722167391, 27255, 1566722167596, 27460, 205, true
14886, 1566722167394, 27258, 1566722167602, 27466, 208, true
14887, 1566722167398, 27262, 1566722167602, 27466, 204, true
14888, 1566722167400, 27264, 1566722167603, 27467, 203, true
14889, 1566722167401, 27265, 1566722167604, 27468, 203, true
14890, 1566722167402, 27266, 1566722167606, 27470, 204, true
14891, 1566722167404, 27268, 1566722167607, 27471, 203, true
14892, 1566722167405, 27269, 1566722167610, 27474, 205, true
14893, 1566722167408, 27272, 1566722167611, 27475, 203, true
14894, 1566722167410, 27274, 1566722167619, 27483, 209, true
14895, 1566722167412, 27276, 1566722167619, 27483, 207, true
14896, 1566722167413, 27277, 1566722167619, 27483, 206, true
14897, 1566722167414, 27278, 1566722167620, 27484, 206, true
14898, 1566722167416, 27280, 1566722167631, 27495, 215, true
14899, 1566722167422, 27286, 1566722167631, 27495, 209, true
14900, 1566722167423, 27287, 1566722167632, 27496, 209, true
14901, 1566722167423, 27287, 1566722167632, 27496, 209, true
14902, 1566722167424, 27288, 1566722167632, 27496, 208, true
14903, 1566722167425, 27289, 1566722167632, 27496, 207, true
14904, 1566722167426, 27290, 1566722167632, 27496, 206, true
14905, 1566722167426, 27290, 1566722167632, 27496, 206, true
14906, 1566722167426, 27290, 1566722167632, 27496, 206, true
14907, 1566722167429, 27293, 1566722167639, 27503, 210, true
14908, 1566722167429, 27293, 1566722167639, 27503, 210, true
14909, 1566722167430, 27294, 1566722167639, 27503, 209, true
14910, 1566722167431, 27295, 1566722167639, 27503, 208, true
14911, 1566722167433, 27297, 1566722167639, 27503, 206, true
14912, 1566722167435, 27299, 1566722167641, 27505, 206, true
14913, 1566722167435, 27299, 1566722167639, 27503, 204, true
14914, 1566722167436, 27300, 1566722167646, 27510, 210, true
14915, 1566722167441, 27305, 1566722167647, 27511, 206, true
14916, 1566722167442, 27306, 1566722167648, 27512, 206, true
14917, 1566722167445, 27309, 1566722167648, 27512, 203, true
14918, 1566722167447, 27311, 1566722167651, 27515, 204, true
14919, 1566722167447, 27311, 1566722167652, 27516, 205, true
14920, 1566722167447, 27311, 1566722167653, 27517, 206, true
14921, 1566722167451, 27315, 1566722167656, 27520, 205, true
14922, 1566722167455, 27319, 1566722167689, 27553, 234, true
14923, 1566722167456, 27320, 1566722167690, 27554, 234, true
14924, 1566722167477, 27341, 1566722167690, 27554, 213, true
14925, 1566722167477, 27341, 1566722167681, 27545, 204, true
14926, 1566722167477, 27341, 1566722167707, 27571, 230, true
14927, 1566722167484, 27348, 1566722167701, 27565, 217, true
14928, 1566722167489, 27353, 1566722167705, 27569, 216, true
14929, 1566722167494, 27358, 1566722167708, 27572, 214, true
14930, 1566722167495, 27359, 1566722167706, 27570, 211, true
14931, 1566722167495, 27359, 1566722167705, 27569, 210, true
14932, 1566722167502, 27366, 1566722167708, 27572, 206, true
14933, 1566722167506, 27370, 1566722167714, 27578, 208, true
14934, 1566722167506, 27370, 1566722167714, 27578, 208, true
14935, 1566722167507, 27371, 1566722167714, 27578, 207, true
14936, 1566722167507, 27371, 1566722167714, 27578, 207, true
14937, 1566722167511, 27375, 1566722167714, 27578, 203, true
14938, 1566722167511, 27375, 1566722167719, 27583, 208, true
14939, 1566722167513, 27377, 1566722167724, 27588, 211, true
14940, 1566722167514, 27378, 1566722167717, 27581, 203, true
14941, 1566722167514, 27378, 1566722167723, 27587, 209, true
14942, 1566722167515, 27379, 1566722167720, 27584, 205, true
14943, 1566722167515, 27379, 1566722167720, 27584, 205, true
14944, 1566722167516, 27380, 1566722167720, 27584, 204, true
14945, 1566722167518, 27382, 1566722167725, 27589, 207, true
14946, 1566722167518, 27382, 1566722167724, 27588, 206, true
14947, 1566722167519, 27383, 1566722167729, 27593, 210, true
14948, 1566722167520, 27384, 1566722167730, 27594, 210, true
14949, 1566722167520, 27384, 1566722167729, 27593, 209, true
14950, 1566722167521, 27385, 1566722167726, 27590, 205, true
14951, 1566722167523, 27387, 1566722167729, 27593, 206, true
14952, 1566722167523, 27387, 1566722167729, 27593, 206, true
14953, 1566722167525, 27389, 1566722167732, 27596, 207, true
14954, 1566722167525, 27389, 1566722167734, 27598, 209, true
14955, 1566722167530, 27394, 1566722167740, 27604, 210, true
14956, 1566722167531, 27395, 1566722167738, 27602, 207, true
14957, 1566722167531, 27395, 1566722167740, 27604, 209, true
14958, 1566722167531, 27395, 1566722167740, 27604, 209, true
14959, 1566722167532, 27396, 1566722167738, 27602, 206, true
14960, 1566722167533, 27397, 1566722167749, 27613, 216, true
14961, 1566722167534, 27398, 1566722167743, 27607, 209, true
14962, 1566722167536, 27400, 1566722167747, 27611, 211, true
14963, 1566722167537, 27401, 1566722167756, 27620, 219, true
14964, 1566722167537, 27401, 1566722167752, 27616, 215, true
14965, 1566722167538, 27402, 1566722167752, 27616, 214, true
14966, 1566722167541, 27405, 1566722167750, 27614, 209, true
14967, 1566722167546, 27410, 1566722167757, 27621, 211, true
14968, 1566722167548, 27412, 1566722167756, 27620, 208, true
14969, 1566722167549, 27413, 1566722167757, 27621, 208, true
14970, 1566722167549, 27413, 1566722167762, 27626, 213, true
14971, 1566722167550, 27414, 1566722167758, 27622, 208, true
14972, 1566722167554, 27418, 1566722167762, 27626, 208, true
14973, 1566722167555, 27419, 1566722167761, 27625, 206, true
14974, 1566722167555, 27419, 1566722167763, 27627, 208, true
14975, 1566722167556, 27420, 1566722167766, 27630, 210, true
14976, 1566722167557, 27421, 1566722167766, 27630, 209, true
14977, 1566722167557, 27421, 1566722167764, 27628, 207, true
14978, 1566722167558, 27422, 1566722167766, 27630, 208, true
14979, 1566722167559, 27423, 1566722167767, 27631, 208, true
14980, 1566722167560, 27424, 1566722167767, 27631, 207, true
14981, 1566722167561, 27425, 1566722167767, 27631, 206, true
14982, 1566722167562, 27426, 1566722167768, 27632, 206, true
14983, 1566722167563, 27427, 1566722167771, 27635, 208, true
14984, 1566722167563, 27427, 1566722167769, 27633, 206, true
14985, 1566722167563, 27427, 1566722167771, 27635, 208, true
14986, 1566722167564, 27428, 1566722167769, 27633, 205, true
14987, 1566722167564, 27428, 1566722167771, 27635, 207, true
14988, 1566722167565, 27429, 1566722167771, 27635, 206, true
14989, 1566722167565, 27429, 1566722167771, 27635, 206, true
14990, 1566722167566, 27430, 1566722167773, 27637, 207, true
14991, 1566722167567, 27431, 1566722167772, 27636, 205, true
14992, 1566722167568, 27432, 1566722167773, 27637, 205, true
14993, 1566722167569, 27433, 1566722167773, 27637, 204, true
14994, 1566722167571, 27435, 1566722167778, 27642, 207, true
14995, 1566722167571, 27435, 1566722167775, 27639, 204, true
14996, 1566722167572, 27436, 1566722167778, 27642, 206, true
14997, 1566722167572, 27436, 1566722167778, 27642, 206, true
14998, 1566722167575, 27439, 1566722167781, 27645, 206, true
14999, 1566722167575, 27439, 1566722167783, 27647, 208, true
15000, 1566722167575, 27439, 1566722167785, 27649, 210, true
15001, 1566722167575, 27439, 1566722167788, 27652, 213, true
15002, 1566722167576, 27440, 1566722167789, 27653, 213, true
15003, 1566722167576, 27440, 1566722167789, 27653, 213, true
15004, 1566722167576, 27440, 1566722167788, 27652, 212, true
15005, 1566722167576, 27440, 1566722167783, 27647, 207, true
15006, 1566722167577, 27441, 1566722167785, 27649, 208, true
15007, 1566722167577, 27441, 1566722167789, 27653, 212, true
15008, 1566722167577, 27441, 1566722167789, 27653, 212, true
15009, 1566722167578, 27442, 1566722167785, 27649, 207, true
15010, 1566722167579, 27443, 1566722167804, 27668, 225, true
15011, 1566722167580, 27444, 1566722167789, 27653, 209, true
15012, 1566722167581, 27445, 1566722167792, 27656, 211, true
15013, 1566722167582, 27446, 1566722167789, 27653, 207, true
15014, 1566722167583, 27447, 1566722167791, 27655, 208, true
15015, 1566722167585, 27449, 1566722167803, 27667, 218, true
15016, 1566722167586, 27450, 1566722167804, 27668, 218, true
15017, 1566722167587, 27451, 1566722167804, 27668, 217, true
15018, 1566722167588, 27452, 1566722167804, 27668, 216, true
15019, 1566722167589, 27453, 1566722167804, 27668, 215, true
15020, 1566722167589, 27453, 1566722167803, 27667, 214, true
15021, 1566722167590, 27454, 1566722167798, 27662, 208, true
15022, 1566722167590, 27454, 1566722167804, 27668, 214, true
15023, 1566722167591, 27455, 1566722167804, 27668, 213, true
15024, 1566722167594, 27458, 1566722167804, 27668, 210, true
15025, 1566722167596, 27460, 1566722167804, 27668, 208, true
15026, 1566722167597, 27461, 1566722167804, 27668, 207, true
15027, 1566722167598, 27462, 1566722167804, 27668, 206, true
15028, 1566722167598, 27462, 1566722167804, 27668, 206, true
15029, 1566722167599, 27463, 1566722167813, 27677, 214, true
15030, 1566722167600, 27464, 1566722167814, 27678, 214, true
15031, 1566722167604, 27468, 1566722167815, 27679, 211, true
15032, 1566722167605, 27469, 1566722167815, 27679, 210, true
15033, 1566722167607, 27471, 1566722167816, 27680, 209, true
15034, 1566722167607, 27471, 1566722167815, 27679, 208, true
15035, 1566722167608, 27472, 1566722167817, 27681, 209, true
15036, 1566722167609, 27473, 1566722167820, 27684, 211, true
15037, 1566722167609, 27473, 1566722167820, 27684, 211, true
15038, 1566722167612, 27476, 1566722167820, 27684, 208, true
15039, 1566722167612, 27476, 1566722167820, 27684, 208, true
15040, 1566722167613, 27477, 1566722167820, 27684, 207, true
15041, 1566722167614, 27478, 1566722167820, 27684, 206, true
15042, 1566722167615, 27479, 1566722167820, 27684, 205, true
15043, 1566722167616, 27480, 1566722167823, 27687, 207, true
15044, 1566722167617, 27481, 1566722167825, 27689, 208, true
15045, 1566722167620, 27484, 1566722167828, 27692, 208, true
15046, 1566722167621, 27485, 1566722167831, 27695, 210, true
15047, 1566722167622, 27486, 1566722167831, 27695, 209, true
15048, 1566722167622, 27486, 1566722167832, 27696, 210, true
15049, 1566722167623, 27487, 1566722167834, 27698, 211, true
15050, 1566722167623, 27487, 1566722167829, 27693, 206, true
15051, 1566722167625, 27489, 1566722167833, 27697, 208, true
15052, 1566722167625, 27489, 1566722167836, 27700, 211, true
15053, 1566722167626, 27490, 1566722167843, 27707, 217, true
15054, 1566722167633, 27497, 1566722167842, 27706, 209, true
15055, 1566722167633, 27497, 1566722167843, 27707, 210, true
15056, 1566722167633, 27497, 1566722167845, 27709, 212, true
15057, 1566722167640, 27504, 1566722167845, 27709, 205, true
15058, 1566722167640, 27504, 1566722167845, 27709, 205, true
15059, 1566722167641, 27505, 1566722167853, 27717, 212, true
15060, 1566722167643, 27507, 1566722167849, 27713, 206, true
15061, 1566722167643, 27507, 1566722167848, 27712, 205, true
15062, 1566722167644, 27508, 1566722167854, 27718, 210, true
15063, 1566722167644, 27508, 1566722167856, 27720, 212, true
15064, 1566722167645, 27509, 1566722167854, 27718, 209, true
15065, 1566722167645, 27509, 1566722167860, 27724, 215, true
15066, 1566722167648, 27512, 1566722167855, 27719, 207, true
15067, 1566722167649, 27513, 1566722167858, 27722, 209, true
15068, 1566722167653, 27517, 1566722167859, 27723, 206, true
15069, 1566722167654, 27518, 1566722167859, 27723, 205, true
15070, 1566722167654, 27518, 1566722167861, 27725, 207, true
15071, 1566722167654, 27518, 1566722167862, 27726, 208, true
15072, 1566722167657, 27521, 1566722167876, 27740, 219, true
15073, 1566722167657, 27521, 1566722167876, 27740, 219, true
15074, 1566722167658, 27522, 1566722167869, 27733, 211, true
15075, 1566722167659, 27523, 1566722167873, 27737, 214, true
15076, 1566722167660, 27524, 1566722167875, 27739, 215, true
15077, 1566722167661, 27525, 1566722167870, 27734, 209, true
15078, 1566722167662, 27526, 1566722167872, 27736, 210, true
15079, 1566722167663, 27527, 1566722167883, 27747, 220, true
15080, 1566722167664, 27528, 1566722167881, 27745, 217, true
15081, 1566722167665, 27529, 1566722167881, 27745, 216, true
15082, 1566722167665, 27529, 1566722167881, 27745, 216, true
15083, 1566722167665, 27529, 1566722167871, 27735, 206, true
15084, 1566722167667, 27531, 1566722167880, 27744, 213, true
15085, 1566722167668, 27532, 1566722167883, 27747, 215, true
15086, 1566722167669, 27533, 1566722167875, 27739, 206, true
15087, 1566722167669, 27533, 1566722167882, 27746, 213, true
15088, 1566722167672, 27536, 1566722167882, 27746, 210, true
15089, 1566722167673, 27537, 1566722167884, 27748, 211, true
15090, 1566722167675, 27539, 1566722167885, 27749, 210, true
15091, 1566722167677, 27541, 1566722167885, 27749, 208, true
15092, 1566722167679, 27543, 1566722167891, 27755, 212, true
15093, 1566722167682, 27546, 1566722167891, 27755, 209, true
15094, 1566722167685, 27549, 1566722167892, 27756, 207, true
15095, 1566722167687, 27551, 1566722167893, 27757, 206, true
15096, 1566722167690, 27554, 1566722167894, 27758, 204, true
15097, 1566722167692, 27556, 1566722167906, 27770, 214, true
15098, 1566722167693, 27557, 1566722167904, 27768, 211, true
15099, 1566722167697, 27561, 1566722167905, 27769, 208, true
15100, 1566722167699, 27563, 1566722167907, 27771, 208, true
15101, 1566722167701, 27565, 1566722167907, 27771, 206, true
15102, 1566722167702, 27566, 1566722167908, 27772, 206, true
15103, 1566722167709, 27573, 1566722167915, 27779, 206, true
15104, 1566722167715, 27579, 1566722167921, 27785, 206, true
15105, 1566722167718, 27582, 1566722167921, 27785, 203, true
15106, 1566722167722, 27586, 1566722167934, 27798, 212, true
15107, 1566722167727, 27591, 1566722167935, 27799, 208, true
15108, 1566722167732, 27596, 1566722167941, 27805, 209, true
15109, 1566722167741, 27605, 1566722167946, 27810, 205, true
15110, 1566722167743, 27607, 1566722167946, 27810, 203, true
15111, 1566722167744, 27608, 1566722167947, 27811, 203, true
15112, 1566722167745, 27609, 1566722167951, 27815, 206, true
15113, 1566722167747, 27611, 1566722167951, 27815, 204, true
15114, 1566722167749, 27613, 1566722167964, 27828, 215, true
15115, 1566722167793, 27657, 1566722167999, 27863, 206, true
15116, 1566722167794, 27658, 1566722167999, 27863, 205, true
15117, 1566722167795, 27659, 1566722168021, 27885, 226, true
15118, 1566722167795, 27659, 1566722168001, 27865, 206, true
15119, 1566722167795, 27659, 1566722168188, 28052, 393, true
15120, 1566722167796, 27660, 1566722168185, 28049, 389, true
15121, 1566722167796, 27660, 1566722168187, 28051, 391, true
15122, 1566722167797, 27661, 1566722168187, 28051, 390, true
15123, 1566722167797, 27661, 1566722168188, 28052, 391, true
15124, 1566722167798, 27662, 1566722168189, 28053, 391, true
15125, 1566722167804, 27668, 1566722168187, 28051, 383, true
15126, 1566722167805, 27669, 1566722168189, 28053, 384, true
15127, 1566722167805, 27669, 1566722168188, 28052, 383, true
15128, 1566722167805, 27669, 1566722168186, 28050, 381, true
15129, 1566722167805, 27669, 1566722168078, 27942, 273, true
15130, 1566722167805, 27669, 1566722168188, 28052, 383, true
15131, 1566722167805, 27669, 1566722168187, 28051, 382, true
15132, 1566722167806, 27670, 1566722168186, 28050, 380, true
15133, 1566722167806, 27670, 1566722168176, 28040, 370, true
15134, 1566722167806, 27670, 1566722168188, 28052, 382, true
15135, 1566722167807, 27671, 1566722168068, 27932, 261, true
15136, 1566722167808, 27672, 1566722168185, 28049, 377, true
15137, 1566722167808, 27672, 1566722168184, 28048, 376, true
15138, 1566722167808, 27672, 1566722168188, 28052, 380, true
15139, 1566722167809, 27673, 1566722168053, 27917, 244, true
15140, 1566722167809, 27673, 1566722168185, 28049, 376, true
15141, 1566722167809, 27673, 1566722168058, 27922, 249, true
15142, 1566722167809, 27673, 1566722168187, 28051, 378, true
15143, 1566722167810, 27674, 1566722168186, 28050, 376, true
15144, 1566722167810, 27674, 1566722168185, 28049, 375, true
15145, 1566722167810, 27674, 1566722168186, 28050, 376, true
15146, 1566722167811, 27675, 1566722168186, 28050, 375, true
15147, 1566722167811, 27675, 1566722168186, 28050, 375, true
15148, 1566722167812, 27676, 1566722168189, 28053, 377, true
15149, 1566722167812, 27676, 1566722168187, 28051, 375, true
15150, 1566722167813, 27677, 1566722168185, 28049, 372, true
15151, 1566722167814, 27678, 1566722168189, 28053, 375, true
15152, 1566722167814, 27678, 1566722168189, 28053, 375, true
15153, 1566722167815, 27679, 1566722168191, 28055, 376, true
15154, 1566722167816, 27680, 1566722168185, 28049, 369, true
15155, 1566722167816, 27680, 1566722168176, 28040, 360, true
15156, 1566722167817, 27681, 1566722168094, 27958, 277, true
15157, 1566722167819, 27683, 1566722168187, 28051, 368, true
15158, 1566722167821, 27685, 1566722168186, 28050, 365, true
15159, 1566722167821, 27685, 1566722168176, 28040, 355, true
15160, 1566722167821, 27685, 1566722168188, 28052, 367, true
15161, 1566722167821, 27685, 1566722168185, 28049, 364, true
15162, 1566722167821, 27685, 1566722168187, 28051, 366, true
15163, 1566722167821, 27685, 1566722168186, 28050, 365, true
15164, 1566722167822, 27686, 1566722168189, 28053, 367, true
15165, 1566722167822, 27686, 1566722168188, 28052, 366, true
15166, 1566722167823, 27687, 1566722168210, 28074, 387, true
15167, 1566722167824, 27688, 1566722168188, 28052, 364, true
15168, 1566722167824, 27688, 1566722168199, 28063, 375, true
15169, 1566722167825, 27689, 1566722168211, 28075, 386, true
15170, 1566722167825, 27689, 1566722168217, 28081, 392, true
15171, 1566722167825, 27689, 1566722168199, 28063, 374, true
15172, 1566722167826, 27690, 1566722168201, 28065, 375, true
15173, 1566722167826, 27690, 1566722168190, 28054, 364, true
15174, 1566722167827, 27691, 1566722168211, 28075, 384, true
15175, 1566722167827, 27691, 1566722168212, 28076, 385, true
15176, 1566722167828, 27692, 1566722168211, 28075, 383, true
15177, 1566722167829, 27693, 1566722168202, 28066, 373, true
15178, 1566722167830, 27694, 1566722168192, 28056, 362, true
15179, 1566722167830, 27694, 1566722168201, 28065, 371, true
15180, 1566722167831, 27695, 1566722168191, 28055, 360, true
15181, 1566722167831, 27695, 1566722168191, 28055, 360, true
15182, 1566722167832, 27696, 1566722168203, 28067, 371, true
15183, 1566722167832, 27696, 1566722168215, 28079, 383, true
15184, 1566722167833, 27697, 1566722168209, 28073, 376, true
15185, 1566722167834, 27698, 1566722168192, 28056, 358, true
15186, 1566722167834, 27698, 1566722168210, 28074, 376, true
15187, 1566722167836, 27700, 1566722168210, 28074, 374, true
15188, 1566722167837, 27701, 1566722168190, 28054, 353, true
15189, 1566722167838, 27702, 1566722168189, 28053, 351, true
15190, 1566722167839, 27703, 1566722168192, 28056, 353, true
15191, 1566722167839, 27703, 1566722168201, 28065, 362, true
15192, 1566722167840, 27704, 1566722168210, 28074, 370, true
15193, 1566722167841, 27705, 1566722168204, 28068, 363, true
15194, 1566722167841, 27705, 1566722168215, 28079, 374, true
15195, 1566722167842, 27706, 1566722168193, 28057, 351, true
15196, 1566722167845, 27709, 1566722168199, 28063, 354, true
15197, 1566722167845, 27709, 1566722168191, 28055, 346, true
15198, 1566722167846, 27710, 1566722168213, 28077, 367, true
15199, 1566722167846, 27710, 1566722168191, 28055, 345, true
15200, 1566722167846, 27710, 1566722168217, 28081, 371, true
15201, 1566722167846, 27710, 1566722168211, 28075, 365, true
15202, 1566722167847, 27711, 1566722168190, 28054, 343, true
15203, 1566722167847, 27711, 1566722168190, 28054, 343, true
15204, 1566722167848, 27712, 1566722168192, 28056, 344, true
15205, 1566722167849, 27713, 1566722168202, 28066, 353, true
15206, 1566722167850, 27714, 1566722168213, 28077, 363, true
15207, 1566722167850, 27714, 1566722168215, 28079, 365, true
15208, 1566722167851, 27715, 1566722168200, 28064, 349, true
15209, 1566722167851, 27715, 1566722168202, 28066, 351, true
15210, 1566722167852, 27716, 1566722168300, 28164, 448, true
15211, 1566722167852, 27716, 1566722168212, 28076, 360, true
15212, 1566722167853, 27717, 1566722168209, 28073, 356, true
15213, 1566722167854, 27718, 1566722168192, 28056, 338, true
15214, 1566722167854, 27718, 1566722168204, 28068, 350, true
15215, 1566722167855, 27719, 1566722168215, 28079, 360, true
15216, 1566722167856, 27720, 1566722168202, 28066, 346, true
15217, 1566722167856, 27720, 1566722168192, 28056, 336, true
15218, 1566722167857, 27721, 1566722168202, 28066, 345, true
15219, 1566722167858, 27722, 1566722168200, 28064, 342, true
15220, 1566722167859, 27723, 1566722168212, 28076, 353, true
15221, 1566722167860, 27724, 1566722168192, 28056, 332, true
15222, 1566722167861, 27725, 1566722168203, 28067, 342, true
15223, 1566722167861, 27725, 1566722168191, 28055, 330, true
15224, 1566722167862, 27726, 1566722168211, 28075, 349, true
15225, 1566722167862, 27726, 1566722168200, 28064, 338, true
15226, 1566722167863, 27727, 1566722168210, 28074, 347, true
15227, 1566722167863, 27727, 1566722168212, 28076, 349, true
15228, 1566722167863, 27727, 1566722168212, 28076, 349, true
15229, 1566722167864, 27728, 1566722168192, 28056, 328, true
15230, 1566722167864, 27728, 1566722168213, 28077, 349, true
15231, 1566722167864, 27728, 1566722168193, 28057, 329, true
15232, 1566722167865, 27729, 1566722168215, 28079, 350, true
15233, 1566722167866, 27730, 1566722168213, 28077, 347, true
15234, 1566722167866, 27730, 1566722168190, 28054, 324, true
15235, 1566722167866, 27730, 1566722168201, 28065, 335, true
15236, 1566722167866, 27730, 1566722168200, 28064, 334, true
15237, 1566722167867, 27731, 1566722168212, 28076, 345, true
15238, 1566722167867, 27731, 1566722168203, 28067, 336, true
15239, 1566722167867, 27731, 1566722168202, 28066, 335, true
15240, 1566722167868, 27732, 1566722168200, 28064, 332, true
15241, 1566722167868, 27732, 1566722168201, 28065, 333, true
15242, 1566722167869, 27733, 1566722168210, 28074, 341, true
15243, 1566722167870, 27734, 1566722168200, 28064, 330, true
15244, 1566722167871, 27735, 1566722168191, 28055, 320, true
15245, 1566722167871, 27735, 1566722168204, 28068, 333, true
15246, 1566722167872, 27736, 1566722168219, 28083, 347, true
15247, 1566722167872, 27736, 1566722168212, 28076, 340, true
15248, 1566722167873, 27737, 1566722168202, 28066, 329, true
15249, 1566722167874, 27738, 1566722168213, 28077, 339, true
15250, 1566722167875, 27739, 1566722168213, 28077, 338, true
15251, 1566722167876, 27740, 1566722168202, 28066, 326, true
15252, 1566722167876, 27740, 1566722168190, 28054, 314, true
15253, 1566722167877, 27741, 1566722168201, 28065, 324, true
15254, 1566722167877, 27741, 1566722168190, 28054, 313, true
15255, 1566722167878, 27742, 1566722168211, 28075, 333, true
15256, 1566722167879, 27743, 1566722168189, 28053, 310, true
15257, 1566722167880, 27744, 1566722168189, 28053, 309, true
15258, 1566722167881, 27745, 1566722168211, 28075, 330, true
15259, 1566722167882, 27746, 1566722168218, 28082, 336, true
15260, 1566722167882, 27746, 1566722168204, 28068, 322, true
15261, 1566722167883, 27747, 1566722168211, 28075, 328, true
15262, 1566722167883, 27747, 1566722168216, 28080, 333, true
15263, 1566722167884, 27748, 1566722168211, 28075, 327, true
15264, 1566722167884, 27748, 1566722168217, 28081, 333, true
15265, 1566722167885, 27749, 1566722168202, 28066, 317, true
15266, 1566722167886, 27750, 1566722168201, 28065, 315, true
15267, 1566722167886, 27750, 1566722168200, 28064, 314, true
15268, 1566722167887, 27751, 1566722168200, 28064, 313, true
15269, 1566722167887, 27751, 1566722168199, 28063, 312, true
15270, 1566722167887, 27751, 1566722168201, 28065, 314, true
15271, 1566722167888, 27752, 1566722168220, 28084, 332, true
15272, 1566722167888, 27752, 1566722168210, 28074, 322, true
15273, 1566722167888, 27752, 1566722168190, 28054, 302, true
15274, 1566722167889, 27753, 1566722168211, 28075, 322, true
15275, 1566722167889, 27753, 1566722168203, 28067, 314, true
15276, 1566722167890, 27754, 1566722168209, 28073, 319, true
15277, 1566722167891, 27755, 1566722168199, 28063, 308, true
15278, 1566722167892, 27756, 1566722168199, 28063, 307, true
15279, 1566722167892, 27756, 1566722168209, 28073, 317, true
15280, 1566722167893, 27757, 1566722168200, 28064, 307, true
15281, 1566722167893, 27757, 1566722168198, 28062, 305, true
15282, 1566722167894, 27758, 1566722168203, 28067, 309, true
15283, 1566722167894, 27758, 1566722168210, 28074, 316, true
15284, 1566722167894, 27758, 1566722168201, 28065, 307, true
15285, 1566722167895, 27759, 1566722168213, 28077, 318, true
15286, 1566722167895, 27759, 1566722168203, 28067, 308, true
15287, 1566722167895, 27759, 1566722168203, 28067, 308, true
15288, 1566722167895, 27759, 1566722168199, 28063, 304, true
15289, 1566722167896, 27760, 1566722168217, 28081, 321, true
15290, 1566722167896, 27760, 1566722168295, 28159, 399, true
15291, 1566722167896, 27760, 1566722168191, 28055, 295, true
15292, 1566722167897, 27761, 1566722168199, 28063, 302, true
15293, 1566722167898, 27762, 1566722168212, 28076, 314, true
15294, 1566722167899, 27763, 1566722168204, 28068, 305, true
15295, 1566722167899, 27763, 1566722168233, 28097, 334, true
15296, 1566722167900, 27764, 1566722168220, 28084, 320, true
15297, 1566722167900, 27764, 1566722168220, 28084, 320, true
15298, 1566722167901, 27765, 1566722168220, 28084, 319, true
15299, 1566722167901, 27765, 1566722168220, 28084, 319, true
15300, 1566722167901, 27765, 1566722168230, 28094, 329, true
15301, 1566722167902, 27766, 1566722168220, 28084, 318, true
15302, 1566722167902, 27766, 1566722168229, 28093, 327, true
15303, 1566722167903, 27767, 1566722168232, 28096, 329, true
15304, 1566722167904, 27768, 1566722168233, 28097, 329, true
15305, 1566722167905, 27769, 1566722168234, 28098, 329, true
15306, 1566722167905, 27769, 1566722168230, 28094, 325, true
15307, 1566722167906, 27770, 1566722168231, 28095, 325, true
15308, 1566722167907, 27771, 1566722168230, 28094, 323, true
15309, 1566722167907, 27771, 1566722168233, 28097, 326, true
15310, 1566722167908, 27772, 1566722168233, 28097, 325, true
15311, 1566722167909, 27773, 1566722168231, 28095, 322, true
15312, 1566722167909, 27773, 1566722168231, 28095, 322, true
15313, 1566722167910, 27774, 1566722168232, 28096, 322, true
15314, 1566722167910, 27774, 1566722168231, 28095, 321, true
15315, 1566722167910, 27774, 1566722168230, 28094, 320, true
15316, 1566722167910, 27774, 1566722168230, 28094, 320, true
15317, 1566722167911, 27775, 1566722168220, 28084, 309, true
15318, 1566722167911, 27775, 1566722168220, 28084, 309, true
15319, 1566722167912, 27776, 1566722168233, 28097, 321, true
15320, 1566722167912, 27776, 1566722168230, 28094, 318, true
15321, 1566722167912, 27776, 1566722168232, 28096, 320, true
15322, 1566722167913, 27777, 1566722168231, 28095, 318, true
15323, 1566722167914, 27778, 1566722168233, 28097, 319, true
15324, 1566722167915, 27779, 1566722168233, 28097, 318, true
15325, 1566722167916, 27780, 1566722168233, 28097, 317, true
15326, 1566722167916, 27780, 1566722168232, 28096, 316, true
15327, 1566722167916, 27780, 1566722168230, 28094, 314, true
15328, 1566722167917, 27781, 1566722168232, 28096, 315, true
15329, 1566722167917, 27781, 1566722168231, 28095, 314, true
15330, 1566722167917, 27781, 1566722168231, 28095, 314, true
15331, 1566722167918, 27782, 1566722168234, 28098, 316, true
15332, 1566722167919, 27783, 1566722168234, 28098, 315, true
15333, 1566722167919, 27783, 1566722168231, 28095, 312, true
15334, 1566722167919, 27783, 1566722168232, 28096, 313, true
15335, 1566722167922, 27786, 1566722168231, 28095, 309, true
15336, 1566722167923, 27787, 1566722168230, 28094, 307, true
15337, 1566722167926, 27790, 1566722168232, 28096, 306, true
15338, 1566722167928, 27792, 1566722168220, 28084, 292, true
15339, 1566722167985, 27849, 1566722168234, 28098, 249, true
15340, 1566722167985, 27849, 1566722168233, 28097, 248, true
15341, 1566722167986, 27850, 1566722168233, 28097, 247, true
15342, 1566722167987, 27851, 1566722168234, 28098, 247, true
15343, 1566722167988, 27852, 1566722168234, 28098, 246, true
15344, 1566722167990, 27854, 1566722168234, 28098, 244, true
15345, 1566722167992, 27856, 1566722168234, 28098, 242, true
15346, 1566722167994, 27858, 1566722168234, 28098, 240, true
15347, 1566722167996, 27860, 1566722168234, 28098, 238, true
15348, 1566722168000, 27864, 1566722168235, 28099, 235, true
15349, 1566722168001, 27865, 1566722168235, 28099, 234, true
15350, 1566722168002, 27866, 1566722168235, 28099, 233, true
15351, 1566722168004, 27868, 1566722168235, 28099, 231, true
15352, 1566722168006, 27870, 1566722168235, 28099, 229, true
15353, 1566722168009, 27873, 1566722168235, 28099, 226, true
15354, 1566722168011, 27875, 1566722168235, 28099, 224, true
15355, 1566722168013, 27877, 1566722168235, 28099, 222, true
15356, 1566722168015, 27879, 1566722168235, 28099, 220, true
15357, 1566722168018, 27882, 1566722168235, 28099, 217, true
15358, 1566722168020, 27884, 1566722168236, 28100, 216, true
15359, 1566722168022, 27886, 1566722168236, 28100, 214, true
15360, 1566722168026, 27890, 1566722168236, 28100, 210, true
15361, 1566722168035, 27899, 1566722168259, 28123, 224, true
15362, 1566722168035, 27899, 1566722168262, 28126, 227, true
15363, 1566722168035, 27899, 1566722168265, 28129, 230, true
15364, 1566722168036, 27900, 1566722168263, 28127, 227, true
15365, 1566722168037, 27901, 1566722168265, 28129, 228, true
15366, 1566722168038, 27902, 1566722168258, 28122, 220, true
15367, 1566722168039, 27903, 1566722168262, 28126, 223, true
15368, 1566722168039, 27903, 1566722168264, 28128, 225, true
15369, 1566722168047, 27911, 1566722168259, 28123, 212, true
15370, 1566722168047, 27911, 1566722168260, 28124, 213, true
15371, 1566722168047, 27911, 1566722168266, 28130, 219, true
15372, 1566722168048, 27912, 1566722168265, 28129, 217, true
15373, 1566722168048, 27912, 1566722168258, 28122, 210, true
15374, 1566722168049, 27913, 1566722168269, 28133, 220, true
15375, 1566722168049, 27913, 1566722168270, 28134, 221, true
15376, 1566722168051, 27915, 1566722168270, 28134, 219, true
15377, 1566722168052, 27916, 1566722168265, 28129, 213, true
15378, 1566722168064, 27928, 1566722168269, 28133, 205, true
15379, 1566722168064, 27928, 1566722168270, 28134, 206, true
15380, 1566722168065, 27929, 1566722168277, 28141, 212, true
15381, 1566722168072, 27936, 1566722168280, 28144, 208, true
15382, 1566722168074, 27938, 1566722168342, 28206, 268, true
15383, 1566722168075, 27939, 1566722168342, 28206, 267, true
15384, 1566722168075, 27939, 1566722168342, 28206, 267, true
15385, 1566722168076, 27940, 1566722168342, 28206, 266, true
15386, 1566722168077, 27941, 1566722168342, 28206, 265, true
15387, 1566722168081, 27945, 1566722168346, 28210, 265, true
15388, 1566722168087, 27951, 1566722168343, 28207, 256, true
15389, 1566722168088, 27952, 1566722168346, 28210, 258, true
15390, 1566722168089, 27953, 1566722168346, 28210, 257, true
15391, 1566722168090, 27954, 1566722168347, 28211, 257, true
15392, 1566722168091, 27955, 1566722168346, 28210, 255, true
15393, 1566722168092, 27956, 1566722168343, 28207, 251, true
15394, 1566722168093, 27957, 1566722168342, 28206, 249, true
15395, 1566722168097, 27961, 1566722168346, 28210, 249, true
15396, 1566722168097, 27961, 1566722168473, 28337, 376, true
15397, 1566722168098, 27962, 1566722168439, 28303, 341, true
15398, 1566722168098, 27962, 1566722168473, 28337, 375, true
15399, 1566722168099, 27963, 1566722168481, 28345, 382, true
15400, 1566722168099, 27963, 1566722168515, 28379, 416, true
15401, 1566722168100, 27964, 1566722168478, 28342, 378, true
15402, 1566722168100, 27964, 1566722168502, 28366, 402, true
15403, 1566722168100, 27964, 1566722168470, 28334, 370, true
15404, 1566722168101, 27965, 1566722168483, 28347, 382, true
15405, 1566722168102, 27966, 1566722168454, 28318, 352, true
15406, 1566722168102, 27966, 1566722168519, 28383, 417, true
15407, 1566722168102, 27966, 1566722168480, 28344, 378, true
15408, 1566722168103, 27967, 1566722168515, 28379, 412, true
15409, 1566722168103, 27967, 1566722168474, 28338, 371, true
15410, 1566722168103, 27967, 1566722168472, 28336, 369, true
15411, 1566722168104, 27968, 1566722168469, 28333, 365, true
15412, 1566722168104, 27968, 1566722168475, 28339, 371, true
15413, 1566722168104, 27968, 1566722168505, 28369, 401, true
15414, 1566722168105, 27969, 1566722168515, 28379, 410, true
15415, 1566722168105, 27969, 1566722168521, 28385, 416, true
15416, 1566722168106, 27970, 1566722168474, 28338, 368, true
15417, 1566722168106, 27970, 1566722168515, 28379, 409, true
15418, 1566722168106, 27970, 1566722168520, 28384, 414, true
15419, 1566722168107, 27971, 1566722168463, 28327, 356, true
15420, 1566722168107, 27971, 1566722168458, 28322, 351, true
15421, 1566722168107, 27971, 1566722168468, 28332, 361, true
15422, 1566722168107, 27971, 1566722168467, 28331, 360, true
15423, 1566722168108, 27972, 1566722168454, 28318, 346, true
15424, 1566722168109, 27973, 1566722168454, 28318, 345, true
15425, 1566722168109, 27973, 1566722168470, 28334, 361, true
15426, 1566722168109, 27973, 1566722168454, 28318, 345, true
15427, 1566722168110, 27974, 1566722168506, 28370, 396, true
15428, 1566722168110, 27974, 1566722168454, 28318, 344, true
15429, 1566722168110, 27974, 1566722168515, 28379, 405, true
15430, 1566722168111, 27975, 1566722168485, 28349, 374, true
15431, 1566722168111, 27975, 1566722168454, 28318, 343, true
15432, 1566722168111, 27975, 1566722168485, 28349, 374, true
15433, 1566722168112, 27976, 1566722168514, 28378, 402, true
15434, 1566722168112, 27976, 1566722168472, 28336, 360, true
15435, 1566722168113, 27977, 1566722168455, 28319, 342, true
15436, 1566722168113, 27977, 1566722168501, 28365, 388, true
15437, 1566722168114, 27978, 1566722168478, 28342, 364, true
15438, 1566722168114, 27978, 1566722168455, 28319, 341, true
15439, 1566722168115, 27979, 1566722168486, 28350, 371, true
15440, 1566722168115, 27979, 1566722168454, 28318, 339, true
15441, 1566722168115, 27979, 1566722168468, 28332, 353, true
15442, 1566722168115, 27979, 1566722168501, 28365, 386, true
15443, 1566722168116, 27980, 1566722168503, 28367, 387, true
15444, 1566722168116, 27980, 1566722168484, 28348, 368, true
15445, 1566722168117, 27981, 1566722168521, 28385, 404, true
15446, 1566722168117, 27981, 1566722168472, 28336, 355, true
15447, 1566722168117, 27981, 1566722168515, 28379, 398, true
15448, 1566722168118, 27982, 1566722168514, 28378, 396, true
15449, 1566722168118, 27982, 1566722168471, 28335, 353, true
15450, 1566722168118, 27982, 1566722168515, 28379, 397, true
15451, 1566722168118, 27982, 1566722168502, 28366, 384, true
15452, 1566722168119, 27983, 1566722168515, 28379, 396, true
15453, 1566722168119, 27983, 1566722168515, 28379, 396, true
15454, 1566722168120, 27984, 1566722168481, 28345, 361, true
15455, 1566722168120, 27984, 1566722168487, 28351, 367, true
15456, 1566722168121, 27985, 1566722168475, 28339, 354, true
15457, 1566722168121, 27985, 1566722168489, 28353, 368, true
15458, 1566722168121, 27985, 1566722168470, 28334, 349, true
15459, 1566722168122, 27986, 1566722168515, 28379, 393, true
15460, 1566722168122, 27986, 1566722168515, 28379, 393, true
15461, 1566722168122, 27986, 1566722168514, 28378, 392, true
15462, 1566722168122, 27986, 1566722168484, 28348, 362, true
15463, 1566722168123, 27987, 1566722168520, 28384, 397, true
15464, 1566722168123, 27987, 1566722168454, 28318, 331, true
15465, 1566722168123, 27987, 1566722168502, 28366, 379, true
15466, 1566722168124, 27988, 1566722168485, 28349, 361, true
15467, 1566722168124, 27988, 1566722168514, 28378, 390, true
15468, 1566722168124, 27988, 1566722168468, 28332, 344, true
15469, 1566722168125, 27989, 1566722168467, 28331, 342, true
15470, 1566722168125, 27989, 1566722168712, 28576, 587, true
15471, 1566722168125, 27989, 1566722168721, 28585, 596, true
15472, 1566722168126, 27990, 1566722168711, 28575, 585, true
15473, 1566722168126, 27990, 1566722168554, 28418, 428, true
15474, 1566722168127, 27991, 1566722168552, 28416, 425, true
15475, 1566722168127, 27991, 1566722168534, 28398, 407, true
15476, 1566722168127, 27991, 1566722168712, 28576, 585, true
15477, 1566722168128, 27992, 1566722168712, 28576, 584, true
15478, 1566722168128, 27992, 1566722168711, 28575, 583, true
15479, 1566722168129, 27993, 1566722168553, 28417, 424, true
15480, 1566722168129, 27993, 1566722168713, 28577, 584, true
15481, 1566722168129, 27993, 1566722168711, 28575, 582, true
15482, 1566722168130, 27994, 1566722168721, 28585, 591, true
15483, 1566722168131, 27995, 1566722168721, 28585, 590, true
15484, 1566722168131, 27995, 1566722168566, 28430, 435, true
15485, 1566722168131, 27995, 1566722168553, 28417, 422, true
15486, 1566722168132, 27996, 1566722168712, 28576, 580, true
15487, 1566722168133, 27997, 1566722168535, 28399, 402, true
15488, 1566722168133, 27997, 1566722168713, 28577, 580, true
15489, 1566722168134, 27998, 1566722168721, 28585, 587, true
15490, 1566722168134, 27998, 1566722168560, 28424, 426, true
15491, 1566722168134, 27998, 1566722168570, 28434, 436, true
15492, 1566722168135, 27999, 1566722168565, 28429, 430, true
15493, 1566722168135, 27999, 1566722168554, 28418, 419, true
15494, 1566722168136, 28000, 1566722168711, 28575, 575, true
15495, 1566722168137, 28001, 1566722168711, 28575, 574, true
15496, 1566722168137, 28001, 1566722168560, 28424, 423, true
15497, 1566722168137, 28001, 1566722168553, 28417, 416, true
15498, 1566722168138, 28002, 1566722168570, 28434, 432, true
15499, 1566722168138, 28002, 1566722168720, 28584, 582, true
15500, 1566722168138, 28002, 1566722168554, 28418, 416, true
15501, 1566722168139, 28003, 1566722168712, 28576, 573, true
15502, 1566722168139, 28003, 1566722168566, 28430, 427, true
15503, 1566722168140, 28004, 1566722168566, 28430, 426, true
15504, 1566722168140, 28004, 1566722168553, 28417, 413, true
15505, 1566722168140, 28004, 1566722168565, 28429, 425, true
15506, 1566722168141, 28005, 1566722168713, 28577, 572, true
15507, 1566722168141, 28005, 1566722168559, 28423, 418, true
15508, 1566722168141, 28005, 1566722168680, 28544, 539, true
15509, 1566722168142, 28006, 1566722168553, 28417, 411, true
15510, 1566722168142, 28006, 1566722168712, 28576, 570, true
15511, 1566722168143, 28007, 1566722168722, 28586, 579, true
15512, 1566722168143, 28007, 1566722168570, 28434, 427, true
15513, 1566722168144, 28008, 1566722168553, 28417, 409, true
15514, 1566722168145, 28009, 1566722168676, 28540, 531, true
15515, 1566722168146, 28010, 1566722168710, 28574, 564, true
15516, 1566722168147, 28011, 1566722168720, 28584, 573, true
15517, 1566722168148, 28012, 1566722168676, 28540, 528, true
15518, 1566722168148, 28012, 1566722168554, 28418, 406, true
15519, 1566722168149, 28013, 1566722168711, 28575, 562, true
15520, 1566722168149, 28013, 1566722168676, 28540, 527, true
15521, 1566722168149, 28013, 1566722168554, 28418, 405, true
15522, 1566722168150, 28014, 1566722168560, 28424, 410, true
15523, 1566722168150, 28014, 1566722168553, 28417, 403, true
15524, 1566722168151, 28015, 1566722168566, 28430, 415, true
15525, 1566722168151, 28015, 1566722168721, 28585, 570, true
15526, 1566722168151, 28015, 1566722168546, 28410, 395, true
15527, 1566722168152, 28016, 1566722168570, 28434, 418, true
15528, 1566722168152, 28016, 1566722168571, 28435, 419, true
15529, 1566722168153, 28017, 1566722168710, 28574, 557, true
15530, 1566722168153, 28017, 1566722168570, 28434, 417, true
15531, 1566722168154, 28018, 1566722168553, 28417, 399, true
15532, 1566722168155, 28019, 1566722168570, 28434, 415, true
15533, 1566722168155, 28019, 1566722168712, 28576, 557, true
15534, 1566722168156, 28020, 1566722168554, 28418, 398, true
15535, 1566722168156, 28020, 1566722168679, 28543, 523, true
15536, 1566722168157, 28021, 1566722168547, 28411, 390, true
15537, 1566722168158, 28022, 1566722168547, 28411, 389, true
15538, 1566722168158, 28022, 1566722168570, 28434, 412, true
15539, 1566722168159, 28023, 1566722168711, 28575, 552, true
15540, 1566722168159, 28023, 1566722168559, 28423, 400, true
15541, 1566722168160, 28024, 1566722168566, 28430, 406, true
15542, 1566722168160, 28024, 1566722168564, 28428, 404, true
15543, 1566722168161, 28025, 1566722168570, 28434, 409, true
15544, 1566722168161, 28025, 1566722168547, 28411, 386, true
15545, 1566722168162, 28026, 1566722168570, 28434, 408, true
15546, 1566722168162, 28026, 1566722168547, 28411, 385, true
15547, 1566722168163, 28027, 1566722168546, 28410, 383, true
15548, 1566722168163, 28027, 1566722168722, 28586, 559, true
15549, 1566722168163, 28027, 1566722168560, 28424, 397, true
15550, 1566722168164, 28028, 1566722168679, 28543, 515, true
15551, 1566722168164, 28028, 1566722168565, 28429, 401, true
15552, 1566722168165, 28029, 1566722168559, 28423, 394, true
15553, 1566722168165, 28029, 1566722168553, 28417, 388, true
15554, 1566722168165, 28029, 1566722168565, 28429, 400, true
15555, 1566722168165, 28029, 1566722168565, 28429, 400, true
15556, 1566722168166, 28030, 1566722168712, 28576, 546, true
15557, 1566722168166, 28030, 1566722168570, 28434, 404, true
15558, 1566722168166, 28030, 1566722168680, 28544, 514, true
15559, 1566722168167, 28031, 1566722168565, 28429, 398, true
15560, 1566722168167, 28031, 1566722168564, 28428, 397, true
15561, 1566722168167, 28031, 1566722168553, 28417, 386, true
15562, 1566722168168, 28032, 1566722168710, 28574, 542, true
15563, 1566722168168, 28032, 1566722168721, 28585, 553, true
15564, 1566722168169, 28033, 1566722168538, 28402, 369, true
15565, 1566722168170, 28034, 1566722168566, 28430, 396, true
15566, 1566722168171, 28035, 1566722168560, 28424, 389, true
15567, 1566722168172, 28036, 1566722168710, 28574, 538, true
15568, 1566722168173, 28037, 1566722168722, 28586, 549, true
15569, 1566722168174, 28038, 1566722168721, 28585, 547, true
15570, 1566722168275, 28139, 1566722168524, 28388, 249, true
15571, 1566722168284, 28148, 1566722168721, 28585, 437, true
15572, 1566722168285, 28149, 1566722168571, 28435, 286, true
15573, 1566722168285, 28149, 1566722168560, 28424, 275, true
15574, 1566722168285, 28149, 1566722168565, 28429, 280, true
15575, 1566722168286, 28150, 1566722168560, 28424, 274, true
15576, 1566722168286, 28150, 1566722168711, 28575, 425, true
15577, 1566722168287, 28151, 1566722168558, 28422, 271, true
15578, 1566722168287, 28151, 1566722168679, 28543, 392, true
15579, 1566722168287, 28151, 1566722168566, 28430, 279, true
15580, 1566722168288, 28152, 1566722168712, 28576, 424, true
15581, 1566722168288, 28152, 1566722168566, 28430, 278, true
15582, 1566722168289, 28153, 1566722168711, 28575, 422, true
15583, 1566722168289, 28153, 1566722168552, 28416, 263, true
15584, 1566722168289, 28153, 1566722168545, 28409, 256, true
15585, 1566722168290, 28154, 1566722168679, 28543, 389, true
15586, 1566722168290, 28154, 1566722168720, 28584, 430, true
15587, 1566722168290, 28154, 1566722168559, 28423, 269, true
15588, 1566722168291, 28155, 1566722168676, 28540, 385, true
15589, 1566722168291, 28155, 1566722168566, 28430, 275, true
15590, 1566722168291, 28155, 1566722168720, 28584, 429, true
15591, 1566722168292, 28156, 1566722168559, 28423, 267, true
15592, 1566722168292, 28156, 1566722168559, 28423, 267, true
15593, 1566722168292, 28156, 1566722168570, 28434, 278, true
15594, 1566722168293, 28157, 1566722168559, 28423, 266, true
15595, 1566722168293, 28157, 1566722168559, 28423, 266, true
15596, 1566722168293, 28157, 1566722168567, 28431, 274, true
15597, 1566722168294, 28158, 1566722168565, 28429, 271, true
15598, 1566722168294, 28158, 1566722168710, 28574, 416, true
15599, 1566722168294, 28158, 1566722168560, 28424, 266, true
15600, 1566722168369, 28233, 1566722168710, 28574, 341, true
15601, 1566722168369, 28233, 1566722168710, 28574, 341, true
15602, 1566722168369, 28233, 1566722168710, 28574, 341, true
15603, 1566722168370, 28234, 1566722168709, 28573, 339, true
15604, 1566722168370, 28234, 1566722168709, 28573, 339, true
15605, 1566722168371, 28235, 1566722168708, 28572, 337, true
15606, 1566722168372, 28236, 1566722168708, 28572, 336, true
15607, 1566722168373, 28237, 1566722168708, 28572, 335, true
15608, 1566722168374, 28238, 1566722168709, 28573, 335, true
15609, 1566722168376, 28240, 1566722168708, 28572, 332, true
15610, 1566722168377, 28241, 1566722168708, 28572, 331, true
15611, 1566722168378, 28242, 1566722168706, 28570, 328, true
15612, 1566722168380, 28244, 1566722168708, 28572, 328, true
15613, 1566722168382, 28246, 1566722168708, 28572, 326, true
15614, 1566722168388, 28252, 1566722168708, 28572, 320, true
15615, 1566722168388, 28252, 1566722168708, 28572, 320, true
15616, 1566722168388, 28252, 1566722168707, 28571, 319, true
15617, 1566722168389, 28253, 1566722168707, 28571, 318, true
15618, 1566722168391, 28255, 1566722168707, 28571, 316, true
15619, 1566722168393, 28257, 1566722168707, 28571, 314, true
15620, 1566722168394, 28258, 1566722168695, 28559, 301, true
15621, 1566722168396, 28260, 1566722168707, 28571, 311, true
15622, 1566722168398, 28262, 1566722168707, 28571, 309, true
15623, 1566722168402, 28266, 1566722168694, 28558, 292, true
15624, 1566722168404, 28268, 1566722168695, 28559, 291, true
15625, 1566722168406, 28270, 1566722168693, 28557, 287, true
15626, 1566722168407, 28271, 1566722168693, 28557, 286, true
15627, 1566722168409, 28273, 1566722168692, 28556, 283, true
15628, 1566722168411, 28275, 1566722168691, 28555, 280, true
15629, 1566722168413, 28277, 1566722168691, 28555, 278, true
15630, 1566722168414, 28278, 1566722168691, 28555, 277, true
15631, 1566722168416, 28280, 1566722168691, 28555, 275, true
15632, 1566722168418, 28282, 1566722168691, 28555, 273, true
15633, 1566722168420, 28284, 1566722168691, 28555, 271, true
15634, 1566722168420, 28284, 1566722168691, 28555, 271, true
15635, 1566722168420, 28284, 1566722168691, 28555, 271, true
15636, 1566722168422, 28286, 1566722168691, 28555, 269, true
15637, 1566722168423, 28287, 1566722168690, 28554, 267, true
15638, 1566722168424, 28288, 1566722168685, 28549, 261, true
15639, 1566722168425, 28289, 1566722168691, 28555, 266, true
15640, 1566722168426, 28290, 1566722168686, 28550, 260, true
15641, 1566722168428, 28292, 1566722168685, 28549, 257, true
15642, 1566722168429, 28293, 1566722168685, 28549, 256, true
15643, 1566722168430, 28294, 1566722168686, 28550, 256, true
15644, 1566722168431, 28295, 1566722168691, 28555, 260, true
15645, 1566722168436, 28300, 1566722168682, 28546, 246, true
15646, 1566722168439, 28303, 1566722168682, 28546, 243, true
15647, 1566722168441, 28305, 1566722168685, 28549, 244, true
15648, 1566722168444, 28308, 1566722168681, 28545, 237, true
15649, 1566722168446, 28310, 1566722168797, 28661, 351, true
15650, 1566722168447, 28311, 1566722168681, 28545, 234, true
15651, 1566722168447, 28311, 1566722168797, 28661, 350, true
15652, 1566722168448, 28312, 1566722168781, 28645, 333, true
15653, 1566722168448, 28312, 1566722168795, 28659, 347, true
15654, 1566722168454, 28318, 1566722168821, 28685, 367, true
15655, 1566722168455, 28319, 1566722168680, 28544, 225, true
15656, 1566722168456, 28320, 1566722168722, 28586, 266, true
15657, 1566722168456, 28320, 1566722168831, 28695, 375, true
15658, 1566722168457, 28321, 1566722168831, 28695, 374, true
15659, 1566722168457, 28321, 1566722168831, 28695, 374, true
15660, 1566722168457, 28321, 1566722168831, 28695, 374, true
15661, 1566722168458, 28322, 1566722168722, 28586, 264, true
15662, 1566722168459, 28323, 1566722168722, 28586, 263, true
15663, 1566722168459, 28323, 1566722168830, 28694, 371, true
15664, 1566722168460, 28324, 1566722168831, 28695, 371, true
15665, 1566722168463, 28327, 1566722168807, 28671, 344, true
15666, 1566722168464, 28328, 1566722169014, 28878, 550, true
15667, 1566722168465, 28329, 1566722168722, 28586, 257, true
15668, 1566722168466, 28330, 1566722168971, 28835, 505, true
15669, 1566722168466, 28330, 1566722168971, 28835, 505, true
15670, 1566722168468, 28332, 1566722168826, 28690, 358, true
15671, 1566722168469, 28333, 1566722168831, 28695, 362, true
15672, 1566722168469, 28333, 1566722168721, 28585, 252, true
15673, 1566722168470, 28334, 1566722168970, 28834, 500, true
15674, 1566722168471, 28335, 1566722168722, 28586, 251, true
15675, 1566722168471, 28335, 1566722168971, 28835, 500, true
15676, 1566722168472, 28336, 1566722168987, 28851, 515, true
15677, 1566722168473, 28337, 1566722168798, 28662, 325, true
15678, 1566722168474, 28338, 1566722168831, 28695, 357, true
15679, 1566722168474, 28338, 1566722168710, 28574, 236, true
15680, 1566722168475, 28339, 1566722168971, 28835, 496, true
15681, 1566722168476, 28340, 1566722168721, 28585, 245, true
15682, 1566722168476, 28340, 1566722168831, 28695, 355, true
15683, 1566722168476, 28340, 1566722168831, 28695, 355, true
15684, 1566722168477, 28341, 1566722168722, 28586, 245, true
15685, 1566722168478, 28342, 1566722168826, 28690, 348, true
15686, 1566722168479, 28343, 1566722168722, 28586, 243, true
15687, 1566722168479, 28343, 1566722168833, 28697, 354, true
15688, 1566722168480, 28344, 1566722168972, 28836, 492, true
15689, 1566722168481, 28345, 1566722168832, 28696, 351, true
15690, 1566722168482, 28346, 1566722168971, 28835, 489, true
15691, 1566722168482, 28346, 1566722168834, 28698, 352, true
15692, 1566722168482, 28346, 1566722168792, 28656, 310, true
15693, 1566722168483, 28347, 1566722168723, 28587, 240, true
15694, 1566722168484, 28348, 1566722168723, 28587, 239, true
15695, 1566722168485, 28349, 1566722168723, 28587, 238, true
15696, 1566722168486, 28350, 1566722168836, 28700, 350, true
15697, 1566722168486, 28350, 1566722168972, 28836, 486, true
15698, 1566722168487, 28351, 1566722168972, 28836, 485, true
15699, 1566722168487, 28351, 1566722168723, 28587, 236, true
15700, 1566722168488, 28352, 1566722168797, 28661, 309, true
15701, 1566722168488, 28352, 1566722168723, 28587, 235, true
15702, 1566722168489, 28353, 1566722168723, 28587, 234, true
15703, 1566722168490, 28354, 1566722168972, 28836, 482, true
15704, 1566722168491, 28355, 1566722169012, 28876, 521, true
15705, 1566722168491, 28355, 1566722169012, 28876, 521, true
15706, 1566722168492, 28356, 1566722168723, 28587, 231, true
15707, 1566722168493, 28357, 1566722168972, 28836, 479, true
15708, 1566722168494, 28358, 1566722168973, 28837, 479, true
15709, 1566722168495, 28359, 1566722169012, 28876, 517, true
15710, 1566722168495, 28359, 1566722168723, 28587, 228, true
15711, 1566722168496, 28360, 1566722169012, 28876, 516, true
15712, 1566722168497, 28361, 1566722168791, 28655, 294, true
15713, 1566722168498, 28362, 1566722169012, 28876, 514, true
15714, 1566722168498, 28362, 1566722168723, 28587, 225, true
15715, 1566722168499, 28363, 1566722169013, 28877, 514, true
15716, 1566722168500, 28364, 1566722169012, 28876, 512, true
15717, 1566722168501, 28365, 1566722169013, 28877, 512, true
15718, 1566722168502, 28366, 1566722169013, 28877, 511, true
15719, 1566722168503, 28367, 1566722168794, 28658, 291, true
15720, 1566722168503, 28367, 1566722169012, 28876, 509, true
15721, 1566722168504, 28368, 1566722168723, 28587, 219, true
15722, 1566722168504, 28368, 1566722169012, 28876, 508, true
15723, 1566722168505, 28369, 1566722168727, 28591, 222, true
15724, 1566722168515, 28379, 1566722168730, 28594, 215, true
15725, 1566722168516, 28380, 1566722168973, 28837, 457, true
15726, 1566722168517, 28381, 1566722169011, 28875, 494, true
15727, 1566722168517, 28381, 1566722169013, 28877, 496, true
15728, 1566722168518, 28382, 1566722168733, 28597, 215, true
15729, 1566722168518, 28382, 1566722169013, 28877, 495, true
15730, 1566722168518, 28382, 1566722169013, 28877, 495, true
15731, 1566722168520, 28384, 1566722168792, 28656, 272, true
15732, 1566722168520, 28384, 1566722168737, 28601, 217, true
15733, 1566722168521, 28385, 1566722169011, 28875, 490, true
15734, 1566722168522, 28386, 1566722168741, 28605, 219, true
15735, 1566722168523, 28387, 1566722169011, 28875, 488, true
15736, 1566722168523, 28387, 1566722169013, 28877, 490, true
15737, 1566722168524, 28388, 1566722168972, 28836, 448, true
15738, 1566722168525, 28389, 1566722168746, 28610, 221, true
15739, 1566722168525, 28389, 1566722168778, 28642, 253, true
15740, 1566722168526, 28390, 1566722169013, 28877, 487, true
15741, 1566722168527, 28391, 1566722168785, 28649, 258, true
15742, 1566722168528, 28392, 1566722169013, 28877, 485, true
15743, 1566722168529, 28393, 1566722169013, 28877, 484, true
15744, 1566722168530, 28394, 1566722169013, 28877, 483, true
15745, 1566722168530, 28394, 1566722168789, 28653, 259, true
15746, 1566722168531, 28395, 1566722168787, 28651, 256, true
15747, 1566722168532, 28396, 1566722168793, 28657, 261, true
15748, 1566722168533, 28397, 1566722168786, 28650, 253, true
15749, 1566722168534, 28398, 1566722168793, 28657, 259, true
15750, 1566722168535, 28399, 1566722168792, 28656, 257, true
15751, 1566722168535, 28399, 1566722168797, 28661, 262, true
15752, 1566722168536, 28400, 1566722168795, 28659, 259, true
15753, 1566722168537, 28401, 1566722168795, 28659, 258, true
15754, 1566722168538, 28402, 1566722168793, 28657, 255, true
15755, 1566722168538, 28402, 1566722168781, 28645, 243, true
15756, 1566722168539, 28403, 1566722168777, 28641, 238, true
15757, 1566722168540, 28404, 1566722168797, 28661, 257, true
15758, 1566722168541, 28405, 1566722168824, 28688, 283, true
15759, 1566722168542, 28406, 1566722169012, 28876, 470, true
15760, 1566722168543, 28407, 1566722168802, 28666, 259, true
15761, 1566722168544, 28408, 1566722168828, 28692, 284, true
15762, 1566722168544, 28408, 1566722168970, 28834, 426, true
15763, 1566722168620, 28484, 1566722168825, 28689, 205, true
15764, 1566722168622, 28486, 1566722168827, 28691, 205, true
15765, 1566722168623, 28487, 1566722169014, 28878, 391, true
15766, 1566722168624, 28488, 1566722168831, 28695, 207, true
15767, 1566722168624, 28488, 1566722168831, 28695, 207, true
15768, 1566722168625, 28489, 1566722168831, 28695, 206, true
15769, 1566722168626, 28490, 1566722169014, 28878, 388, true
15770, 1566722168628, 28492, 1566722169014, 28878, 386, true
15771, 1566722168628, 28492, 1566722169014, 28878, 386, true
15772, 1566722168629, 28493, 1566722168973, 28837, 344, true
15773, 1566722168630, 28494, 1566722168973, 28837, 343, true
15774, 1566722168631, 28495, 1566722169014, 28878, 383, true
15775, 1566722168632, 28496, 1566722169014, 28878, 382, true
15776, 1566722168632, 28496, 1566722169014, 28878, 382, true
15777, 1566722168633, 28497, 1566722169014, 28878, 381, true
15778, 1566722168634, 28498, 1566722169014, 28878, 380, true
15779, 1566722168636, 28500, 1566722169015, 28879, 379, true
15780, 1566722168636, 28500, 1566722169015, 28879, 379, true
15781, 1566722168637, 28501, 1566722169015, 28879, 378, true
15782, 1566722168638, 28502, 1566722169015, 28879, 377, true
15783, 1566722168638, 28502, 1566722169015, 28879, 377, true
15784, 1566722168639, 28503, 1566722169015, 28879, 376, true
15785, 1566722168639, 28503, 1566722169015, 28879, 376, true
15786, 1566722168640, 28504, 1566722169015, 28879, 375, true
15787, 1566722168641, 28505, 1566722169015, 28879, 374, true
15788, 1566722168642, 28506, 1566722169015, 28879, 373, true
15789, 1566722168645, 28509, 1566722168999, 28863, 354, true
15790, 1566722168645, 28509, 1566722169015, 28879, 370, true
15791, 1566722168646, 28510, 1566722168999, 28863, 353, true
15792, 1566722168647, 28511, 1566722168998, 28862, 351, true
15793, 1566722168648, 28512, 1566722168999, 28863, 351, true
15794, 1566722168649, 28513, 1566722168996, 28860, 347, true
15795, 1566722168651, 28515, 1566722168995, 28859, 344, true
15796, 1566722168651, 28515, 1566722168996, 28860, 345, true
15797, 1566722168651, 28515, 1566722168998, 28862, 347, true
15798, 1566722168653, 28517, 1566722168997, 28861, 344, true
15799, 1566722168654, 28518, 1566722168994, 28858, 340, true
15800, 1566722168655, 28519, 1566722168993, 28857, 338, true
15801, 1566722168655, 28519, 1566722168993, 28857, 338, true
15802, 1566722168655, 28519, 1566722168993, 28857, 338, true
15803, 1566722168656, 28520, 1566722168992, 28856, 336, true
15804, 1566722168657, 28521, 1566722168991, 28855, 334, true
15805, 1566722168657, 28521, 1566722168991, 28855, 334, true
15806, 1566722168658, 28522, 1566722168991, 28855, 333, true
15807, 1566722168659, 28523, 1566722168991, 28855, 332, true
15808, 1566722168660, 28524, 1566722168991, 28855, 331, true
15809, 1566722168661, 28525, 1566722168990, 28854, 329, true
15810, 1566722168663, 28527, 1566722168990, 28854, 327, true
15811, 1566722168664, 28528, 1566722168990, 28854, 326, true
15812, 1566722168665, 28529, 1566722168990, 28854, 325, true
15813, 1566722168665, 28529, 1566722168989, 28853, 324, true
15814, 1566722168666, 28530, 1566722168989, 28853, 323, true
15815, 1566722168668, 28532, 1566722168988, 28852, 320, true
15816, 1566722168668, 28532, 1566722168987, 28851, 319, true
15817, 1566722168669, 28533, 1566722168987, 28851, 318, true
15818, 1566722168671, 28535, 1566722168987, 28851, 316, true
15819, 1566722168672, 28536, 1566722169088, 28952, 416, true
15820, 1566722168673, 28537, 1566722169088, 28952, 415, true
15821, 1566722168749, 28613, 1566722169088, 28952, 339, true
15822, 1566722168749, 28613, 1566722169085, 28949, 336, true
15823, 1566722168749, 28613, 1566722169088, 28952, 339, true
15824, 1566722168760, 28624, 1566722169085, 28949, 325, true
15825, 1566722168762, 28626, 1566722169084, 28948, 322, true
15826, 1566722168764, 28628, 1566722169085, 28949, 321, true
15827, 1566722168766, 28630, 1566722169085, 28949, 319, true
15828, 1566722168767, 28631, 1566722169084, 28948, 317, true
15829, 1566722168769, 28633, 1566722169084, 28948, 315, true
15830, 1566722168771, 28635, 1566722169084, 28948, 313, true
15831, 1566722168773, 28637, 1566722169084, 28948, 311, true
15832, 1566722168775, 28639, 1566722169083, 28947, 308, true
15833, 1566722168777, 28641, 1566722169083, 28947, 306, true
15834, 1566722168779, 28643, 1566722169083, 28947, 304, true
15835, 1566722168781, 28645, 1566722169083, 28947, 302, true
15836, 1566722168782, 28646, 1566722169083, 28947, 301, true
15837, 1566722168783, 28647, 1566722169082, 28946, 299, true
15838, 1566722168787, 28651, 1566722169083, 28947, 296, true
15839, 1566722168788, 28652, 1566722169082, 28946, 294, true
15840, 1566722168790, 28654, 1566722169082, 28946, 292, true
15841, 1566722168798, 28662, 1566722169082, 28946, 284, true
15842, 1566722168799, 28663, 1566722169078, 28942, 279, true
15843, 1566722168799, 28663, 1566722169078, 28942, 279, true
15844, 1566722168800, 28664, 1566722169078, 28942, 278, true
15845, 1566722168800, 28664, 1566722169221, 29085, 421, true
15846, 1566722168801, 28665, 1566722169078, 28942, 277, true
15847, 1566722168801, 28665, 1566722169077, 28941, 276, true
15848, 1566722168801, 28665, 1566722169221, 29085, 420, true
15849, 1566722168802, 28666, 1566722169077, 28941, 275, true
15850, 1566722168803, 28667, 1566722169078, 28942, 275, true
15851, 1566722168803, 28667, 1566722169077, 28941, 274, true
15852, 1566722168804, 28668, 1566722169077, 28941, 273, true
15853, 1566722168805, 28669, 1566722169271, 29135, 466, true
15854, 1566722168807, 28671, 1566722169251, 29115, 444, true
15855, 1566722168808, 28672, 1566722169238, 29102, 430, true
15856, 1566722168809, 28673, 1566722169276, 29140, 467, true
15857, 1566722168810, 28674, 1566722169258, 29122, 448, true
15858, 1566722168810, 28674, 1566722169267, 29131, 457, true
15859, 1566722168811, 28675, 1566722169257, 29121, 446, true
15860, 1566722168811, 28675, 1566722169238, 29102, 427, true
15861, 1566722168812, 28676, 1566722169260, 29124, 448, true
15862, 1566722168812, 28676, 1566722169256, 29120, 444, true
15863, 1566722168813, 28677, 1566722169235, 29099, 422, true
15864, 1566722168813, 28677, 1566722169235, 29099, 422, true
15865, 1566722168813, 28677, 1566722169261, 29125, 448, true
15866, 1566722168813, 28677, 1566722169241, 29105, 428, true
15867, 1566722168814, 28678, 1566722169257, 29121, 443, true
15868, 1566722168814, 28678, 1566722169239, 29103, 425, true
15869, 1566722168814, 28678, 1566722169256, 29120, 442, true
15870, 1566722168815, 28679, 1566722169253, 29117, 438, true
15871, 1566722168815, 28679, 1566722169253, 29117, 438, true
15872, 1566722168815, 28679, 1566722169276, 29140, 461, true
15873, 1566722168815, 28679, 1566722169252, 29116, 437, true
15874, 1566722168816, 28680, 1566722169238, 29102, 422, true
15875, 1566722168816, 28680, 1566722169255, 29119, 439, true
15876, 1566722168816, 28680, 1566722169273, 29137, 457, true
15877, 1566722168817, 28681, 1566722169262, 29126, 445, true
15878, 1566722168817, 28681, 1566722169241, 29105, 424, true
15879, 1566722168817, 28681, 1566722169254, 29118, 437, true
15880, 1566722168818, 28682, 1566722169236, 29100, 418, true
15881, 1566722168818, 28682, 1566722169254, 29118, 436, true
15882, 1566722168818, 28682, 1566722169261, 29125, 443, true
15883, 1566722168818, 28682, 1566722169263, 29127, 445, true
15884, 1566722168819, 28683, 1566722169242, 29106, 423, true
15885, 1566722168819, 28683, 1566722169253, 29117, 434, true
15886, 1566722168819, 28683, 1566722169273, 29137, 454, true
15887, 1566722168820, 28684, 1566722169258, 29122, 438, true
15888, 1566722168820, 28684, 1566722169244, 29108, 424, true
15889, 1566722168820, 28684, 1566722169255, 29119, 435, true
15890, 1566722168821, 28685, 1566722169262, 29126, 441, true
15891, 1566722168822, 28686, 1566722169243, 29107, 421, true
15892, 1566722168822, 28686, 1566722169274, 29138, 452, true
15893, 1566722168822, 28686, 1566722169236, 29100, 414, true
15894, 1566722168823, 28687, 1566722169222, 29086, 399, true
15895, 1566722168823, 28687, 1566722169261, 29125, 438, true
15896, 1566722168823, 28687, 1566722169258, 29122, 435, true
15897, 1566722168824, 28688, 1566722169235, 29099, 411, true
15898, 1566722168825, 28689, 1566722169232, 29096, 407, true
15899, 1566722168825, 28689, 1566722169232, 29096, 407, true
15900, 1566722168827, 28691, 1566722169222, 29086, 395, true
15901, 1566722168827, 28691, 1566722169259, 29123, 432, true
15902, 1566722168832, 28696, 1566722169264, 29128, 432, true
15903, 1566722168832, 28696, 1566722169241, 29105, 409, true
15904, 1566722168833, 28697, 1566722169258, 29122, 425, true
15905, 1566722168833, 28697, 1566722169234, 29098, 401, true
15906, 1566722168834, 28698, 1566722169254, 29118, 420, true
15907, 1566722168834, 28698, 1566722169253, 29117, 419, true
15908, 1566722168836, 28700, 1566722169255, 29119, 419, true
15909, 1566722168837, 28701, 1566722169253, 29117, 416, true
15910, 1566722168837, 28701, 1566722169243, 29107, 406, true
15911, 1566722168837, 28701, 1566722169239, 29103, 402, true
15912, 1566722168838, 28702, 1566722169259, 29123, 421, true
15913, 1566722168838, 28702, 1566722169236, 29100, 398, true
15914, 1566722168838, 28702, 1566722169243, 29107, 405, true
15915, 1566722168839, 28703, 1566722169244, 29108, 405, true
15916, 1566722168839, 28703, 1566722169276, 29140, 437, true
15917, 1566722168839, 28703, 1566722169273, 29137, 434, true
15918, 1566722168840, 28704, 1566722169238, 29102, 398, true
15919, 1566722168840, 28704, 1566722169274, 29138, 434, true
15920, 1566722168840, 28704, 1566722169237, 29101, 397, true
15921, 1566722168841, 28705, 1566722169242, 29106, 401, true
15922, 1566722168842, 28706, 1566722169239, 29103, 397, true
15923, 1566722168842, 28706, 1566722169238, 29102, 396, true
15924, 1566722168843, 28707, 1566722169260, 29124, 417, true
15925, 1566722168844, 28708, 1566722169236, 29100, 392, true
15926, 1566722168844, 28708, 1566722169275, 29139, 431, true
15927, 1566722168845, 28709, 1566722169262, 29126, 417, true
15928, 1566722168846, 28710, 1566722169259, 29123, 413, true
15929, 1566722168846, 28710, 1566722169243, 29107, 397, true
15930, 1566722168847, 28711, 1566722169266, 29130, 419, true
15931, 1566722168847, 28711, 1566722169259, 29123, 412, true
15932, 1566722168847, 28711, 1566722169237, 29101, 390, true
15933, 1566722168848, 28712, 1566722169263, 29127, 415, true
15934, 1566722168848, 28712, 1566722169275, 29139, 427, true
15935, 1566722168848, 28712, 1566722169254, 29118, 406, true
15936, 1566722168848, 28712, 1566722169241, 29105, 393, true
15937, 1566722168849, 28713, 1566722169235, 29099, 386, true
15938, 1566722168849, 28713, 1566722169241, 29105, 392, true
15939, 1566722168849, 28713, 1566722169255, 29119, 406, true
15940, 1566722168849, 28713, 1566722169240, 29104, 391, true
15941, 1566722168850, 28714, 1566722169278, 29142, 428, true
15942, 1566722168850, 28714, 1566722169267, 29131, 417, true
15943, 1566722168850, 28714, 1566722169256, 29120, 406, true
15944, 1566722168851, 28715, 1566722169255, 29119, 404, true
15945, 1566722168851, 28715, 1566722169235, 29099, 384, true
15946, 1566722168851, 28715, 1566722169254, 29118, 403, true
15947, 1566722168852, 28716, 1566722169274, 29138, 422, true
15948, 1566722168852, 28716, 1566722169238, 29102, 386, true
15949, 1566722168852, 28716, 1566722169267, 29131, 415, true
15950, 1566722168853, 28717, 1566722169273, 29137, 420, true
15951, 1566722168853, 28717, 1566722169256, 29120, 403, true
15952, 1566722168853, 28717, 1566722169263, 29127, 410, true
15953, 1566722168853, 28717, 1566722169236, 29100, 383, true
15954, 1566722168853, 28717, 1566722169277, 29141, 424, true
15955, 1566722168853, 28717, 1566722169263, 29127, 410, true
15956, 1566722168853, 28717, 1566722169274, 29138, 421, true
15957, 1566722168854, 28718, 1566722169259, 29123, 405, true
15958, 1566722168854, 28718, 1566722169275, 29139, 421, true
15959, 1566722168857, 28721, 1566722169278, 29142, 421, true
15960, 1566722168858, 28722, 1566722169262, 29126, 404, true
15961, 1566722168858, 28722, 1566722169262, 29126, 404, true
15962, 1566722168858, 28722, 1566722169294, 29158, 436, true
15963, 1566722168859, 28723, 1566722169282, 29146, 423, true
15964, 1566722168859, 28723, 1566722169280, 29144, 421, true
15965, 1566722168860, 28724, 1566722169293, 29157, 433, true
15966, 1566722168860, 28724, 1566722169294, 29158, 434, true
15967, 1566722168860, 28724, 1566722169279, 29143, 419, true
15968, 1566722168861, 28725, 1566722169275, 29139, 414, true
15969, 1566722168862, 28726, 1566722169294, 29158, 432, true
15970, 1566722168862, 28726, 1566722169294, 29158, 432, true
15971, 1566722168862, 28726, 1566722169292, 29156, 430, true
15972, 1566722168863, 28727, 1566722169292, 29156, 429, true
15973, 1566722168864, 28728, 1566722169292, 29156, 428, true
15974, 1566722168864, 28728, 1566722169293, 29157, 429, true
15975, 1566722168864, 28728, 1566722169292, 29156, 428, true
15976, 1566722168865, 28729, 1566722169293, 29157, 428, true
15977, 1566722168865, 28729, 1566722169284, 29148, 419, true
15978, 1566722168866, 28730, 1566722169293, 29157, 427, true
15979, 1566722168866, 28730, 1566722169281, 29145, 415, true
15980, 1566722168866, 28730, 1566722169279, 29143, 413, true
15981, 1566722168867, 28731, 1566722169278, 29142, 411, true
15982, 1566722168868, 28732, 1566722169281, 29145, 413, true
15983, 1566722168869, 28733, 1566722169300, 29164, 431, true
15984, 1566722168869, 28733, 1566722169300, 29164, 431, true
15985, 1566722168870, 28734, 1566722169295, 29159, 425, true
15986, 1566722168885, 28749, 1566722169292, 29156, 407, true
15987, 1566722168886, 28750, 1566722169293, 29157, 407, true
15988, 1566722168887, 28751, 1566722169281, 29145, 394, true
15989, 1566722168888, 28752, 1566722169285, 29149, 397, true
15990, 1566722168888, 28752, 1566722169291, 29155, 403, true
15991, 1566722168889, 28753, 1566722169293, 29157, 404, true
15992, 1566722168889, 28753, 1566722169294, 29158, 405, true
15993, 1566722168890, 28754, 1566722169280, 29144, 390, true
15994, 1566722168890, 28754, 1566722169285, 29149, 395, true
15995, 1566722168891, 28755, 1566722169292, 29156, 401, true
15996, 1566722168891, 28755, 1566722169293, 29157, 402, true
15997, 1566722168892, 28756, 1566722169282, 29146, 390, true
15998, 1566722168892, 28756, 1566722169292, 29156, 400, true
15999, 1566722168892, 28756, 1566722169279, 29143, 387, true
16000, 1566722168892, 28756, 1566722169292, 29156, 400, true
