ID, start, start-shifted, finish, finish-shifted, elapsed, succeeded
1, 1566721906208, 0, 1566721906568, 360, 360, true
2, 1566721906221, 13, 1566721906567, 359, 346, true
3, 1566721906221, 13, 1566721906570, 362, 349, true
4, 1566721906222, 14, 1566721906567, 359, 345, true
5, 1566721906225, 17, 1566721906566, 358, 341, true
6, 1566721906226, 18, 1566721906570, 362, 344, true
7, 1566721906227, 19, 1566721906571, 363, 344, true
8, 1566721906228, 20, 1566721906566, 358, 338, true
9, 1566721906228, 20, 1566721906572, 364, 344, true
10, 1566721906235, 27, 1566721906565, 357, 330, true
11, 1566721906235, 27, 1566721906571, 363, 336, true
12, 1566721906236, 28, 1566721906565, 357, 329, true
13, 1566721906237, 29, 1566721906565, 357, 328, true
14, 1566721906237, 29, 1566721906569, 361, 332, true
15, 1566721906349, 141, 1566721906572, 364, 223, true
16, 1566721906350, 142, 1566721906567, 359, 217, true
17, 1566721906353, 145, 1566721906566, 358, 213, true
18, 1566721906354, 146, 1566721906565, 357, 211, true
19, 1566721906373, 165, 1566721906579, 371, 206, true
20, 1566721906377, 169, 1566721906586, 378, 209, true
21, 1566721906379, 171, 1566721906586, 378, 207, true
22, 1566721906381, 173, 1566721906587, 379, 206, true
23, 1566721906385, 177, 1566721906596, 388, 211, true
24, 1566721906385, 177, 1566721906596, 388, 211, true
25, 1566721906388, 180, 1566721906597, 389, 209, true
26, 1566721906388, 180, 1566721906597, 389, 209, true
27, 1566721906390, 182, 1566721906597, 389, 207, true
28, 1566721906393, 185, 1566721906601, 393, 208, true
29, 1566721906395, 187, 1566721906602, 394, 207, true
30, 1566721906395, 187, 1566721906601, 393, 206, true
31, 1566721906398, 190, 1566721906609, 401, 211, true
32, 1566721906399, 191, 1566721906609, 401, 210, true
33, 1566721906401, 193, 1566721906693, 485, 292, true
34, 1566721906402, 194, 1566721906609, 401, 207, true
35, 1566721906404, 196, 1566721906610, 402, 206, true
36, 1566721906407, 199, 1566721906615, 407, 208, true
37, 1566721906407, 199, 1566721906615, 407, 208, true
38, 1566721906409, 201, 1566721906615, 407, 206, true
39, 1566721906410, 202, 1566721906615, 407, 205, true
40, 1566721906413, 205, 1566721906621, 413, 208, true
41, 1566721906413, 205, 1566721906621, 413, 208, true
42, 1566721906416, 208, 1566721906621, 413, 205, true
43, 1566721906416, 208, 1566721906621, 413, 205, true
44, 1566721906419, 211, 1566721906629, 421, 210, true
45, 1566721906422, 214, 1566721906629, 421, 207, true
46, 1566721906427, 219, 1566721906636, 428, 209, true
47, 1566721906430, 222, 1566721906637, 429, 207, true
48, 1566721906431, 223, 1566721906637, 429, 206, true
49, 1566721906434, 226, 1566721906643, 435, 209, true
50, 1566721906436, 228, 1566721906643, 435, 207, true
51, 1566721906439, 231, 1566721906646, 438, 207, true
52, 1566721906441, 233, 1566721906648, 440, 207, true
53, 1566721906444, 236, 1566721906654, 446, 210, true
54, 1566721906444, 236, 1566721906650, 442, 206, true
55, 1566721906447, 239, 1566721906655, 447, 208, true
56, 1566721906447, 239, 1566721906654, 446, 207, true
57, 1566721906449, 241, 1566721906658, 450, 209, true
58, 1566721906450, 242, 1566721906656, 448, 206, true
59, 1566721906451, 243, 1566721906659, 451, 208, true
60, 1566721906453, 245, 1566721906660, 452, 207, true
61, 1566721906453, 245, 1566721906659, 451, 206, true
62, 1566721906455, 247, 1566721906661, 453, 206, true
63, 1566721906455, 247, 1566721906661, 453, 206, true
64, 1566721906457, 249, 1566721906674, 466, 217, true
65, 1566721906458, 250, 1566721906675, 467, 217, true
66, 1566721906459, 251, 1566721906674, 466, 215, true
67, 1566721906460, 252, 1566721906674, 466, 214, true
68, 1566721906461, 253, 1566721906674, 466, 213, true
69, 1566721906462, 254, 1566721906675, 467, 213, true
70, 1566721906463, 255, 1566721906675, 467, 212, true
71, 1566721906465, 257, 1566721906675, 467, 210, true
72, 1566721906465, 257, 1566721906673, 465, 208, true
73, 1566721906466, 258, 1566721906674, 466, 208, true
74, 1566721906468, 260, 1566721906675, 467, 207, true
75, 1566721906468, 260, 1566721906675, 467, 207, true
76, 1566721906470, 262, 1566721906676, 468, 206, true
77, 1566721906471, 263, 1566721906682, 474, 211, true
78, 1566721906472, 264, 1566721906679, 471, 207, true
79, 1566721906474, 266, 1566721906682, 474, 208, true
80, 1566721906477, 269, 1566721906685, 477, 208, true
81, 1566721906479, 271, 1566721906684, 476, 205, true
82, 1566721906480, 272, 1566721906686, 478, 206, true
83, 1566721906482, 274, 1566721906688, 480, 206, true
84, 1566721906482, 274, 1566721906688, 480, 206, true
85, 1566721906484, 276, 1566721906689, 481, 205, true
86, 1566721906485, 277, 1566721906692, 484, 207, true
87, 1566721906486, 278, 1566721906692, 484, 206, true
88, 1566721906487, 279, 1566721906696, 488, 209, true
89, 1566721906488, 280, 1566721906697, 489, 209, true
90, 1566721906489, 281, 1566721906697, 489, 208, true
91, 1566721906490, 282, 1566721906696, 488, 206, true
92, 1566721906491, 283, 1566721906697, 489, 206, true
93, 1566721906493, 285, 1566721906705, 497, 212, true
94, 1566721906493, 285, 1566721906705, 497, 212, true
95, 1566721906495, 287, 1566721906705, 497, 210, true
96, 1566721906496, 288, 1566721906705, 497, 209, true
97, 1566721906497, 289, 1566721906705, 497, 208, true
98, 1566721906499, 291, 1566721906708, 500, 209, true
99, 1566721906499, 291, 1566721906708, 500, 209, true
100, 1566721906500, 292, 1566721906705, 497, 205, true
101, 1566721906502, 294, 1566721906708, 500, 206, true
102, 1566721906502, 294, 1566721906708, 500, 206, true
103, 1566721906504, 296, 1566721906710, 502, 206, true
104, 1566721906505, 297, 1566721906710, 502, 205, true
105, 1566721906506, 298, 1566721906711, 503, 205, true
106, 1566721906508, 300, 1566721906717, 509, 209, true
107, 1566721906508, 300, 1566721906716, 508, 208, true
108, 1566721906509, 301, 1566721906717, 509, 208, true
109, 1566721906511, 303, 1566721906718, 510, 207, true
110, 1566721906512, 304, 1566721906718, 510, 206, true
111, 1566721906514, 306, 1566721906722, 514, 208, true
112, 1566721906514, 306, 1566721906722, 514, 208, true
113, 1566721906516, 308, 1566721906726, 518, 210, true
114, 1566721906516, 308, 1566721906722, 514, 206, true
115, 1566721906518, 310, 1566721906723, 515, 205, true
116, 1566721906520, 312, 1566721906726, 518, 206, true
117, 1566721906520, 312, 1566721906725, 517, 205, true
118, 1566721906523, 315, 1566721906732, 524, 209, true
119, 1566721906525, 317, 1566721906733, 525, 208, true
120, 1566721906528, 320, 1566721906735, 527, 207, true
121, 1566721906532, 324, 1566721906740, 532, 208, true
122, 1566721906535, 327, 1566721906745, 537, 210, true
123, 1566721906536, 328, 1566721906745, 537, 209, true
124, 1566721906537, 329, 1566721906745, 537, 208, true
125, 1566721906538, 330, 1566721906745, 537, 207, true
126, 1566721906539, 331, 1566721906747, 539, 208, true
127, 1566721906540, 332, 1566721906747, 539, 207, true
128, 1566721906545, 337, 1566721906756, 548, 211, true
129, 1566721906557, 349, 1566721906764, 556, 207, true
130, 1566721906573, 365, 1566721906897, 689, 324, true
131, 1566721906573, 365, 1566721906791, 583, 218, true
132, 1566721906573, 365, 1566721906791, 583, 218, true
133, 1566721906575, 367, 1566721906791, 583, 216, true
134, 1566721906576, 368, 1566721906791, 583, 215, true
135, 1566721906576, 368, 1566721906791, 583, 215, true
136, 1566721906577, 369, 1566721906791, 583, 214, true
137, 1566721906580, 372, 1566721906792, 584, 212, true
138, 1566721906582, 374, 1566721906792, 584, 210, true
139, 1566721906582, 374, 1566721906792, 584, 210, true
140, 1566721906584, 376, 1566721906792, 584, 208, true
141, 1566721906588, 380, 1566721906795, 587, 207, true
142, 1566721906588, 380, 1566721906794, 586, 206, true
143, 1566721906589, 381, 1566721906794, 586, 205, true
144, 1566721906589, 381, 1566721906805, 597, 216, true
145, 1566721906590, 382, 1566721906806, 598, 216, true
146, 1566721906591, 383, 1566721906797, 589, 206, true
147, 1566721906593, 385, 1566721906806, 598, 213, true
148, 1566721906598, 390, 1566721906806, 598, 208, true
149, 1566721906602, 394, 1566721906816, 608, 214, true
150, 1566721906603, 395, 1566721906817, 609, 214, true
151, 1566721906603, 395, 1566721906813, 605, 210, true
152, 1566721906604, 396, 1566721906816, 608, 212, true
153, 1566721906604, 396, 1566721906809, 601, 205, true
154, 1566721906604, 396, 1566721906813, 605, 209, true
155, 1566721906605, 397, 1566721906815, 607, 210, true
156, 1566721906610, 402, 1566721906823, 615, 213, true
157, 1566721906611, 403, 1566721906823, 615, 212, true
158, 1566721906612, 404, 1566721906823, 615, 211, true
159, 1566721906616, 408, 1566721906823, 615, 207, true
160, 1566721906617, 409, 1566721906823, 615, 206, true
161, 1566721906617, 409, 1566721906825, 617, 208, true
162, 1566721906618, 410, 1566721906825, 617, 207, true
163, 1566721906622, 414, 1566721906828, 620, 206, true
164, 1566721906623, 415, 1566721906827, 619, 204, true
165, 1566721906623, 415, 1566721906828, 620, 205, true
166, 1566721906624, 416, 1566721906832, 624, 208, true
167, 1566721906625, 417, 1566721906836, 628, 211, true
168, 1566721906626, 418, 1566721906836, 628, 210, true
169, 1566721906630, 422, 1566721906843, 635, 213, true
170, 1566721906631, 423, 1566721906839, 631, 208, true
171, 1566721906631, 423, 1566721906845, 637, 214, true
172, 1566721906631, 423, 1566721906845, 637, 214, true
173, 1566721906632, 424, 1566721906845, 637, 213, true
174, 1566721906633, 425, 1566721906843, 635, 210, true
175, 1566721906637, 429, 1566721906842, 634, 205, true
176, 1566721906638, 430, 1566721906842, 634, 204, true
177, 1566721906640, 432, 1566721906849, 641, 209, true
178, 1566721906642, 434, 1566721906858, 650, 216, true
179, 1566721906644, 436, 1566721906853, 645, 209, true
180, 1566721906646, 438, 1566721906857, 649, 211, true
181, 1566721906648, 440, 1566721906858, 650, 210, true
182, 1566721906651, 443, 1566721906858, 650, 207, true
183, 1566721906656, 448, 1566721906865, 657, 209, true
184, 1566721906656, 448, 1566721906865, 657, 209, true
185, 1566721906663, 455, 1566721906873, 665, 210, true
186, 1566721906665, 457, 1566721906874, 666, 209, true
187, 1566721906665, 457, 1566721906873, 665, 208, true
188, 1566721906666, 458, 1566721906879, 671, 213, true
189, 1566721906667, 459, 1566721906884, 676, 217, true
190, 1566721906668, 460, 1566721906888, 680, 220, true
191, 1566721906668, 460, 1566721906889, 681, 221, true
192, 1566721906677, 469, 1566721906889, 681, 212, true
193, 1566721906683, 475, 1566721906891, 683, 208, true
194, 1566721906685, 477, 1566721906894, 686, 209, true
195, 1566721906687, 479, 1566721906894, 686, 207, true
196, 1566721906729, 521, 1566721906936, 728, 207, true
197, 1566721906738, 530, 1566721906942, 734, 204, true
198, 1566721906742, 534, 1566721906954, 746, 212, true
199, 1566721906759, 551, 1566721906966, 758, 207, true
200, 1566721906766, 558, 1566721906974, 766, 208, true
201, 1566721906768, 560, 1566721906975, 767, 207, true
202, 1566721906770, 562, 1566721906975, 767, 205, true
203, 1566721906772, 564, 1566721906975, 767, 203, true
204, 1566721906776, 568, 1566721906982, 774, 206, true
205, 1566721906778, 570, 1566721906988, 780, 210, true
206, 1566721906786, 578, 1566721906996, 788, 210, true
207, 1566721906802, 594, 1566721907008, 800, 206, true
208, 1566721906807, 599, 1566721907016, 808, 209, true
209, 1566721906809, 601, 1566721907015, 807, 206, true
210, 1566721906811, 603, 1566721907016, 808, 205, true
211, 1566721906814, 606, 1566721907023, 815, 209, true
212, 1566721906818, 610, 1566721907026, 818, 208, true
213, 1566721906818, 610, 1566721907026, 818, 208, true
214, 1566721906819, 611, 1566721907026, 818, 207, true
215, 1566721906819, 611, 1566721907026, 818, 207, true
216, 1566721906822, 614, 1566721907027, 819, 205, true
217, 1566721906826, 618, 1566721907032, 824, 206, true
218, 1566721906829, 621, 1566721907035, 827, 206, true
219, 1566721906829, 621, 1566721907035, 827, 206, true
220, 1566721906830, 622, 1566721907036, 828, 206, true
221, 1566721906832, 624, 1566721907041, 833, 209, true
222, 1566721906833, 625, 1566721907042, 834, 209, true
223, 1566721906833, 625, 1566721907041, 833, 208, true
224, 1566721906833, 625, 1566721907041, 833, 208, true
225, 1566721906834, 626, 1566721907041, 833, 207, true
226, 1566721906838, 630, 1566721907048, 840, 210, true
227, 1566721906838, 630, 1566721907044, 836, 206, true
228, 1566721906839, 631, 1566721907046, 838, 207, true
229, 1566721906846, 638, 1566721907052, 844, 206, true
230, 1566721906847, 639, 1566721907052, 844, 205, true
231, 1566721906849, 641, 1566721907055, 847, 206, true
232, 1566721906850, 642, 1566721907062, 854, 212, true
233, 1566721906850, 642, 1566721907057, 849, 207, true
234, 1566721906851, 643, 1566721907063, 855, 212, true
235, 1566721906853, 645, 1566721907062, 854, 209, true
236, 1566721906854, 646, 1566721907063, 855, 209, true
237, 1566721906859, 651, 1566721907066, 858, 207, true
238, 1566721906860, 652, 1566721907066, 858, 206, true
239, 1566721906861, 653, 1566721907066, 858, 205, true
240, 1566721906863, 655, 1566721907068, 860, 205, true
241, 1566721906863, 655, 1566721907070, 862, 207, true
242, 1566721906866, 658, 1566721907071, 863, 205, true
243, 1566721906867, 659, 1566721907075, 867, 208, true
244, 1566721906867, 659, 1566721907075, 867, 208, true
245, 1566721906868, 660, 1566721907075, 867, 207, true
246, 1566721906869, 661, 1566721907076, 868, 207, true
247, 1566721906871, 663, 1566721907078, 870, 207, true
248, 1566721906874, 666, 1566721907085, 877, 211, true
249, 1566721906875, 667, 1566721907085, 877, 210, true
250, 1566721906875, 667, 1566721907089, 881, 214, true
251, 1566721906876, 668, 1566721907086, 878, 210, true
252, 1566721906876, 668, 1566721907090, 882, 214, true
253, 1566721906877, 669, 1566721907090, 882, 213, true
254, 1566721906881, 673, 1566721907093, 885, 212, true
255, 1566721906881, 673, 1566721907093, 885, 212, true
256, 1566721906882, 674, 1566721907093, 885, 211, true
257, 1566721906885, 677, 1566721907094, 886, 209, true
258, 1566721906885, 677, 1566721907094, 886, 209, true
259, 1566721906887, 679, 1566721907094, 886, 207, true
260, 1566721906889, 681, 1566721907094, 886, 205, true
261, 1566721906892, 684, 1566721907097, 889, 205, true
262, 1566721906892, 684, 1566721907097, 889, 205, true
263, 1566721906895, 687, 1566721907107, 899, 212, true
264, 1566721906895, 687, 1566721907108, 900, 213, true
265, 1566721906896, 688, 1566721907107, 899, 211, true
266, 1566721906898, 690, 1566721907107, 899, 209, true
267, 1566721906899, 691, 1566721907108, 900, 209, true
268, 1566721906899, 691, 1566721907108, 900, 209, true
269, 1566721906900, 692, 1566721907109, 901, 209, true
270, 1566721906902, 694, 1566721907110, 902, 208, true
271, 1566721906903, 695, 1566721907110, 902, 207, true
272, 1566721906904, 696, 1566721907110, 902, 206, true
273, 1566721906906, 698, 1566721907110, 902, 204, true
274, 1566721906907, 699, 1566721907115, 907, 208, true
275, 1566721906908, 700, 1566721907114, 906, 206, true
276, 1566721906909, 701, 1566721907114, 906, 205, true
277, 1566721906910, 702, 1566721907116, 908, 206, true
278, 1566721906912, 704, 1566721907118, 910, 206, true
279, 1566721906913, 705, 1566721907118, 910, 205, true
280, 1566721906914, 706, 1566721907118, 910, 204, true
281, 1566721906915, 707, 1566721907123, 915, 208, true
282, 1566721906916, 708, 1566721907123, 915, 207, true
283, 1566721906917, 709, 1566721907124, 916, 207, true
284, 1566721906919, 711, 1566721907125, 917, 206, true
285, 1566721906919, 711, 1566721907125, 917, 206, true
286, 1566721906920, 712, 1566721907127, 919, 207, true
287, 1566721906922, 714, 1566721907127, 919, 205, true
288, 1566721906923, 715, 1566721907128, 920, 205, true
289, 1566721906925, 717, 1566721907133, 925, 208, true
290, 1566721906926, 718, 1566721907132, 924, 206, true
291, 1566721906927, 719, 1566721907136, 928, 209, true
292, 1566721906929, 721, 1566721907136, 928, 207, true
293, 1566721906929, 721, 1566721907136, 928, 207, true
294, 1566721906931, 723, 1566721907136, 928, 205, true
295, 1566721906932, 724, 1566721907136, 928, 204, true
296, 1566721906933, 725, 1566721907139, 931, 206, true
297, 1566721906934, 726, 1566721907139, 931, 205, true
298, 1566721906936, 728, 1566721907145, 937, 209, true
299, 1566721906937, 729, 1566721907142, 934, 205, true
300, 1566721906937, 729, 1566721907145, 937, 208, true
301, 1566721906940, 732, 1566721907145, 937, 205, true
302, 1566721906940, 732, 1566721907147, 939, 207, true
303, 1566721906942, 734, 1566721907147, 939, 205, true
304, 1566721906943, 735, 1566721907148, 940, 205, true
305, 1566721906945, 737, 1566721907154, 946, 209, true
306, 1566721906945, 737, 1566721907154, 946, 209, true
307, 1566721906946, 738, 1566721907154, 946, 208, true
308, 1566721906948, 740, 1566721907162, 954, 214, true
309, 1566721906949, 741, 1566721907160, 952, 211, true
310, 1566721906950, 742, 1566721907163, 955, 213, true
311, 1566721906950, 742, 1566721907160, 952, 210, true
312, 1566721906951, 743, 1566721907160, 952, 209, true
313, 1566721906952, 744, 1566721907160, 952, 208, true
314, 1566721906953, 745, 1566721907162, 954, 209, true
315, 1566721906957, 749, 1566721907163, 955, 206, true
316, 1566721906958, 750, 1566721907163, 955, 205, true
317, 1566721906959, 751, 1566721907166, 958, 207, true
318, 1566721906960, 752, 1566721907170, 962, 210, true
319, 1566721906961, 753, 1566721907170, 962, 209, true
320, 1566721906962, 754, 1566721907168, 960, 206, true
321, 1566721906962, 754, 1566721907168, 960, 206, true
322, 1566721906963, 755, 1566721907170, 962, 207, true
323, 1566721906967, 759, 1566721907175, 967, 208, true
324, 1566721906968, 760, 1566721907178, 970, 210, true
325, 1566721906970, 762, 1566721907179, 971, 209, true
326, 1566721906971, 763, 1566721907179, 971, 208, true
327, 1566721906976, 768, 1566721907180, 972, 204, true
328, 1566721906977, 769, 1566721907186, 978, 209, true
329, 1566721906978, 770, 1566721907196, 988, 218, true
330, 1566721906978, 770, 1566721907186, 978, 208, true
331, 1566721906979, 771, 1566721907194, 986, 215, true
332, 1566721906979, 771, 1566721907190, 982, 211, true
333, 1566721906980, 772, 1566721907190, 982, 210, true
334, 1566721906984, 776, 1566721907194, 986, 210, true
335, 1566721906984, 776, 1566721907196, 988, 212, true
336, 1566721906985, 777, 1566721907194, 986, 209, true
337, 1566721906985, 777, 1566721907195, 987, 210, true
338, 1566721906986, 778, 1566721907195, 987, 209, true
339, 1566721906988, 780, 1566721907195, 987, 207, true
340, 1566721906990, 782, 1566721907198, 990, 208, true
341, 1566721906991, 783, 1566721907199, 991, 208, true
342, 1566721906991, 783, 1566721907199, 991, 208, true
343, 1566721906993, 785, 1566721907199, 991, 206, true
344, 1566721906995, 787, 1566721907200, 992, 205, true
345, 1566721906997, 789, 1566721907200, 992, 203, true
346, 1566721906998, 790, 1566721907208, 1000, 210, true
347, 1566721906998, 790, 1566721907206, 998, 208, true
348, 1566721906999, 791, 1566721907208, 1000, 209, true
349, 1566721907001, 793, 1566721907206, 998, 205, true
350, 1566721907002, 794, 1566721907210, 1002, 208, true
351, 1566721907003, 795, 1566721907208, 1000, 205, true
352, 1566721907004, 796, 1566721907210, 1002, 206, true
353, 1566721907006, 798, 1566721907211, 1003, 205, true
354, 1566721907008, 800, 1566721907214, 1006, 206, true
355, 1566721907009, 801, 1566721907220, 1012, 211, true
356, 1566721907009, 801, 1566721907215, 1007, 206, true
357, 1566721907010, 802, 1566721907219, 1011, 209, true
358, 1566721907011, 803, 1566721907225, 1017, 214, true
359, 1566721907016, 808, 1566721907225, 1017, 209, true
360, 1566721907017, 809, 1566721907225, 1017, 208, true
361, 1566721907018, 810, 1566721907226, 1018, 208, true
362, 1566721907019, 811, 1566721907226, 1018, 207, true
363, 1566721907021, 813, 1566721907229, 1021, 208, true
364, 1566721907023, 815, 1566721907228, 1020, 205, true
365, 1566721907027, 819, 1566721907237, 1029, 210, true
366, 1566721907028, 820, 1566721907238, 1030, 210, true
367, 1566721907028, 820, 1566721907238, 1030, 210, true
368, 1566721907029, 821, 1566721907238, 1030, 209, true
369, 1566721907029, 821, 1566721907238, 1030, 209, true
370, 1566721907029, 821, 1566721907241, 1033, 212, true
371, 1566721907030, 822, 1566721907240, 1032, 210, true
372, 1566721907031, 823, 1566721907238, 1030, 207, true
373, 1566721907036, 828, 1566721907241, 1033, 205, true
374, 1566721907037, 829, 1566721907246, 1038, 209, true
375, 1566721907038, 830, 1566721907244, 1036, 206, true
376, 1566721907042, 834, 1566721907246, 1038, 204, true
377, 1566721907045, 837, 1566721907248, 1040, 203, true
378, 1566721907046, 838, 1566721907251, 1043, 205, true
379, 1566721907047, 839, 1566721907255, 1047, 208, true
380, 1566721907049, 841, 1566721907255, 1047, 206, true
381, 1566721907049, 841, 1566721907255, 1047, 206, true
382, 1566721907050, 842, 1566721907255, 1047, 205, true
383, 1566721907052, 844, 1566721907258, 1050, 206, true
384, 1566721907054, 846, 1566721907262, 1054, 208, true
385, 1566721907056, 848, 1566721907262, 1054, 206, true
386, 1566721907058, 850, 1566721907283, 1075, 225, true
387, 1566721907058, 850, 1566721907284, 1076, 226, true
388, 1566721907059, 851, 1566721907283, 1075, 224, true
389, 1566721907059, 851, 1566721907282, 1074, 223, true
390, 1566721907099, 891, 1566721907303, 1095, 204, true
391, 1566721907101, 893, 1566721907305, 1097, 204, true
392, 1566721907103, 895, 1566721907314, 1106, 211, true
393, 1566721907119, 911, 1566721907324, 1116, 205, true
394, 1566721907121, 913, 1566721907326, 1118, 205, true
395, 1566721907129, 921, 1566721907336, 1128, 207, true
396, 1566721907130, 922, 1566721907338, 1130, 208, true
397, 1566721907140, 932, 1566721907347, 1139, 207, true
398, 1566721907142, 934, 1566721907347, 1139, 205, true
399, 1566721907155, 947, 1566721907360, 1152, 205, true
400, 1566721907157, 949, 1566721907368, 1160, 211, true
401, 1566721907172, 964, 1566721907381, 1173, 209, true
402, 1566721907176, 968, 1566721907384, 1176, 208, true
403, 1566721907181, 973, 1566721907385, 1177, 204, true
404, 1566721907183, 975, 1566721907391, 1183, 208, true
405, 1566721907185, 977, 1566721907391, 1183, 206, true
406, 1566721907188, 980, 1566721907393, 1185, 205, true
407, 1566721907191, 983, 1566721907400, 1192, 209, true
408, 1566721907202, 994, 1566721907407, 1199, 205, true
409, 1566721907204, 996, 1566721907412, 1204, 208, true
410, 1566721907212, 1004, 1566721907416, 1208, 204, true
411, 1566721907216, 1008, 1566721907425, 1217, 209, true
412, 1566721907217, 1009, 1566721907425, 1217, 208, true
413, 1566721907221, 1013, 1566721907425, 1217, 204, true
414, 1566721907222, 1014, 1566721907429, 1221, 207, true
415, 1566721907229, 1021, 1566721907434, 1226, 205, true
416, 1566721907231, 1023, 1566721907436, 1228, 205, true
417, 1566721907233, 1025, 1566721907441, 1233, 208, true
418, 1566721907234, 1026, 1566721907441, 1233, 207, true
419, 1566721907235, 1027, 1566721907447, 1239, 212, true
420, 1566721907241, 1033, 1566721907452, 1244, 211, true
421, 1566721907242, 1034, 1566721907452, 1244, 210, true
422, 1566721907242, 1034, 1566721907454, 1246, 212, true
423, 1566721907242, 1034, 1566721907452, 1244, 210, true
424, 1566721907243, 1035, 1566721907461, 1253, 218, true
425, 1566721907243, 1035, 1566721907452, 1244, 209, true
426, 1566721907248, 1040, 1566721907454, 1246, 206, true
427, 1566721907249, 1041, 1566721907461, 1253, 212, true
428, 1566721907249, 1041, 1566721907457, 1249, 208, true
429, 1566721907250, 1042, 1566721907454, 1246, 204, true
430, 1566721907252, 1044, 1566721907461, 1253, 209, true
431, 1566721907257, 1049, 1566721907465, 1257, 208, true
432, 1566721907258, 1050, 1566721907469, 1261, 211, true
433, 1566721907259, 1051, 1566721907469, 1261, 210, true
434, 1566721907259, 1051, 1566721907465, 1257, 206, true
435, 1566721907259, 1051, 1566721907469, 1261, 210, true
436, 1566721907260, 1052, 1566721907469, 1261, 209, true
437, 1566721907260, 1052, 1566721907469, 1261, 209, true
438, 1566721907263, 1055, 1566721907469, 1261, 206, true
439, 1566721907264, 1056, 1566721907469, 1261, 205, true
440, 1566721907282, 1074, 1566721907488, 1280, 206, true
441, 1566721907284, 1076, 1566721907497, 1289, 213, true
442, 1566721907284, 1076, 1566721907488, 1280, 204, true
443, 1566721907286, 1078, 1566721907497, 1289, 211, true
444, 1566721907286, 1078, 1566721907497, 1289, 211, true
445, 1566721907287, 1079, 1566721907497, 1289, 210, true
446, 1566721907288, 1080, 1566721907498, 1290, 210, true
447, 1566721907290, 1082, 1566721907498, 1290, 208, true
448, 1566721907290, 1082, 1566721907498, 1290, 208, true
449, 1566721907292, 1084, 1566721907498, 1290, 206, true
450, 1566721907293, 1085, 1566721907499, 1291, 206, true
451, 1566721907295, 1087, 1566721907499, 1291, 204, true
452, 1566721907295, 1087, 1566721907500, 1292, 205, true
453, 1566721907296, 1088, 1566721907500, 1292, 204, true
454, 1566721907299, 1091, 1566721907506, 1298, 207, true
455, 1566721907301, 1093, 1566721907506, 1298, 205, true
456, 1566721907302, 1094, 1566721907507, 1299, 205, true
457, 1566721907304, 1096, 1566721907515, 1307, 211, true
458, 1566721907306, 1098, 1566721907515, 1307, 209, true
459, 1566721907307, 1099, 1566721907515, 1307, 208, true
460, 1566721907307, 1099, 1566721907516, 1308, 209, true
461, 1566721907308, 1100, 1566721907515, 1307, 207, true
462, 1566721907310, 1102, 1566721907515, 1307, 205, true
463, 1566721907311, 1103, 1566721907518, 1310, 207, true
464, 1566721907312, 1104, 1566721907526, 1318, 214, true
465, 1566721907313, 1105, 1566721907518, 1310, 205, true
466, 1566721907317, 1109, 1566721907526, 1318, 209, true
467, 1566721907317, 1109, 1566721907526, 1318, 209, true
468, 1566721907318, 1110, 1566721907527, 1319, 209, true
469, 1566721907319, 1111, 1566721907527, 1319, 208, true
470, 1566721907320, 1112, 1566721907527, 1319, 207, true
471, 1566721907321, 1113, 1566721907527, 1319, 206, true
472, 1566721907324, 1116, 1566721907529, 1321, 205, true
473, 1566721907325, 1117, 1566721907533, 1325, 208, true
474, 1566721907327, 1119, 1566721907533, 1325, 206, true
475, 1566721907327, 1119, 1566721907533, 1325, 206, true
476, 1566721907328, 1120, 1566721907536, 1328, 208, true
477, 1566721907329, 1121, 1566721907535, 1327, 206, true
478, 1566721907331, 1123, 1566721907535, 1327, 204, true
479, 1566721907332, 1124, 1566721907541, 1333, 209, true
480, 1566721907334, 1126, 1566721907543, 1335, 209, true
481, 1566721907334, 1126, 1566721907541, 1333, 207, true
482, 1566721907335, 1127, 1566721907543, 1335, 208, true
483, 1566721907339, 1131, 1566721907544, 1336, 205, true
484, 1566721907339, 1131, 1566721907543, 1335, 204, true
485, 1566721907340, 1132, 1566721907545, 1337, 205, true
486, 1566721907340, 1132, 1566721907545, 1337, 205, true
487, 1566721907342, 1134, 1566721907548, 1340, 206, true
488, 1566721907342, 1134, 1566721907547, 1339, 205, true
489, 1566721907344, 1136, 1566721907555, 1347, 211, true
490, 1566721907344, 1136, 1566721907554, 1346, 210, true
491, 1566721907347, 1139, 1566721907554, 1346, 207, true
492, 1566721907348, 1140, 1566721907553, 1345, 205, true
493, 1566721907349, 1141, 1566721907556, 1348, 207, true
494, 1566721907351, 1143, 1566721907557, 1349, 206, true
495, 1566721907351, 1143, 1566721907558, 1350, 207, true
496, 1566721907352, 1144, 1566721907557, 1349, 205, true
497, 1566721907355, 1147, 1566721907562, 1354, 207, true
498, 1566721907355, 1147, 1566721907562, 1354, 207, true
499, 1566721907356, 1148, 1566721907566, 1358, 210, true
500, 1566721907358, 1150, 1566721907566, 1358, 208, true
501, 1566721907360, 1152, 1566721907566, 1358, 206, true
502, 1566721907360, 1152, 1566721907564, 1356, 204, true
503, 1566721907362, 1154, 1566721907566, 1358, 204, true
504, 1566721907363, 1155, 1566721907569, 1361, 206, true
505, 1566721907364, 1156, 1566721907571, 1363, 207, true
506, 1566721907365, 1157, 1566721907574, 1366, 209, true
507, 1566721907367, 1159, 1566721907573, 1365, 206, true
508, 1566721907369, 1161, 1566721907574, 1366, 205, true
509, 1566721907369, 1161, 1566721907578, 1370, 209, true
510, 1566721907371, 1163, 1566721907578, 1370, 207, true
511, 1566721907373, 1165, 1566721907580, 1372, 207, true
512, 1566721907375, 1167, 1566721907582, 1374, 207, true
513, 1566721907377, 1169, 1566721907585, 1377, 208, true
514, 1566721907386, 1178, 1566721907591, 1383, 205, true
515, 1566721907388, 1180, 1566721907597, 1389, 209, true
516, 1566721907388, 1180, 1566721907598, 1390, 210, true
517, 1566721907393, 1185, 1566721907600, 1392, 207, true
518, 1566721907394, 1186, 1566721907600, 1392, 206, true
519, 1566721907395, 1187, 1566721907600, 1392, 205, true
520, 1566721907395, 1187, 1566721907600, 1392, 205, true
521, 1566721907396, 1188, 1566721907600, 1392, 204, true
522, 1566721907398, 1190, 1566721907605, 1397, 207, true
523, 1566721907398, 1190, 1566721907606, 1398, 208, true
524, 1566721907399, 1191, 1566721907605, 1397, 206, true
525, 1566721907401, 1193, 1566721907608, 1400, 207, true
526, 1566721907402, 1194, 1566721907608, 1400, 206, true
527, 1566721907403, 1195, 1566721907608, 1400, 205, true
528, 1566721907404, 1196, 1566721907619, 1411, 215, true
529, 1566721907406, 1198, 1566721907619, 1411, 213, true
530, 1566721907408, 1200, 1566721907619, 1411, 211, true
531, 1566721907409, 1201, 1566721907628, 1420, 219, true
532, 1566721907410, 1202, 1566721907620, 1412, 210, true
533, 1566721907411, 1203, 1566721907620, 1412, 209, true
534, 1566721907413, 1205, 1566721907628, 1420, 215, true
535, 1566721907414, 1206, 1566721907620, 1412, 206, true
536, 1566721907416, 1208, 1566721907628, 1420, 212, true
537, 1566721907417, 1209, 1566721907628, 1420, 211, true
538, 1566721907418, 1210, 1566721907628, 1420, 210, true
539, 1566721907419, 1211, 1566721907628, 1420, 209, true
540, 1566721907420, 1212, 1566721907628, 1420, 208, true
541, 1566721907421, 1213, 1566721907628, 1420, 207, true
542, 1566721907422, 1214, 1566721907628, 1420, 206, true
543, 1566721907426, 1218, 1566721907632, 1424, 206, true
544, 1566721907426, 1218, 1566721907631, 1423, 205, true
545, 1566721907427, 1219, 1566721907631, 1423, 204, true
546, 1566721907429, 1221, 1566721907636, 1428, 207, true
547, 1566721907430, 1222, 1566721907636, 1428, 206, true
548, 1566721907430, 1222, 1566721907638, 1430, 208, true
549, 1566721907431, 1223, 1566721907638, 1430, 207, true
550, 1566721907433, 1225, 1566721907642, 1434, 209, true
551, 1566721907436, 1228, 1566721907643, 1435, 207, true
552, 1566721907437, 1229, 1566721907642, 1434, 205, true
553, 1566721907438, 1230, 1566721907652, 1444, 214, true
554, 1566721907439, 1231, 1566721907652, 1444, 213, true
555, 1566721907441, 1233, 1566721907657, 1449, 216, true
556, 1566721907442, 1234, 1566721907654, 1446, 212, true
557, 1566721907442, 1234, 1566721907655, 1447, 213, true
558, 1566721907444, 1236, 1566721907656, 1448, 212, true
559, 1566721907447, 1239, 1566721907656, 1448, 209, true
560, 1566721907447, 1239, 1566721907657, 1449, 210, true
561, 1566721907449, 1241, 1566721907657, 1449, 208, true
562, 1566721907455, 1247, 1566721907660, 1452, 205, true
563, 1566721907456, 1248, 1566721907660, 1452, 204, true
564, 1566721907458, 1250, 1566721907664, 1456, 206, true
565, 1566721907458, 1250, 1566721907662, 1454, 204, true
566, 1566721907459, 1251, 1566721907668, 1460, 209, true
567, 1566721907462, 1254, 1566721907668, 1460, 206, true
568, 1566721907463, 1255, 1566721907668, 1460, 205, true
569, 1566721907465, 1257, 1566721907674, 1466, 209, true
570, 1566721907465, 1257, 1566721907674, 1466, 209, true
571, 1566721907471, 1263, 1566721907679, 1471, 208, true
572, 1566721907472, 1264, 1566721907680, 1472, 208, true
573, 1566721907472, 1264, 1566721907680, 1472, 208, true
574, 1566721907472, 1264, 1566721907679, 1471, 207, true
575, 1566721907473, 1265, 1566721907684, 1476, 211, true
576, 1566721907474, 1266, 1566721907684, 1476, 210, true
577, 1566721907476, 1268, 1566721907682, 1474, 206, true
578, 1566721907477, 1269, 1566721907690, 1482, 213, true
579, 1566721907478, 1270, 1566721907691, 1483, 213, true
580, 1566721907479, 1271, 1566721907690, 1482, 211, true
581, 1566721907480, 1272, 1566721907691, 1483, 211, true
582, 1566721907481, 1273, 1566721907691, 1483, 210, true
583, 1566721907485, 1277, 1566721907692, 1484, 207, true
584, 1566721907489, 1281, 1566721907693, 1485, 204, true
585, 1566721907492, 1284, 1566721907700, 1492, 208, true
586, 1566721907502, 1294, 1566721907707, 1499, 205, true
587, 1566721907504, 1296, 1566721907708, 1500, 204, true
588, 1566721907530, 1322, 1566721907737, 1529, 207, true
589, 1566721907531, 1323, 1566721907738, 1530, 207, true
590, 1566721907540, 1332, 1566721907746, 1538, 206, true
591, 1566721907548, 1340, 1566721907756, 1548, 208, true
592, 1566721907549, 1341, 1566721907756, 1548, 207, true
593, 1566721907550, 1342, 1566721907756, 1548, 206, true
594, 1566721907550, 1342, 1566721907757, 1549, 207, true
595, 1566721907552, 1344, 1566721907759, 1551, 207, true
596, 1566721907560, 1352, 1566721907767, 1559, 207, true
597, 1566721907563, 1355, 1566721907771, 1563, 208, true
598, 1566721907564, 1356, 1566721907779, 1571, 215, true
599, 1566721907567, 1359, 1566721907787, 1579, 220, true
600, 1566721907567, 1359, 1566721907783, 1575, 216, true
601, 1566721907568, 1360, 1566721907787, 1579, 219, true
602, 1566721907569, 1361, 1566721907779, 1571, 210, true
603, 1566721907570, 1362, 1566721907782, 1574, 212, true
604, 1566721907573, 1365, 1566721907783, 1575, 210, true
605, 1566721907574, 1366, 1566721907787, 1579, 213, true
606, 1566721907579, 1371, 1566721907787, 1579, 208, true
607, 1566721907580, 1372, 1566721907787, 1579, 207, true
608, 1566721907581, 1373, 1566721907787, 1579, 206, true
609, 1566721907584, 1376, 1566721907794, 1586, 210, true
610, 1566721907585, 1377, 1566721907794, 1586, 209, true
611, 1566721907586, 1378, 1566721907794, 1586, 208, true
612, 1566721907586, 1378, 1566721907793, 1585, 207, true
613, 1566721907586, 1378, 1566721907794, 1586, 208, true
614, 1566721907587, 1379, 1566721907794, 1586, 207, true
615, 1566721907591, 1383, 1566721907795, 1587, 204, true
616, 1566721907593, 1385, 1566721907800, 1592, 207, true
617, 1566721907595, 1387, 1566721907803, 1595, 208, true
618, 1566721907601, 1393, 1566721907804, 1596, 203, true
619, 1566721907602, 1394, 1566721907816, 1608, 214, true
620, 1566721907602, 1394, 1566721907816, 1608, 214, true
621, 1566721907602, 1394, 1566721907816, 1608, 214, true
622, 1566721907603, 1395, 1566721907816, 1608, 213, true
623, 1566721907603, 1395, 1566721907816, 1608, 213, true
624, 1566721907603, 1395, 1566721907810, 1602, 207, true
625, 1566721907606, 1398, 1566721907816, 1608, 210, true
626, 1566721907610, 1402, 1566721907816, 1608, 206, true
627, 1566721907611, 1403, 1566721907816, 1608, 205, true
628, 1566721907612, 1404, 1566721907818, 1610, 206, true
629, 1566721907613, 1405, 1566721907834, 1626, 221, true
630, 1566721907613, 1405, 1566721907828, 1620, 215, true
631, 1566721907621, 1413, 1566721907839, 1631, 218, true
632, 1566721907623, 1415, 1566721907840, 1632, 217, true
633, 1566721907624, 1416, 1566721907839, 1631, 215, true
634, 1566721907625, 1417, 1566721907835, 1627, 210, true
635, 1566721907629, 1421, 1566721907835, 1627, 206, true
636, 1566721907632, 1424, 1566721907841, 1633, 209, true
637, 1566721907633, 1425, 1566721907841, 1633, 208, true
638, 1566721907637, 1429, 1566721907848, 1640, 211, true
639, 1566721907639, 1431, 1566721907850, 1642, 211, true
640, 1566721907640, 1432, 1566721907847, 1639, 207, true
641, 1566721907640, 1432, 1566721907848, 1640, 208, true
642, 1566721907641, 1433, 1566721907850, 1642, 209, true
643, 1566721907643, 1435, 1566721907850, 1642, 207, true
644, 1566721907649, 1441, 1566721907865, 1657, 216, true
645, 1566721907658, 1450, 1566721907867, 1659, 209, true
646, 1566721907661, 1453, 1566721907867, 1659, 206, true
647, 1566721907662, 1454, 1566721907868, 1660, 206, true
648, 1566721907663, 1455, 1566721907871, 1663, 208, true
649, 1566721907665, 1457, 1566721907871, 1663, 206, true
650, 1566721907666, 1458, 1566721907877, 1669, 211, true
651, 1566721907669, 1461, 1566721907874, 1666, 205, true
652, 1566721907670, 1462, 1566721907880, 1672, 210, true
653, 1566721907671, 1463, 1566721907880, 1672, 209, true
654, 1566721907672, 1464, 1566721907880, 1672, 208, true
655, 1566721907675, 1467, 1566721907895, 1687, 220, true
656, 1566721907675, 1467, 1566721907894, 1686, 219, true
657, 1566721907675, 1467, 1566721907883, 1675, 208, true
658, 1566721907676, 1468, 1566721907909, 1701, 233, true
659, 1566721907676, 1468, 1566721907908, 1700, 232, true
660, 1566721907677, 1469, 1566721907909, 1701, 232, true
661, 1566721907680, 1472, 1566721907908, 1700, 228, true
662, 1566721907686, 1478, 1566721907909, 1701, 223, true
663, 1566721907687, 1479, 1566721907910, 1702, 223, true
664, 1566721907687, 1479, 1566721907909, 1701, 222, true
665, 1566721907688, 1480, 1566721907909, 1701, 221, true
666, 1566721907704, 1496, 1566721907910, 1702, 206, true
667, 1566721907705, 1497, 1566721907915, 1707, 210, true
668, 1566721907709, 1501, 1566721907916, 1708, 207, true
669, 1566721907710, 1502, 1566721907920, 1712, 210, true
670, 1566721907712, 1504, 1566721907920, 1712, 208, true
671, 1566721907713, 1505, 1566721907920, 1712, 207, true
672, 1566721907715, 1507, 1566721907921, 1713, 206, true
673, 1566721907716, 1508, 1566721907921, 1713, 205, true
674, 1566721907718, 1510, 1566721907926, 1718, 208, true
675, 1566721907720, 1512, 1566721907926, 1718, 206, true
676, 1566721907722, 1514, 1566721907931, 1723, 209, true
677, 1566721907724, 1516, 1566721907931, 1723, 207, true
678, 1566721907726, 1518, 1566721907933, 1725, 207, true
679, 1566721907729, 1521, 1566721907934, 1726, 205, true
680, 1566721907731, 1523, 1566721907934, 1726, 203, true
681, 1566721907733, 1525, 1566721907937, 1729, 204, true
682, 1566721907735, 1527, 1566721907939, 1731, 204, true
683, 1566721907739, 1531, 1566721907942, 1734, 203, true
684, 1566721907741, 1533, 1566721907948, 1740, 207, true
685, 1566721907742, 1534, 1566721907948, 1740, 206, true
686, 1566721907744, 1536, 1566721907949, 1741, 205, true
687, 1566721907747, 1539, 1566721907955, 1747, 208, true
688, 1566721907749, 1541, 1566721907955, 1747, 206, true
689, 1566721907751, 1543, 1566721907955, 1747, 204, true
690, 1566721907753, 1545, 1566721907957, 1749, 204, true
691, 1566721907758, 1550, 1566721907961, 1753, 203, true
692, 1566721907760, 1552, 1566721907963, 1755, 203, true
693, 1566721907761, 1553, 1566721907965, 1757, 204, true
694, 1566721907763, 1555, 1566721907965, 1757, 202, true
695, 1566721907765, 1557, 1566721907970, 1762, 205, true
696, 1566721907767, 1559, 1566721907970, 1762, 203, true
697, 1566721907769, 1561, 1566721907980, 1772, 211, true
698, 1566721907772, 1564, 1566721907976, 1768, 204, true
699, 1566721907773, 1565, 1566721907981, 1773, 208, true
700, 1566721907776, 1568, 1566721907985, 1777, 209, true
701, 1566721907780, 1572, 1566721907985, 1777, 205, true
702, 1566721907783, 1575, 1566721907990, 1782, 207, true
703, 1566721907789, 1581, 1566721907993, 1785, 204, true
704, 1566721907790, 1582, 1566721907996, 1788, 206, true
705, 1566721907790, 1582, 1566721908000, 1792, 210, true
706, 1566721907797, 1589, 1566721908000, 1792, 203, true
707, 1566721907798, 1590, 1566721908005, 1797, 207, true
708, 1566721907805, 1597, 1566721908010, 1802, 205, true
709, 1566721907806, 1598, 1566721908010, 1802, 204, true
710, 1566721907808, 1600, 1566721908012, 1804, 204, true
711, 1566721907811, 1603, 1566721908015, 1807, 204, true
712, 1566721907812, 1604, 1566721908020, 1812, 208, true
713, 1566721907819, 1611, 1566721908028, 1820, 209, true
714, 1566721907820, 1612, 1566721908028, 1820, 208, true
715, 1566721907821, 1613, 1566721908028, 1820, 207, true
716, 1566721907822, 1614, 1566721908028, 1820, 206, true
717, 1566721907822, 1614, 1566721908028, 1820, 206, true
718, 1566721907824, 1616, 1566721908035, 1827, 211, true
719, 1566721907826, 1618, 1566721908035, 1827, 209, true
720, 1566721907829, 1621, 1566721908035, 1827, 206, true
721, 1566721907831, 1623, 1566721908037, 1829, 206, true
722, 1566721907832, 1624, 1566721908044, 1836, 212, true
723, 1566721907836, 1628, 1566721908044, 1836, 208, true
724, 1566721907842, 1634, 1566721908052, 1844, 210, true
725, 1566721907844, 1636, 1566721908052, 1844, 208, true
726, 1566721907846, 1638, 1566721908055, 1847, 209, true
727, 1566721907851, 1643, 1566721908055, 1847, 204, true
728, 1566721907852, 1644, 1566721908055, 1847, 203, true
729, 1566721907854, 1646, 1566721908057, 1849, 203, true
730, 1566721907856, 1648, 1566721908060, 1852, 204, true
731, 1566721907858, 1650, 1566721908064, 1856, 206, true
732, 1566721907859, 1651, 1566721908065, 1857, 206, true
733, 1566721907861, 1653, 1566721908066, 1858, 205, true
734, 1566721907863, 1655, 1566721908070, 1862, 207, true
735, 1566721907868, 1660, 1566721908072, 1864, 204, true
736, 1566721907870, 1662, 1566721908075, 1867, 205, true
737, 1566721907873, 1665, 1566721908080, 1872, 207, true
738, 1566721907875, 1667, 1566721908080, 1872, 205, true
739, 1566721907877, 1669, 1566721908082, 1874, 205, true
740, 1566721907881, 1673, 1566721908085, 1877, 204, true
741, 1566721907884, 1676, 1566721908090, 1882, 206, true
742, 1566721907885, 1677, 1566721908090, 1882, 205, true
743, 1566721907887, 1679, 1566721908094, 1886, 207, true
744, 1566721907888, 1680, 1566721908093, 1885, 205, true
745, 1566721907890, 1682, 1566721908094, 1886, 204, true
746, 1566721907892, 1684, 1566721908096, 1888, 204, true
747, 1566721907896, 1688, 1566721908100, 1892, 204, true
748, 1566721907900, 1692, 1566721908106, 1898, 206, true
749, 1566721907902, 1694, 1566721908114, 1906, 212, true
750, 1566721907938, 1730, 1566721908146, 1938, 208, true
751, 1566721907940, 1732, 1566721908148, 1940, 208, true
752, 1566721907940, 1732, 1566721908148, 1940, 208, true
753, 1566721907940, 1732, 1566721908154, 1946, 214, true
754, 1566721907941, 1733, 1566721908146, 1938, 205, true
755, 1566721907941, 1733, 1566721908146, 1938, 205, true
756, 1566721907943, 1735, 1566721908148, 1940, 205, true
757, 1566721907944, 1736, 1566721908157, 1949, 213, true
758, 1566721907946, 1738, 1566721908156, 1948, 210, true
759, 1566721907947, 1739, 1566721908154, 1946, 207, true
760, 1566721907950, 1742, 1566721908156, 1948, 206, true
761, 1566721907951, 1743, 1566721908154, 1946, 203, true
762, 1566721907952, 1744, 1566721908158, 1950, 206, true
763, 1566721907952, 1744, 1566721908159, 1951, 207, true
764, 1566721907952, 1744, 1566721908159, 1951, 207, true
765, 1566721907957, 1749, 1566721908165, 1957, 208, true
766, 1566721907957, 1749, 1566721908165, 1957, 208, true
767, 1566721907959, 1751, 1566721908163, 1955, 204, true
768, 1566721907961, 1753, 1566721908166, 1958, 205, true
769, 1566721907961, 1753, 1566721908166, 1958, 205, true
770, 1566721907966, 1758, 1566721908172, 1964, 206, true
771, 1566721907966, 1758, 1566721908173, 1965, 207, true
772, 1566721907967, 1759, 1566721908174, 1966, 207, true
773, 1566721907968, 1760, 1566721908174, 1966, 206, true
774, 1566721907971, 1763, 1566721908175, 1967, 204, true
775, 1566721907972, 1764, 1566721908178, 1970, 206, true
776, 1566721907972, 1764, 1566721908184, 1976, 212, true
777, 1566721907973, 1765, 1566721908185, 1977, 212, true
778, 1566721907974, 1766, 1566721908179, 1971, 205, true
779, 1566721907977, 1769, 1566721908185, 1977, 208, true
780, 1566721907977, 1769, 1566721908187, 1979, 210, true
781, 1566721907978, 1770, 1566721908183, 1975, 205, true
782, 1566721907982, 1774, 1566721908186, 1978, 204, true
783, 1566721907983, 1775, 1566721908189, 1981, 206, true
784, 1566721907985, 1777, 1566721908189, 1981, 204, true
785, 1566721907986, 1778, 1566721908194, 1986, 208, true
786, 1566721907987, 1779, 1566721908199, 1991, 212, true
787, 1566721907987, 1779, 1566721908199, 1991, 212, true
788, 1566721907988, 1780, 1566721908199, 1991, 211, true
789, 1566721907988, 1780, 1566721908199, 1991, 211, true
790, 1566721907990, 1782, 1566721908201, 1993, 211, true
791, 1566721907991, 1783, 1566721908199, 1991, 208, true
792, 1566721907991, 1783, 1566721908201, 1993, 210, true
793, 1566721907994, 1786, 1566721908199, 1991, 205, true
794, 1566721907997, 1789, 1566721908206, 1998, 209, true
795, 1566721907998, 1790, 1566721908218, 2010, 220, true
796, 1566721907998, 1790, 1566721908217, 2009, 219, true
797, 1566721908000, 1792, 1566721908218, 2010, 218, true
798, 1566721908001, 1793, 1566721908219, 2011, 218, true
799, 1566721908001, 1793, 1566721908218, 2010, 217, true
800, 1566721908002, 1794, 1566721908217, 2009, 215, true
801, 1566721908003, 1795, 1566721908217, 2009, 214, true
802, 1566721908004, 1796, 1566721908218, 2010, 214, true
803, 1566721908005, 1797, 1566721908218, 2010, 213, true
804, 1566721908008, 1800, 1566721908220, 2012, 212, true
805, 1566721908010, 1802, 1566721908220, 2012, 210, true
806, 1566721908012, 1804, 1566721908231, 2023, 219, true
807, 1566721908013, 1805, 1566721908231, 2023, 218, true
808, 1566721908013, 1805, 1566721908232, 2024, 219, true
809, 1566721908014, 1806, 1566721908231, 2023, 217, true
810, 1566721908015, 1807, 1566721908230, 2022, 215, true
811, 1566721908016, 1808, 1566721908231, 2023, 215, true
812, 1566721908016, 1808, 1566721908226, 2018, 210, true
813, 1566721908017, 1809, 1566721908231, 2023, 214, true
814, 1566721908017, 1809, 1566721908232, 2024, 215, true
815, 1566721908018, 1810, 1566721908230, 2022, 212, true
816, 1566721908020, 1812, 1566721908231, 2023, 211, true
817, 1566721908022, 1814, 1566721908232, 2024, 210, true
818, 1566721908024, 1816, 1566721908232, 2024, 208, true
819, 1566721908029, 1821, 1566721908234, 2026, 205, true
820, 1566721908029, 1821, 1566721908234, 2026, 205, true
821, 1566721908030, 1822, 1566721908234, 2026, 204, true
822, 1566721908030, 1822, 1566721908234, 2026, 204, true
823, 1566721908032, 1824, 1566721908244, 2036, 212, true
824, 1566721908032, 1824, 1566721908243, 2035, 211, true
825, 1566721908033, 1825, 1566721908244, 2036, 211, true
826, 1566721908036, 1828, 1566721908244, 2036, 208, true
827, 1566721908038, 1830, 1566721908246, 2038, 208, true
828, 1566721908039, 1831, 1566721908249, 2041, 210, true
829, 1566721908039, 1831, 1566721908244, 2036, 205, true
830, 1566721908040, 1832, 1566721908250, 2042, 210, true
831, 1566721908042, 1834, 1566721908249, 2041, 207, true
832, 1566721908045, 1837, 1566721908250, 2042, 205, true
833, 1566721908046, 1838, 1566721908250, 2042, 204, true
834, 1566721908047, 1839, 1566721908260, 2052, 213, true
835, 1566721908047, 1839, 1566721908260, 2052, 213, true
836, 1566721908049, 1841, 1566721908257, 2049, 208, true
837, 1566721908049, 1841, 1566721908260, 2052, 211, true
838, 1566721908050, 1842, 1566721908257, 2049, 207, true
839, 1566721908050, 1842, 1566721908265, 2057, 215, true
840, 1566721908052, 1844, 1566721908263, 2055, 211, true
841, 1566721908053, 1845, 1566721908268, 2060, 215, true
842, 1566721908056, 1848, 1566721908265, 2057, 209, true
843, 1566721908058, 1850, 1566721908264, 2056, 206, true
844, 1566721908059, 1851, 1566721908268, 2060, 209, true
845, 1566721908060, 1852, 1566721908268, 2060, 208, true
846, 1566721908063, 1855, 1566721908268, 2060, 205, true
847, 1566721908066, 1858, 1566721908270, 2062, 204, true
848, 1566721908070, 1862, 1566721908279, 2071, 209, true
849, 1566721908073, 1865, 1566721908280, 2072, 207, true
850, 1566721908075, 1867, 1566721908280, 2072, 205, true
851, 1566721908077, 1869, 1566721908280, 2072, 203, true
852, 1566721908078, 1870, 1566721908282, 2074, 204, true
853, 1566721908082, 1874, 1566721908290, 2082, 208, true
854, 1566721908084, 1876, 1566721908290, 2082, 206, true
855, 1566721908086, 1878, 1566721908291, 2083, 205, true
856, 1566721908088, 1880, 1566721908294, 2086, 206, true
857, 1566721908091, 1883, 1566721908301, 2093, 210, true
858, 1566721908095, 1887, 1566721908301, 2093, 206, true
859, 1566721908098, 1890, 1566721908301, 2093, 203, true
860, 1566721908100, 1892, 1566721908306, 2098, 206, true
861, 1566721908102, 1894, 1566721908306, 2098, 204, true
862, 1566721908104, 1896, 1566721908312, 2104, 208, true
863, 1566721908106, 1898, 1566721908312, 2104, 206, true
864, 1566721908108, 1900, 1566721908317, 2109, 209, true
865, 1566721908109, 1901, 1566721908325, 2117, 216, true
866, 1566721908112, 1904, 1566721908325, 2117, 213, true
867, 1566721908115, 1907, 1566721908325, 2117, 210, true
868, 1566721908116, 1908, 1566721908325, 2117, 209, true
869, 1566721908118, 1910, 1566721908327, 2119, 209, true
870, 1566721908120, 1912, 1566721908326, 2118, 206, true
871, 1566721908123, 1915, 1566721908327, 2119, 204, true
872, 1566721908125, 1917, 1566721908330, 2122, 205, true
873, 1566721908126, 1918, 1566721908337, 2129, 211, true
874, 1566721908127, 1919, 1566721908331, 2123, 204, true
875, 1566721908129, 1921, 1566721908337, 2129, 208, true
876, 1566721908129, 1921, 1566721908337, 2129, 208, true
877, 1566721908130, 1922, 1566721908337, 2129, 207, true
878, 1566721908131, 1923, 1566721908337, 2129, 206, true
879, 1566721908133, 1925, 1566721908337, 2129, 204, true
880, 1566721908135, 1927, 1566721908343, 2135, 208, true
881, 1566721908137, 1929, 1566721908346, 2138, 209, true
882, 1566721908139, 1931, 1566721908346, 2138, 207, true
883, 1566721908143, 1935, 1566721908349, 2141, 206, true
884, 1566721908149, 1941, 1566721908365, 2157, 216, true
885, 1566721908150, 1942, 1566721908358, 2150, 208, true
886, 1566721908150, 1942, 1566721908365, 2157, 215, true
887, 1566721908151, 1943, 1566721908362, 2154, 211, true
888, 1566721908160, 1952, 1566721908367, 2159, 207, true
889, 1566721908161, 1953, 1566721908367, 2159, 206, true
890, 1566721908162, 1954, 1566721908370, 2162, 208, true
891, 1566721908167, 1959, 1566721908370, 2162, 203, true
892, 1566721908168, 1960, 1566721908387, 2179, 219, true
893, 1566721908169, 1961, 1566721908386, 2178, 217, true
894, 1566721908169, 1961, 1566721908386, 2178, 217, true
895, 1566721908169, 1961, 1566721908379, 2171, 210, true
896, 1566721908170, 1962, 1566721908387, 2179, 217, true
897, 1566721908170, 1962, 1566721908386, 2178, 216, true
898, 1566721908175, 1967, 1566721908383, 2175, 208, true
899, 1566721908176, 1968, 1566721908386, 2178, 210, true
900, 1566721908181, 1973, 1566721908389, 2181, 208, true
901, 1566721908181, 1973, 1566721908389, 2181, 208, true
902, 1566721908183, 1975, 1566721908389, 2181, 206, true
903, 1566721908188, 1980, 1566721908395, 2187, 207, true
904, 1566721908196, 1988, 1566721908403, 2195, 207, true
905, 1566721908203, 1995, 1566721908411, 2203, 208, true
906, 1566721908222, 2014, 1566721908430, 2222, 208, true
907, 1566721908223, 2015, 1566721908428, 2220, 205, true
908, 1566721908241, 2033, 1566721908447, 2239, 206, true
909, 1566721908247, 2039, 1566721908455, 2247, 208, true
910, 1566721908251, 2043, 1566721908459, 2251, 208, true
911, 1566721908253, 2045, 1566721908459, 2251, 206, true
912, 1566721908255, 2047, 1566721908459, 2251, 204, true
913, 1566721908257, 2049, 1566721908467, 2259, 210, true
914, 1566721908258, 2050, 1566721908462, 2254, 204, true
915, 1566721908261, 2053, 1566721908467, 2259, 206, true
916, 1566721908271, 2063, 1566721908475, 2267, 204, true
917, 1566721908271, 2063, 1566721908475, 2267, 204, true
918, 1566721908281, 2073, 1566721908486, 2278, 205, true
919, 1566721908288, 2080, 1566721908495, 2287, 207, true
920, 1566721908292, 2084, 1566721908496, 2288, 204, true
921, 1566721908293, 2085, 1566721908507, 2299, 214, true
922, 1566721908302, 2094, 1566721908508, 2300, 206, true
923, 1566721908304, 2096, 1566721908510, 2302, 206, true
924, 1566721908307, 2099, 1566721908514, 2306, 207, true
925, 1566721908308, 2100, 1566721908515, 2307, 207, true
926, 1566721908310, 2102, 1566721908515, 2307, 205, true
927, 1566721908312, 2104, 1566721908517, 2309, 205, true
928, 1566721908314, 2106, 1566721908523, 2315, 209, true
929, 1566721908314, 2106, 1566721908525, 2317, 211, true
930, 1566721908315, 2107, 1566721908524, 2316, 209, true
931, 1566721908315, 2107, 1566721908524, 2316, 209, true
932, 1566721908315, 2107, 1566721908530, 2322, 215, true
933, 1566721908316, 2108, 1566721908530, 2322, 214, true
934, 1566721908318, 2110, 1566721908526, 2318, 208, true
935, 1566721908319, 2111, 1566721908525, 2317, 206, true
936, 1566721908321, 2113, 1566721908533, 2325, 212, true
937, 1566721908322, 2114, 1566721908535, 2327, 213, true
938, 1566721908328, 2120, 1566721908539, 2331, 211, true
939, 1566721908328, 2120, 1566721908540, 2332, 212, true
940, 1566721908329, 2121, 1566721908539, 2331, 210, true
941, 1566721908329, 2121, 1566721908535, 2327, 206, true
942, 1566721908332, 2124, 1566721908540, 2332, 208, true
943, 1566721908333, 2125, 1566721908539, 2331, 206, true
944, 1566721908338, 2130, 1566721908545, 2337, 207, true
945, 1566721908338, 2130, 1566721908545, 2337, 207, true
946, 1566721908338, 2130, 1566721908541, 2333, 203, true
947, 1566721908340, 2132, 1566721908545, 2337, 205, true
948, 1566721908340, 2132, 1566721908544, 2336, 204, true
949, 1566721908341, 2133, 1566721908545, 2337, 204, true
950, 1566721908341, 2133, 1566721908546, 2338, 205, true
951, 1566721908343, 2135, 1566721908547, 2339, 204, true
952, 1566721908344, 2136, 1566721908548, 2340, 204, true
953, 1566721908346, 2138, 1566721908555, 2347, 209, true
954, 1566721908346, 2138, 1566721908549, 2341, 203, true
955, 1566721908347, 2139, 1566721908556, 2348, 209, true
956, 1566721908349, 2141, 1566721908552, 2344, 203, true
957, 1566721908350, 2142, 1566721908557, 2349, 207, true
958, 1566721908351, 2143, 1566721908555, 2347, 204, true
959, 1566721908352, 2144, 1566721908559, 2351, 207, true
960, 1566721908353, 2145, 1566721908559, 2351, 206, true
961, 1566721908354, 2146, 1566721908559, 2351, 205, true
962, 1566721908355, 2147, 1566721908559, 2351, 204, true
963, 1566721908358, 2150, 1566721908562, 2354, 204, true
964, 1566721908360, 2152, 1566721908568, 2360, 208, true
965, 1566721908360, 2152, 1566721908568, 2360, 208, true
966, 1566721908363, 2155, 1566721908568, 2360, 205, true
967, 1566721908363, 2155, 1566721908568, 2360, 205, true
968, 1566721908366, 2158, 1566721908570, 2362, 204, true
969, 1566721908368, 2160, 1566721908573, 2365, 205, true
970, 1566721908368, 2160, 1566721908575, 2367, 207, true
971, 1566721908371, 2163, 1566721908575, 2367, 204, true
972, 1566721908371, 2163, 1566721908575, 2367, 204, true
973, 1566721908372, 2164, 1566721908575, 2367, 203, true
974, 1566721908372, 2164, 1566721908576, 2368, 204, true
975, 1566721908374, 2166, 1566721908578, 2370, 204, true
976, 1566721908374, 2166, 1566721908578, 2370, 204, true
977, 1566721908376, 2168, 1566721908583, 2375, 207, true
978, 1566721908376, 2168, 1566721908585, 2377, 209, true
979, 1566721908377, 2169, 1566721908581, 2373, 204, true
980, 1566721908379, 2171, 1566721908585, 2377, 206, true
981, 1566721908380, 2172, 1566721908592, 2384, 212, true
982, 1566721908381, 2173, 1566721908592, 2384, 211, true
983, 1566721908386, 2178, 1566721908592, 2384, 206, true
984, 1566721908390, 2182, 1566721908596, 2388, 206, true
985, 1566721908390, 2182, 1566721908596, 2388, 206, true
986, 1566721908391, 2183, 1566721908596, 2388, 205, true
987, 1566721908392, 2184, 1566721908597, 2389, 205, true
988, 1566721908393, 2185, 1566721908599, 2391, 206, true
989, 1566721908393, 2185, 1566721908599, 2391, 206, true
990, 1566721908395, 2187, 1566721908599, 2391, 204, true
991, 1566721908396, 2188, 1566721908599, 2391, 203, true
992, 1566721908397, 2189, 1566721908605, 2397, 208, true
993, 1566721908399, 2191, 1566721908605, 2397, 206, true
994, 1566721908400, 2192, 1566721908605, 2397, 205, true
995, 1566721908401, 2193, 1566721908607, 2399, 206, true
996, 1566721908403, 2195, 1566721908607, 2399, 204, true
997, 1566721908404, 2196, 1566721908610, 2402, 206, true
998, 1566721908405, 2197, 1566721908611, 2403, 206, true
999, 1566721908407, 2199, 1566721908611, 2403, 204, true
1000, 1566721908408, 2200, 1566721908615, 2407, 207, true
1001, 1566721908409, 2201, 1566721908615, 2407, 206, true
1002, 1566721908411, 2203, 1566721908615, 2407, 204, true
1003, 1566721908412, 2204, 1566721908617, 2409, 205, true
1004, 1566721908413, 2205, 1566721908617, 2409, 204, true
1005, 1566721908414, 2206, 1566721908617, 2409, 203, true
1006, 1566721908415, 2207, 1566721908619, 2411, 204, true
1007, 1566721908415, 2207, 1566721908619, 2411, 204, true
1008, 1566721908417, 2209, 1566721908624, 2416, 207, true
1009, 1566721908417, 2209, 1566721908624, 2416, 207, true
1010, 1566721908418, 2210, 1566721908624, 2416, 206, true
1011, 1566721908420, 2212, 1566721908624, 2416, 204, true
1012, 1566721908420, 2212, 1566721908625, 2417, 205, true
1013, 1566721908421, 2213, 1566721908626, 2418, 205, true
1014, 1566721908423, 2215, 1566721908630, 2422, 207, true
1015, 1566721908424, 2216, 1566721908630, 2422, 206, true
1016, 1566721908425, 2217, 1566721908634, 2426, 209, true
1017, 1566721908426, 2218, 1566721908630, 2422, 204, true
1018, 1566721908429, 2221, 1566721908634, 2426, 205, true
1019, 1566721908432, 2224, 1566721908636, 2428, 204, true
1020, 1566721908433, 2225, 1566721908641, 2433, 208, true
1021, 1566721908434, 2226, 1566721908641, 2433, 207, true
1022, 1566721908435, 2227, 1566721908641, 2433, 206, true
1023, 1566721908437, 2229, 1566721908645, 2437, 208, true
1024, 1566721908437, 2229, 1566721908645, 2437, 208, true
1025, 1566721908438, 2230, 1566721908645, 2437, 207, true
1026, 1566721908441, 2233, 1566721908645, 2437, 204, true
1027, 1566721908443, 2235, 1566721908647, 2439, 204, true
1028, 1566721908444, 2236, 1566721908652, 2444, 208, true
1029, 1566721908445, 2237, 1566721908651, 2443, 206, true
1030, 1566721908446, 2238, 1566721908652, 2444, 206, true
1031, 1566721908448, 2240, 1566721908652, 2444, 204, true
1032, 1566721908449, 2241, 1566721908657, 2449, 208, true
1033, 1566721908450, 2242, 1566721908654, 2446, 204, true
1034, 1566721908451, 2243, 1566721908657, 2449, 206, true
1035, 1566721908453, 2245, 1566721908658, 2450, 205, true
1036, 1566721908456, 2248, 1566721908660, 2452, 204, true
1037, 1566721908456, 2248, 1566721908664, 2456, 208, true
1038, 1566721908460, 2252, 1566721908665, 2457, 205, true
1039, 1566721908463, 2255, 1566721908670, 2462, 207, true
1040, 1566721908463, 2255, 1566721908676, 2468, 213, true
1041, 1566721908464, 2256, 1566721908670, 2462, 206, true
1042, 1566721908464, 2256, 1566721908671, 2463, 207, true
1043, 1566721908464, 2256, 1566721908676, 2468, 212, true
1044, 1566721908467, 2259, 1566721908676, 2468, 209, true
1045, 1566721908469, 2261, 1566721908675, 2467, 206, true
1046, 1566721908471, 2263, 1566721908676, 2468, 205, true
1047, 1566721908473, 2265, 1566721908679, 2471, 206, true
1048, 1566721908477, 2269, 1566721908684, 2476, 207, true
1049, 1566721908478, 2270, 1566721908681, 2473, 203, true
1050, 1566721908480, 2272, 1566721908686, 2478, 206, true
1051, 1566721908480, 2272, 1566721908685, 2477, 205, true
1052, 1566721908481, 2273, 1566721908686, 2478, 205, true
1053, 1566721908482, 2274, 1566721908694, 2486, 212, true
1054, 1566721908484, 2276, 1566721908692, 2484, 208, true
1055, 1566721908485, 2277, 1566721908696, 2488, 211, true
1056, 1566721908487, 2279, 1566721908692, 2484, 205, true
1057, 1566721908488, 2280, 1566721908697, 2489, 209, true
1058, 1566721908490, 2282, 1566721908697, 2489, 207, true
1059, 1566721908491, 2283, 1566721908695, 2487, 204, true
1060, 1566721908492, 2284, 1566721908698, 2490, 206, true
1061, 1566721908493, 2285, 1566721908698, 2490, 205, true
1062, 1566721908496, 2288, 1566721908702, 2494, 206, true
1063, 1566721908497, 2289, 1566721908702, 2494, 205, true
1064, 1566721908498, 2290, 1566721908705, 2497, 207, true
1065, 1566721908498, 2290, 1566721908707, 2499, 209, true
1066, 1566721908501, 2293, 1566721908708, 2500, 207, true
1067, 1566721908503, 2295, 1566721908712, 2504, 209, true
1068, 1566721908504, 2296, 1566721908712, 2504, 208, true
1069, 1566721908505, 2297, 1566721908712, 2504, 207, true
1070, 1566721908507, 2299, 1566721908711, 2503, 204, true
1071, 1566721908510, 2302, 1566721908717, 2509, 207, true
1072, 1566721908511, 2303, 1566721908715, 2507, 204, true
1073, 1566721908511, 2303, 1566721908718, 2510, 207, true
1074, 1566721908511, 2303, 1566721908718, 2510, 207, true
1075, 1566721908513, 2305, 1566721908719, 2511, 206, true
1076, 1566721908518, 2310, 1566721908725, 2517, 207, true
1077, 1566721908518, 2310, 1566721908725, 2517, 207, true
1078, 1566721908519, 2311, 1566721908730, 2522, 211, true
1079, 1566721908519, 2311, 1566721908726, 2518, 207, true
1080, 1566721908520, 2312, 1566721908730, 2522, 210, true
1081, 1566721908520, 2312, 1566721908728, 2520, 208, true
1082, 1566721908521, 2313, 1566721908731, 2523, 210, true
1083, 1566721908527, 2319, 1566721908732, 2524, 205, true
1084, 1566721908528, 2320, 1566721908732, 2524, 204, true
1085, 1566721908531, 2323, 1566721908735, 2527, 204, true
1086, 1566721908533, 2325, 1566721908739, 2531, 206, true
1087, 1566721908536, 2328, 1566721908741, 2533, 205, true
1088, 1566721908542, 2334, 1566721908749, 2541, 207, true
1089, 1566721908550, 2342, 1566721908754, 2546, 204, true
1090, 1566721908553, 2345, 1566721908758, 2550, 205, true
1091, 1566721908561, 2353, 1566721908766, 2558, 205, true
1092, 1566721908565, 2357, 1566721908774, 2566, 209, true
1093, 1566721908571, 2363, 1566721908776, 2568, 205, true
1094, 1566721908576, 2368, 1566721908785, 2577, 209, true
1095, 1566721908581, 2373, 1566721908785, 2577, 204, true
1096, 1566721908585, 2377, 1566721908791, 2583, 206, true
1097, 1566721908588, 2380, 1566721908797, 2589, 209, true
1098, 1566721908588, 2380, 1566721908797, 2589, 209, true
1099, 1566721908592, 2384, 1566721908799, 2591, 207, true
1100, 1566721908594, 2386, 1566721908801, 2593, 207, true
1101, 1566721908603, 2395, 1566721908808, 2600, 205, true
1102, 1566721908609, 2401, 1566721908815, 2607, 206, true
1103, 1566721908612, 2404, 1566721908816, 2608, 204, true
1104, 1566721908620, 2412, 1566721908826, 2618, 206, true
1105, 1566721908621, 2413, 1566721908826, 2618, 205, true
1106, 1566721908627, 2419, 1566721908831, 2623, 204, true
1107, 1566721908631, 2423, 1566721908838, 2630, 207, true
1108, 1566721908634, 2426, 1566721908838, 2630, 204, true
1109, 1566721908637, 2429, 1566721908843, 2635, 206, true
1110, 1566721908638, 2430, 1566721908844, 2636, 206, true
1111, 1566721908642, 2434, 1566721908848, 2640, 206, true
1112, 1566721908648, 2440, 1566721908853, 2645, 205, true
1113, 1566721908649, 2441, 1566721908857, 2649, 208, true
1114, 1566721908655, 2447, 1566721908862, 2654, 207, true
1115, 1566721908656, 2448, 1566721908862, 2654, 206, true
1116, 1566721908661, 2453, 1566721908869, 2661, 208, true
1117, 1566721908662, 2454, 1566721908869, 2661, 207, true
1118, 1566721908668, 2460, 1566721908875, 2667, 207, true
1119, 1566721908671, 2463, 1566721908883, 2675, 212, true
1120, 1566721908672, 2464, 1566721908880, 2672, 208, true
1121, 1566721908673, 2465, 1566721908881, 2673, 208, true
1122, 1566721908680, 2472, 1566721908887, 2679, 207, true
1123, 1566721908682, 2474, 1566721908888, 2680, 206, true
1124, 1566721908687, 2479, 1566721908890, 2682, 203, true
1125, 1566721908689, 2481, 1566721908892, 2684, 203, true
1126, 1566721908690, 2482, 1566721908898, 2690, 208, true
1127, 1566721908691, 2483, 1566721908898, 2690, 207, true
1128, 1566721908694, 2486, 1566721908899, 2691, 205, true
1129, 1566721908699, 2491, 1566721908905, 2697, 206, true
1130, 1566721908703, 2495, 1566721908910, 2702, 207, true
1131, 1566721908706, 2498, 1566721908911, 2703, 205, true
1132, 1566721908709, 2501, 1566721908916, 2708, 207, true
1133, 1566721908712, 2504, 1566721908917, 2709, 205, true
1134, 1566721908713, 2505, 1566721908918, 2710, 205, true
1135, 1566721908713, 2505, 1566721908918, 2710, 205, true
1136, 1566721908716, 2508, 1566721908922, 2714, 206, true
1137, 1566721908720, 2512, 1566721908923, 2715, 203, true
1138, 1566721908722, 2514, 1566721908926, 2718, 204, true
1139, 1566721908723, 2515, 1566721908931, 2723, 208, true
1140, 1566721908726, 2518, 1566721908934, 2726, 208, true
1141, 1566721908729, 2521, 1566721908934, 2726, 205, true
1142, 1566721908733, 2525, 1566721908939, 2731, 206, true
1143, 1566721908735, 2527, 1566721908940, 2732, 205, true
1144, 1566721908737, 2529, 1566721908945, 2737, 208, true
1145, 1566721908739, 2531, 1566721908945, 2737, 206, true
1146, 1566721908742, 2534, 1566721908952, 2744, 210, true
1147, 1566721908743, 2535, 1566721908952, 2744, 209, true
1148, 1566721908744, 2536, 1566721908952, 2744, 208, true
1149, 1566721908746, 2538, 1566721908953, 2745, 207, true
1150, 1566721908747, 2539, 1566721908953, 2745, 206, true
1151, 1566721908750, 2542, 1566721908953, 2745, 203, true
1152, 1566721908751, 2543, 1566721908958, 2750, 207, true
1153, 1566721908754, 2546, 1566721908957, 2749, 203, true
1154, 1566721908756, 2548, 1566721908963, 2755, 207, true
1155, 1566721908759, 2551, 1566721908964, 2756, 205, true
1156, 1566721908761, 2553, 1566721908969, 2761, 208, true
1157, 1566721908763, 2555, 1566721908969, 2761, 206, true
1158, 1566721908775, 2567, 1566721908979, 2771, 204, true
1159, 1566721908777, 2569, 1566721908980, 2772, 203, true
1160, 1566721908779, 2571, 1566721908984, 2776, 205, true
1161, 1566721908780, 2572, 1566721908987, 2779, 207, true
1162, 1566721908786, 2578, 1566721908994, 2786, 208, true
1163, 1566721908787, 2579, 1566721908991, 2783, 204, true
1164, 1566721908789, 2581, 1566721908994, 2786, 205, true
1165, 1566721908792, 2584, 1566721908998, 2790, 206, true
1166, 1566721908794, 2586, 1566721909001, 2793, 207, true
1167, 1566721908795, 2587, 1566721909001, 2793, 206, true
1168, 1566721908799, 2591, 1566721909003, 2795, 204, true
1169, 1566721908803, 2595, 1566721909007, 2799, 204, true
1170, 1566721908805, 2597, 1566721909009, 2801, 204, true
1171, 1566721908806, 2598, 1566721909009, 2801, 203, true
1172, 1566721908809, 2601, 1566721909015, 2807, 206, true
1173, 1566721908811, 2603, 1566721909016, 2808, 205, true
1174, 1566721908812, 2604, 1566721909024, 2816, 212, true
1175, 1566721908815, 2607, 1566721909023, 2815, 208, true
1176, 1566721908817, 2609, 1566721909025, 2817, 208, true
1177, 1566721908817, 2609, 1566721909061, 2853, 244, true
1178, 1566721908819, 2611, 1566721909061, 2853, 242, true
1179, 1566721908820, 2612, 1566721909027, 2819, 207, true
1180, 1566721908820, 2612, 1566721909028, 2820, 208, true
1181, 1566721908822, 2614, 1566721909027, 2819, 205, true
1182, 1566721908823, 2615, 1566721909033, 2825, 210, true
1183, 1566721908824, 2616, 1566721909033, 2825, 209, true
1184, 1566721908827, 2619, 1566721909035, 2827, 208, true
1185, 1566721908828, 2620, 1566721909035, 2827, 207, true
1186, 1566721908828, 2620, 1566721909034, 2826, 206, true
1187, 1566721908831, 2623, 1566721909035, 2827, 204, true
1188, 1566721908831, 2623, 1566721909038, 2830, 207, true
1189, 1566721908832, 2624, 1566721909041, 2833, 209, true
1190, 1566721908833, 2625, 1566721909045, 2837, 212, true
1191, 1566721908834, 2626, 1566721909044, 2836, 210, true
1192, 1566721908835, 2627, 1566721909046, 2838, 211, true
1193, 1566721908837, 2629, 1566721909046, 2838, 209, true
1194, 1566721908839, 2631, 1566721909046, 2838, 207, true
1195, 1566721908840, 2632, 1566721909046, 2838, 206, true
1196, 1566721908841, 2633, 1566721909047, 2839, 206, true
1197, 1566721908843, 2635, 1566721909047, 2839, 204, true
1198, 1566721908844, 2636, 1566721909052, 2844, 208, true
1199, 1566721908845, 2637, 1566721909055, 2847, 210, true
1200, 1566721908848, 2640, 1566721909052, 2844, 204, true
1201, 1566721908849, 2641, 1566721909057, 2849, 208, true
1202, 1566721908851, 2643, 1566721909057, 2849, 206, true
1203, 1566721908851, 2643, 1566721909059, 2851, 208, true
1204, 1566721908852, 2644, 1566721909059, 2851, 207, true
1205, 1566721908854, 2646, 1566721909065, 2857, 211, true
1206, 1566721908855, 2647, 1566721909062, 2854, 207, true
1207, 1566721908858, 2650, 1566721909066, 2858, 208, true
1208, 1566721908859, 2651, 1566721909065, 2857, 206, true
1209, 1566721908859, 2651, 1566721909066, 2858, 207, true
1210, 1566721908860, 2652, 1566721909071, 2863, 211, true
1211, 1566721908863, 2655, 1566721909071, 2863, 208, true
1212, 1566721908864, 2656, 1566721909071, 2863, 207, true
1213, 1566721908865, 2657, 1566721909071, 2863, 206, true
1214, 1566721908866, 2658, 1566721909078, 2870, 212, true
1215, 1566721908867, 2659, 1566721909072, 2864, 205, true
1216, 1566721908870, 2662, 1566721909078, 2870, 208, true
1217, 1566721908870, 2662, 1566721909079, 2871, 209, true
1218, 1566721908871, 2663, 1566721909079, 2871, 208, true
1219, 1566721908873, 2665, 1566721909084, 2876, 211, true
1220, 1566721908874, 2666, 1566721909080, 2872, 206, true
1221, 1566721908877, 2669, 1566721909087, 2879, 210, true
1222, 1566721908878, 2670, 1566721909087, 2879, 209, true
1223, 1566721908881, 2673, 1566721909088, 2880, 207, true
1224, 1566721908882, 2674, 1566721909092, 2884, 210, true
1225, 1566721908884, 2676, 1566721909094, 2886, 210, true
1226, 1566721908884, 2676, 1566721909092, 2884, 208, true
1227, 1566721908884, 2676, 1566721909092, 2884, 208, true
1228, 1566721908886, 2678, 1566721909094, 2886, 208, true
1229, 1566721908892, 2684, 1566721909102, 2894, 210, true
1230, 1566721908892, 2684, 1566721909102, 2894, 210, true
1231, 1566721908893, 2685, 1566721909102, 2894, 209, true
1232, 1566721908893, 2685, 1566721909102, 2894, 209, true
1233, 1566721908893, 2685, 1566721909109, 2901, 216, true
1234, 1566721908894, 2686, 1566721909116, 2908, 222, true
1235, 1566721908895, 2687, 1566721909106, 2898, 211, true
1236, 1566721908898, 2690, 1566721909110, 2902, 212, true
1237, 1566721908900, 2692, 1566721909106, 2898, 206, true
1238, 1566721908900, 2692, 1566721909108, 2900, 208, true
1239, 1566721908901, 2693, 1566721909116, 2908, 215, true
1240, 1566721908901, 2693, 1566721909116, 2908, 215, true
1241, 1566721908902, 2694, 1566721909116, 2908, 214, true
1242, 1566721908905, 2697, 1566721909111, 2903, 206, true
1243, 1566721908907, 2699, 1566721909115, 2907, 208, true
1244, 1566721908908, 2700, 1566721909115, 2907, 207, true
1245, 1566721908912, 2704, 1566721909124, 2916, 212, true
1246, 1566721908913, 2705, 1566721909118, 2910, 205, true
1247, 1566721908915, 2707, 1566721909124, 2916, 209, true
1248, 1566721908919, 2711, 1566721909126, 2918, 207, true
1249, 1566721908919, 2711, 1566721909125, 2917, 206, true
1250, 1566721908920, 2712, 1566721909127, 2919, 207, true
1251, 1566721908921, 2713, 1566721909128, 2920, 207, true
1252, 1566721908923, 2715, 1566721909128, 2920, 205, true
1253, 1566721908924, 2716, 1566721909128, 2920, 204, true
1254, 1566721908926, 2718, 1566721909135, 2927, 209, true
1255, 1566721908926, 2718, 1566721909131, 2923, 205, true
1256, 1566721908927, 2719, 1566721909131, 2923, 204, true
1257, 1566721908928, 2720, 1566721909137, 2929, 209, true
1258, 1566721908930, 2722, 1566721909135, 2927, 205, true
1259, 1566721908932, 2724, 1566721909137, 2929, 205, true
1260, 1566721908934, 2726, 1566721909140, 2932, 206, true
1261, 1566721908935, 2727, 1566721909140, 2932, 205, true
1262, 1566721908936, 2728, 1566721909146, 2938, 210, true
1263, 1566721908938, 2730, 1566721909143, 2935, 205, true
1264, 1566721908955, 2747, 1566721909159, 2951, 204, true
1265, 1566721908955, 2747, 1566721909159, 2951, 204, true
1266, 1566721908977, 2769, 1566721909182, 2974, 205, true
1267, 1566721908985, 2777, 1566721909189, 2981, 204, true
1268, 1566721908987, 2779, 1566721909196, 2988, 209, true
1269, 1566721908989, 2781, 1566721909196, 2988, 207, true
1270, 1566721908991, 2783, 1566721909196, 2988, 205, true
1271, 1566721908995, 2787, 1566721909199, 2991, 204, true
1272, 1566721908996, 2788, 1566721909202, 2994, 206, true
1273, 1566721908999, 2791, 1566721909205, 2997, 206, true
1274, 1566721909000, 2792, 1566721909206, 2998, 206, true
1275, 1566721909002, 2794, 1566721909206, 2998, 204, true
1276, 1566721909004, 2796, 1566721909208, 3000, 204, true
1277, 1566721909005, 2797, 1566721909210, 3002, 205, true
1278, 1566721909007, 2799, 1566721909216, 3008, 209, true
1279, 1566721909007, 2799, 1566721909215, 3007, 208, true
1280, 1566721909011, 2803, 1566721909216, 3008, 205, true
1281, 1566721909013, 2805, 1566721909217, 3009, 204, true
1282, 1566721909016, 2808, 1566721909219, 3011, 203, true
1283, 1566721909022, 2814, 1566721909265, 3057, 243, true
1284, 1566721909025, 2817, 1566721909266, 3058, 241, true
1285, 1566721909025, 2817, 1566721909230, 3022, 205, true
1286, 1566721909029, 2821, 1566721909233, 3025, 204, true
1287, 1566721909030, 2822, 1566721909234, 3026, 204, true
1288, 1566721909036, 2828, 1566721909240, 3032, 204, true
1289, 1566721909039, 2831, 1566721909246, 3038, 207, true
1290, 1566721909041, 2833, 1566721909245, 3037, 204, true
1291, 1566721909043, 2835, 1566721909252, 3044, 209, true
1292, 1566721909049, 2841, 1566721909258, 3050, 209, true
1293, 1566721909050, 2842, 1566721909256, 3048, 206, true
1294, 1566721909053, 2845, 1566721909258, 3050, 205, true
1295, 1566721909056, 2848, 1566721909265, 3057, 209, true
1296, 1566721909063, 2855, 1566721909269, 3061, 206, true
1297, 1566721909067, 2859, 1566721909270, 3062, 203, true
1298, 1566721909068, 2860, 1566721909277, 3069, 209, true
1299, 1566721909068, 2860, 1566721909298, 3090, 230, true
1300, 1566721909072, 2864, 1566721909276, 3068, 204, true
1301, 1566721909073, 2865, 1566721909298, 3090, 225, true
1302, 1566721909073, 2865, 1566721909281, 3073, 208, true
1303, 1566721909074, 2866, 1566721909283, 3075, 209, true
1304, 1566721909075, 2867, 1566721909287, 3079, 212, true
1305, 1566721909075, 2867, 1566721909298, 3090, 223, true
1306, 1566721909075, 2867, 1566721909290, 3082, 215, true
1307, 1566721909076, 2868, 1566721909288, 3080, 212, true
1308, 1566721909078, 2870, 1566721909289, 3081, 211, true
1309, 1566721909080, 2872, 1566721909290, 3082, 210, true
1310, 1566721909081, 2873, 1566721909289, 3081, 208, true
1311, 1566721909083, 2875, 1566721909289, 3081, 206, true
1312, 1566721909085, 2877, 1566721909294, 3086, 209, true
1313, 1566721909085, 2877, 1566721909294, 3086, 209, true
1314, 1566721909089, 2881, 1566721909295, 3087, 206, true
1315, 1566721909090, 2882, 1566721909294, 3086, 204, true
1316, 1566721909094, 2886, 1566721909309, 3101, 215, true
1317, 1566721909095, 2887, 1566721909306, 3098, 211, true
1318, 1566721909095, 2887, 1566721909310, 3102, 215, true
1319, 1566721909095, 2887, 1566721909310, 3102, 215, true
1320, 1566721909096, 2888, 1566721909310, 3102, 214, true
1321, 1566721909096, 2888, 1566721909310, 3102, 214, true
1322, 1566721909096, 2888, 1566721909309, 3101, 213, true
1323, 1566721909099, 2891, 1566721909310, 3102, 211, true
1324, 1566721909106, 2898, 1566721909317, 3109, 211, true
1325, 1566721909107, 2899, 1566721909312, 3104, 205, true
1326, 1566721909110, 2902, 1566721909317, 3109, 207, true
1327, 1566721909112, 2904, 1566721909317, 3109, 205, true
1328, 1566721909112, 2904, 1566721909318, 3110, 206, true
1329, 1566721909117, 2909, 1566721909321, 3113, 204, true
1330, 1566721909119, 2911, 1566721909324, 3116, 205, true
1331, 1566721909119, 2911, 1566721909325, 3117, 206, true
1332, 1566721909120, 2912, 1566721909324, 3116, 204, true
1333, 1566721909120, 2912, 1566721909325, 3117, 205, true
1334, 1566721909121, 2913, 1566721909327, 3119, 206, true
1335, 1566721909122, 2914, 1566721909328, 3120, 206, true
1336, 1566721909124, 2916, 1566721909331, 3123, 207, true
1337, 1566721909129, 2921, 1566721909336, 3128, 207, true
1338, 1566721909129, 2921, 1566721909336, 3128, 207, true
1339, 1566721909131, 2923, 1566721909336, 3128, 205, true
1340, 1566721909131, 2923, 1566721909336, 3128, 205, true
1341, 1566721909133, 2925, 1566721909338, 3130, 205, true
1342, 1566721909133, 2925, 1566721909338, 3130, 205, true
1343, 1566721909135, 2927, 1566721909338, 3130, 203, true
1344, 1566721909137, 2929, 1566721909342, 3134, 205, true
1345, 1566721909138, 2930, 1566721909342, 3134, 204, true
1346, 1566721909140, 2932, 1566721909348, 3140, 208, true
1347, 1566721909140, 2932, 1566721909346, 3138, 206, true
1348, 1566721909141, 2933, 1566721909348, 3140, 207, true
1349, 1566721909143, 2935, 1566721909350, 3142, 207, true
1350, 1566721909143, 2935, 1566721909349, 3141, 206, true
1351, 1566721909144, 2936, 1566721909350, 3142, 206, true
1352, 1566721909146, 2938, 1566721909352, 3144, 206, true
1353, 1566721909147, 2939, 1566721909351, 3143, 204, true
1354, 1566721909148, 2940, 1566721909352, 3144, 204, true
1355, 1566721909149, 2941, 1566721909354, 3146, 205, true
1356, 1566721909151, 2943, 1566721909355, 3147, 204, true
1357, 1566721909153, 2945, 1566721909358, 3150, 205, true
1358, 1566721909155, 2947, 1566721909360, 3152, 205, true
1359, 1566721909156, 2948, 1566721909360, 3152, 204, true
1360, 1566721909158, 2950, 1566721909362, 3154, 204, true
1361, 1566721909160, 2952, 1566721909365, 3157, 205, true
1362, 1566721909160, 2952, 1566721909365, 3157, 205, true
1363, 1566721909161, 2953, 1566721909366, 3158, 205, true
1364, 1566721909162, 2954, 1566721909366, 3158, 204, true
1365, 1566721909163, 2955, 1566721909367, 3159, 204, true
1366, 1566721909164, 2956, 1566721909367, 3159, 203, true
1367, 1566721909165, 2957, 1566721909372, 3164, 207, true
1368, 1566721909165, 2957, 1566721909372, 3164, 207, true
1369, 1566721909166, 2958, 1566721909372, 3164, 206, true
1370, 1566721909168, 2960, 1566721909373, 3165, 205, true
1371, 1566721909168, 2960, 1566721909373, 3165, 205, true
1372, 1566721909170, 2962, 1566721909374, 3166, 204, true
1373, 1566721909171, 2963, 1566721909378, 3170, 207, true
1374, 1566721909172, 2964, 1566721909378, 3170, 206, true
1375, 1566721909173, 2965, 1566721909378, 3170, 205, true
1376, 1566721909174, 2966, 1566721909378, 3170, 204, true
1377, 1566721909175, 2967, 1566721909382, 3174, 207, true
1378, 1566721909176, 2968, 1566721909385, 3177, 209, true
1379, 1566721909177, 2969, 1566721909388, 3180, 211, true
1380, 1566721909179, 2971, 1566721909388, 3180, 209, true
1381, 1566721909180, 2972, 1566721909388, 3180, 208, true
1382, 1566721909183, 2975, 1566721909388, 3180, 205, true
1383, 1566721909184, 2976, 1566721909391, 3183, 207, true
1384, 1566721909186, 2978, 1566721909395, 3187, 209, true
1385, 1566721909190, 2982, 1566721909396, 3188, 206, true
1386, 1566721909190, 2982, 1566721909395, 3187, 205, true
1387, 1566721909193, 2985, 1566721909399, 3191, 206, true
1388, 1566721909200, 2992, 1566721909405, 3197, 205, true
1389, 1566721909203, 2995, 1566721909408, 3200, 205, true
1390, 1566721909211, 3003, 1566721909421, 3213, 210, true
1391, 1566721909212, 3004, 1566721909420, 3212, 208, true
1392, 1566721909212, 3004, 1566721909419, 3211, 207, true
1393, 1566721909213, 3005, 1566721909422, 3214, 209, true
1394, 1566721909214, 3006, 1566721909420, 3212, 206, true
1395, 1566721909220, 3012, 1566721909424, 3216, 204, true
1396, 1566721909221, 3013, 1566721909424, 3216, 203, true
1397, 1566721909223, 3015, 1566721909427, 3219, 204, true
1398, 1566721909224, 3016, 1566721909432, 3224, 208, true
1399, 1566721909228, 3020, 1566721909433, 3225, 205, true
1400, 1566721909228, 3020, 1566721909433, 3225, 205, true
1401, 1566721909231, 3023, 1566721909437, 3229, 206, true
1402, 1566721909232, 3024, 1566721909438, 3230, 206, true
1403, 1566721909235, 3027, 1566721909438, 3230, 203, true
1404, 1566721909236, 3028, 1566721909444, 3236, 208, true
1405, 1566721909238, 3030, 1566721909444, 3236, 206, true
1406, 1566721909241, 3033, 1566721909447, 3239, 206, true
1407, 1566721909243, 3035, 1566721909450, 3242, 207, true
1408, 1566721909246, 3038, 1566721909452, 3244, 206, true
1409, 1566721909248, 3040, 1566721909452, 3244, 204, true
1410, 1566721909251, 3043, 1566721909578, 3370, 327, true
1411, 1566721909252, 3044, 1566721909505, 3297, 253, true
1412, 1566721909253, 3045, 1566721909572, 3364, 319, true
1413, 1566721909254, 3046, 1566721909572, 3364, 318, true
1414, 1566721909254, 3046, 1566721909459, 3251, 205, true
1415, 1566721909256, 3048, 1566721909461, 3253, 205, true
1416, 1566721909259, 3051, 1566721909465, 3257, 206, true
1417, 1566721909271, 3063, 1566721909482, 3274, 211, true
1418, 1566721909263, 3055, 1566721909469, 3261, 206, true
1419, 1566721909264, 3056, 1566721909480, 3272, 216, true
1420, 1566721909266, 3058, 1566721909469, 3261, 203, true
1421, 1566721909267, 3059, 1566721909476, 3268, 209, true
1422, 1566721909270, 3062, 1566721909482, 3274, 212, true
1423, 1566721909272, 3064, 1566721909482, 3274, 210, true
1424, 1566721909273, 3065, 1566721909480, 3272, 207, true
1425, 1566721909274, 3066, 1566721909480, 3272, 206, true
1426, 1566721909274, 3066, 1566721909489, 3281, 215, true
1427, 1566721909277, 3069, 1566721909486, 3278, 209, true
1428, 1566721909278, 3070, 1566721909631, 3423, 353, true
1429, 1566721909279, 3071, 1566721909489, 3281, 210, true
1430, 1566721909282, 3074, 1566721909508, 3300, 226, true
1431, 1566721909284, 3076, 1566721909489, 3281, 205, true
1432, 1566721909284, 3076, 1566721909489, 3281, 205, true
1433, 1566721909285, 3077, 1566721909631, 3423, 346, true
1434, 1566721909285, 3077, 1566721909631, 3423, 346, true
1435, 1566721909291, 3083, 1566721909630, 3422, 339, true
1436, 1566721909292, 3084, 1566721909631, 3423, 339, true
1437, 1566721909296, 3088, 1566721909630, 3422, 334, true
1438, 1566721909296, 3088, 1566721909630, 3422, 334, true
1439, 1566721909297, 3089, 1566721909630, 3422, 333, true
1440, 1566721909303, 3095, 1566721909631, 3423, 328, true
1441, 1566721909303, 3095, 1566721909661, 3453, 358, true
1442, 1566721909305, 3097, 1566721909661, 3453, 356, true
1443, 1566721909307, 3099, 1566721909661, 3453, 354, true
1444, 1566721909313, 3105, 1566721909649, 3441, 336, true
1445, 1566721909313, 3105, 1566721909648, 3440, 335, true
1446, 1566721909313, 3105, 1566721909649, 3441, 336, true
1447, 1566721909314, 3106, 1566721909649, 3441, 335, true
1448, 1566721909314, 3106, 1566721909648, 3440, 334, true
1449, 1566721909319, 3111, 1566721909646, 3438, 327, true
1450, 1566721909322, 3114, 1566721909632, 3424, 310, true
1451, 1566721909340, 3132, 1566721909631, 3423, 291, true
1452, 1566721909344, 3136, 1566721909630, 3422, 286, true
1453, 1566721909356, 3148, 1566721909631, 3423, 275, true
1454, 1566721909358, 3150, 1566721909630, 3422, 272, true
1455, 1566721909363, 3155, 1566721909630, 3422, 267, true
1456, 1566721909368, 3160, 1566721909631, 3423, 263, true
1457, 1566721909369, 3161, 1566721909631, 3423, 262, true
1458, 1566721909375, 3167, 1566721909631, 3423, 256, true
1459, 1566721909380, 3172, 1566721909631, 3423, 251, true
1460, 1566721909381, 3173, 1566721909631, 3423, 250, true
1461, 1566721909386, 3178, 1566721909631, 3423, 245, true
1462, 1566721909390, 3182, 1566721909661, 3453, 271, true
1463, 1566721909392, 3184, 1566721909661, 3453, 269, true
1464, 1566721909393, 3185, 1566721909661, 3453, 268, true
1465, 1566721909397, 3189, 1566721909661, 3453, 264, true
1466, 1566721909400, 3192, 1566721909661, 3453, 261, true
1467, 1566721909400, 3192, 1566721909661, 3453, 261, true
1468, 1566721909406, 3198, 1566721909661, 3453, 255, true
1469, 1566721909410, 3202, 1566721909661, 3453, 251, true
1470, 1566721909411, 3203, 1566721909662, 3454, 251, true
1471, 1566721909412, 3204, 1566721909662, 3454, 250, true
1472, 1566721909417, 3209, 1566721909662, 3454, 245, true
1473, 1566721909421, 3213, 1566721909662, 3454, 241, true
1474, 1566721909422, 3214, 1566721909662, 3454, 240, true
1475, 1566721909423, 3215, 1566721909663, 3455, 240, true
1476, 1566721909426, 3218, 1566721909662, 3454, 236, true
1477, 1566721909426, 3218, 1566721909662, 3454, 236, true
1478, 1566721909428, 3220, 1566721909662, 3454, 234, true
1479, 1566721909429, 3221, 1566721909662, 3454, 233, true
1480, 1566721909429, 3221, 1566721909662, 3454, 233, true
1481, 1566721909430, 3222, 1566721909659, 3451, 229, true
1482, 1566721909430, 3222, 1566721909659, 3451, 229, true
1483, 1566721909432, 3224, 1566721909659, 3451, 227, true
1484, 1566721909434, 3226, 1566721909658, 3450, 224, true
1485, 1566721909438, 3230, 1566721909659, 3451, 221, true
1486, 1566721909439, 3231, 1566721909659, 3451, 220, true
1487, 1566721909440, 3232, 1566721909659, 3451, 219, true
1488, 1566721909441, 3233, 1566721909659, 3451, 218, true
1489, 1566721909442, 3234, 1566721909659, 3451, 217, true
1490, 1566721909444, 3236, 1566721909695, 3487, 251, true
1491, 1566721909445, 3237, 1566721909695, 3487, 250, true
1492, 1566721909447, 3239, 1566721909695, 3487, 248, true
1493, 1566721909447, 3239, 1566721909694, 3486, 247, true
1494, 1566721909448, 3240, 1566721909694, 3486, 246, true
1495, 1566721909453, 3245, 1566721909694, 3486, 241, true
1496, 1566721909453, 3245, 1566721909694, 3486, 241, true
1497, 1566721909453, 3245, 1566721909694, 3486, 241, true
1498, 1566721909454, 3246, 1566721909694, 3486, 240, true
1499, 1566721909456, 3248, 1566721909693, 3485, 237, true
1500, 1566721909457, 3249, 1566721909693, 3485, 236, true
1501, 1566721909457, 3249, 1566721909693, 3485, 236, true
1502, 1566721909459, 3251, 1566721909693, 3485, 234, true
1503, 1566721909460, 3252, 1566721909693, 3485, 233, true
1504, 1566721909462, 3254, 1566721909693, 3485, 231, true
1505, 1566721909463, 3255, 1566721909693, 3485, 230, true
1506, 1566721909466, 3258, 1566721909693, 3485, 227, true
1507, 1566721909466, 3258, 1566721909693, 3485, 227, true
1508, 1566721909467, 3259, 1566721909692, 3484, 225, true
1509, 1566721909472, 3264, 1566721909687, 3479, 215, true
1510, 1566721909476, 3268, 1566721909689, 3481, 213, true
1511, 1566721909478, 3270, 1566721909691, 3483, 213, true
1512, 1566721909479, 3271, 1566721909691, 3483, 212, true
1513, 1566721909481, 3273, 1566721909694, 3486, 213, true
1514, 1566721909481, 3273, 1566721909715, 3507, 234, true
1515, 1566721909482, 3274, 1566721909715, 3507, 233, true
1516, 1566721909491, 3283, 1566721909819, 3611, 328, true
1517, 1566721909491, 3283, 1566721909823, 3615, 332, true
1518, 1566721909491, 3283, 1566721909814, 3606, 323, true
1519, 1566721909493, 3285, 1566721909816, 3608, 323, true
1520, 1566721909493, 3285, 1566721909820, 3612, 327, true
1521, 1566721909494, 3286, 1566721909806, 3598, 312, true
1522, 1566721909494, 3286, 1566721909823, 3615, 329, true
1523, 1566721909494, 3286, 1566721909813, 3605, 319, true
1524, 1566721909494, 3286, 1566721909815, 3607, 321, true
1525, 1566721909495, 3287, 1566721909814, 3606, 319, true
1526, 1566721909497, 3289, 1566721909813, 3605, 316, true
1527, 1566721909497, 3289, 1566721909881, 3673, 384, true
1528, 1566721909497, 3289, 1566721909880, 3672, 383, true
1529, 1566721909497, 3289, 1566721909882, 3674, 385, true
1530, 1566721909498, 3290, 1566721909877, 3669, 379, true
1531, 1566721909498, 3290, 1566721909785, 3577, 287, true
1532, 1566721909498, 3290, 1566721909822, 3614, 324, true
1533, 1566721909498, 3290, 1566721909791, 3583, 293, true
1534, 1566721909499, 3291, 1566721909803, 3595, 304, true
1535, 1566721909501, 3293, 1566721909716, 3508, 215, true
1536, 1566721909501, 3293, 1566721909885, 3677, 384, true
1537, 1566721909515, 3307, 1566721909879, 3671, 364, true
1538, 1566721909516, 3308, 1566721909882, 3674, 366, true
1539, 1566721909517, 3309, 1566721909877, 3669, 360, true
1540, 1566721909517, 3309, 1566721909877, 3669, 360, true
1541, 1566721909517, 3309, 1566721909884, 3676, 367, true
1542, 1566721909517, 3309, 1566721909873, 3665, 356, true
1543, 1566721909517, 3309, 1566721909863, 3655, 346, true
1544, 1566721909518, 3310, 1566721909863, 3655, 345, true
1545, 1566721909518, 3310, 1566721909864, 3656, 346, true
1546, 1566721909518, 3310, 1566721909873, 3665, 355, true
1547, 1566721909518, 3310, 1566721909873, 3665, 355, true
1548, 1566721909521, 3313, 1566721909884, 3676, 363, true
1549, 1566721909521, 3313, 1566721909884, 3676, 363, true
1550, 1566721909521, 3313, 1566721909876, 3668, 355, true
1551, 1566721909522, 3314, 1566721909879, 3671, 357, true
1552, 1566721909522, 3314, 1566721909865, 3657, 343, true
1553, 1566721909524, 3316, 1566721909879, 3671, 355, true
1554, 1566721909524, 3316, 1566721909883, 3675, 359, true
1555, 1566721909524, 3316, 1566721909875, 3667, 351, true
1556, 1566721909525, 3317, 1566721909873, 3665, 348, true
1557, 1566721909525, 3317, 1566721909880, 3672, 355, true
1558, 1566721909525, 3317, 1566721909878, 3670, 353, true
1559, 1566721909526, 3318, 1566721909879, 3671, 353, true
1560, 1566721909526, 3318, 1566721909873, 3665, 347, true
1561, 1566721909526, 3318, 1566721909881, 3673, 355, true
1562, 1566721909527, 3319, 1566721909881, 3673, 354, true
1563, 1566721909527, 3319, 1566721909879, 3671, 352, true
1564, 1566721909527, 3319, 1566721909882, 3674, 355, true
1565, 1566721909527, 3319, 1566721909875, 3667, 348, true
1566, 1566721909527, 3319, 1566721909882, 3674, 355, true
1567, 1566721909528, 3320, 1566721909875, 3667, 347, true
1568, 1566721909528, 3320, 1566721909883, 3675, 355, true
1569, 1566721909528, 3320, 1566721909883, 3675, 355, true
1570, 1566721909529, 3321, 1566721909817, 3609, 288, true
1571, 1566721909530, 3322, 1566721909823, 3615, 293, true
1572, 1566721909530, 3322, 1566721909806, 3598, 276, true
1573, 1566721909530, 3322, 1566721909815, 3607, 285, true
1574, 1566721909532, 3324, 1566721909817, 3609, 285, true
1575, 1566721909532, 3324, 1566721909816, 3608, 284, true
1576, 1566721909532, 3324, 1566721909815, 3607, 283, true
1577, 1566721909533, 3325, 1566721909817, 3609, 284, true
1578, 1566721909533, 3325, 1566721909823, 3615, 290, true
1579, 1566721909533, 3325, 1566721909815, 3607, 282, true
1580, 1566721909534, 3326, 1566721909812, 3604, 278, true
1581, 1566721909534, 3326, 1566721909826, 3618, 292, true
1582, 1566721909534, 3326, 1566721909822, 3614, 288, true
1583, 1566721909535, 3327, 1566721909816, 3608, 281, true
1584, 1566721909535, 3327, 1566721909823, 3615, 288, true
1585, 1566721909535, 3327, 1566721909823, 3615, 288, true
1586, 1566721909536, 3328, 1566721909804, 3596, 268, true
1587, 1566721909536, 3328, 1566721909816, 3608, 280, true
1588, 1566721909537, 3329, 1566721909814, 3606, 277, true
1589, 1566721909537, 3329, 1566721909814, 3606, 277, true
1590, 1566721909537, 3329, 1566721909813, 3605, 276, true
1591, 1566721909538, 3330, 1566721909814, 3606, 276, true
1592, 1566721909538, 3330, 1566721909817, 3609, 279, true
1593, 1566721909539, 3331, 1566721909823, 3615, 284, true
1594, 1566721909539, 3331, 1566721909816, 3608, 277, true
1595, 1566721909540, 3332, 1566721909823, 3615, 283, true
1596, 1566721909540, 3332, 1566721909806, 3598, 266, true
1597, 1566721909540, 3332, 1566721909816, 3608, 276, true
1598, 1566721909541, 3333, 1566721909804, 3596, 263, true
1599, 1566721909541, 3333, 1566721909813, 3605, 272, true
1600, 1566721909541, 3333, 1566721909805, 3597, 264, true
1601, 1566721909542, 3334, 1566721909814, 3606, 272, true
1602, 1566721909542, 3334, 1566721909823, 3615, 281, true
1603, 1566721909542, 3334, 1566721909813, 3605, 271, true
1604, 1566721909543, 3335, 1566721909823, 3615, 280, true
1605, 1566721909543, 3335, 1566721909804, 3596, 261, true
1606, 1566721909544, 3336, 1566721909804, 3596, 260, true
1607, 1566721909544, 3336, 1566721909825, 3617, 281, true
1608, 1566721909545, 3337, 1566721909823, 3615, 278, true
1609, 1566721909545, 3337, 1566721909817, 3609, 272, true
1610, 1566721909545, 3337, 1566721909804, 3596, 259, true
1611, 1566721909546, 3338, 1566721909815, 3607, 269, true
1612, 1566721909546, 3338, 1566721909823, 3615, 277, true
1613, 1566721909547, 3339, 1566721909813, 3605, 266, true
1614, 1566721909547, 3339, 1566721909815, 3607, 268, true
1615, 1566721909547, 3339, 1566721909817, 3609, 270, true
1616, 1566721909571, 3363, 1566721909806, 3598, 235, true
1617, 1566721909695, 3487, 1566721909903, 3695, 208, true
1618, 1566721909696, 3488, 1566721909903, 3695, 207, true
1619, 1566721909697, 3489, 1566721909901, 3693, 204, true
1620, 1566721909699, 3491, 1566721909910, 3702, 211, true
1621, 1566721909699, 3491, 1566721909909, 3701, 210, true
1622, 1566721909700, 3492, 1566721909909, 3701, 209, true
1623, 1566721909700, 3492, 1566721909909, 3701, 209, true
1624, 1566721909700, 3492, 1566721909909, 3701, 209, true
1625, 1566721909702, 3494, 1566721909909, 3701, 207, true
1626, 1566721909703, 3495, 1566721909910, 3702, 207, true
1627, 1566721909703, 3495, 1566721909910, 3702, 207, true
1628, 1566721909705, 3497, 1566721909913, 3705, 208, true
1629, 1566721909706, 3498, 1566721909910, 3702, 204, true
1630, 1566721909706, 3498, 1566721909916, 3708, 210, true
1631, 1566721909707, 3499, 1566721909916, 3708, 209, true
1632, 1566721909709, 3501, 1566721909916, 3708, 207, true
1633, 1566721909709, 3501, 1566721909916, 3708, 207, true
1634, 1566721909710, 3502, 1566721909917, 3709, 207, true
1635, 1566721909711, 3503, 1566721909917, 3709, 206, true
1636, 1566721909712, 3504, 1566721909922, 3714, 210, true
1637, 1566721909712, 3504, 1566721909921, 3713, 209, true
1638, 1566721909716, 3508, 1566721909925, 3717, 209, true
1639, 1566721909717, 3509, 1566721909925, 3717, 208, true
1640, 1566721909718, 3510, 1566721909924, 3716, 206, true
1641, 1566721909719, 3511, 1566721909924, 3716, 205, true
1642, 1566721909720, 3512, 1566721909924, 3716, 204, true
1643, 1566721909721, 3513, 1566721909932, 3724, 211, true
1644, 1566721909722, 3514, 1566721909932, 3724, 210, true
1645, 1566721909722, 3514, 1566721909932, 3724, 210, true
1646, 1566721909722, 3514, 1566721909932, 3724, 210, true
1647, 1566721909722, 3514, 1566721909933, 3725, 211, true
1648, 1566721909723, 3515, 1566721909932, 3724, 209, true
1649, 1566721909723, 3515, 1566721909932, 3724, 209, true
1650, 1566721909723, 3515, 1566721909932, 3724, 209, true
1651, 1566721909723, 3515, 1566721909932, 3724, 209, true
1652, 1566721909726, 3518, 1566721909932, 3724, 206, true
1653, 1566721909726, 3518, 1566721909932, 3724, 206, true
1654, 1566721909727, 3519, 1566721909934, 3726, 207, true
1655, 1566721909728, 3520, 1566721909936, 3728, 208, true
1656, 1566721909729, 3521, 1566721909938, 3730, 209, true
1657, 1566721909729, 3521, 1566721909938, 3730, 209, true
1658, 1566721909730, 3522, 1566721909933, 3725, 203, true
1659, 1566721909731, 3523, 1566721909939, 3731, 208, true
1660, 1566721909732, 3524, 1566721909942, 3734, 210, true
1661, 1566721909733, 3525, 1566721909942, 3734, 209, true
1662, 1566721909733, 3525, 1566721909940, 3732, 207, true
1663, 1566721909733, 3525, 1566721909942, 3734, 209, true
1664, 1566721909734, 3526, 1566721909942, 3734, 208, true
1665, 1566721909734, 3526, 1566721909940, 3732, 206, true
1666, 1566721909736, 3528, 1566721909944, 3736, 208, true
1667, 1566721909736, 3528, 1566721909944, 3736, 208, true
1668, 1566721909737, 3529, 1566721909945, 3737, 208, true
1669, 1566721909737, 3529, 1566721909944, 3736, 207, true
1670, 1566721909738, 3530, 1566721909945, 3737, 207, true
1671, 1566721909739, 3531, 1566721909968, 3760, 229, true
1672, 1566721909740, 3532, 1566721909969, 3761, 229, true
1673, 1566721909740, 3532, 1566721909969, 3761, 229, true
1674, 1566721909741, 3533, 1566721909968, 3760, 227, true
1675, 1566721909741, 3533, 1566721909968, 3760, 227, true
1676, 1566721909742, 3534, 1566721910237, 4029, 495, true
1677, 1566721909743, 3535, 1566721910216, 4008, 473, true
1678, 1566721909743, 3535, 1566721910215, 4007, 472, true
1679, 1566721909743, 3535, 1566721910223, 4015, 480, true
1680, 1566721909743, 3535, 1566721910217, 4009, 474, true
1681, 1566721909744, 3536, 1566721910237, 4029, 493, true
1682, 1566721909744, 3536, 1566721910237, 4029, 493, true
1683, 1566721909744, 3536, 1566721910237, 4029, 493, true
1684, 1566721909744, 3536, 1566721910227, 4019, 483, true
1685, 1566721909744, 3536, 1566721910213, 4005, 469, true
1686, 1566721909744, 3536, 1566721910227, 4019, 483, true
1687, 1566721909745, 3537, 1566721910236, 4028, 491, true
1688, 1566721909745, 3537, 1566721910216, 4008, 471, true
1689, 1566721909745, 3537, 1566721910228, 4020, 483, true
1690, 1566721909745, 3537, 1566721909968, 3760, 223, true
1691, 1566721909746, 3538, 1566721910236, 4028, 490, true
1692, 1566721909746, 3538, 1566721910227, 4019, 481, true
1693, 1566721909746, 3538, 1566721909967, 3759, 221, true
1694, 1566721909747, 3539, 1566721909968, 3760, 221, true
1695, 1566721909748, 3540, 1566721909967, 3759, 219, true
1696, 1566721909749, 3541, 1566721909967, 3759, 218, true
1697, 1566721909750, 3542, 1566721909967, 3759, 217, true
1698, 1566721909751, 3543, 1566721909966, 3758, 215, true
1699, 1566721909752, 3544, 1566721909966, 3758, 214, true
1700, 1566721909753, 3545, 1566721909966, 3758, 213, true
1701, 1566721909753, 3545, 1566721909964, 3756, 211, true
1702, 1566721909755, 3547, 1566721909964, 3756, 209, true
1703, 1566721909755, 3547, 1566721909967, 3759, 212, true
1704, 1566721909756, 3548, 1566721909964, 3756, 208, true
1705, 1566721909758, 3550, 1566721909966, 3758, 208, true
1706, 1566721909758, 3550, 1566721909966, 3758, 208, true
1707, 1566721909759, 3551, 1566721909966, 3758, 207, true
1708, 1566721909760, 3552, 1566721909967, 3759, 207, true
1709, 1566721909762, 3554, 1566721909969, 3761, 207, true
1710, 1566721909762, 3554, 1566721909968, 3760, 206, true
1711, 1566721909763, 3555, 1566721909968, 3760, 205, true
1712, 1566721909764, 3556, 1566721909970, 3762, 206, true
1713, 1566721909765, 3557, 1566721909970, 3762, 205, true
1714, 1566721909765, 3557, 1566721909970, 3762, 205, true
1715, 1566721909768, 3560, 1566721909975, 3767, 207, true
1716, 1566721909768, 3560, 1566721909975, 3767, 207, true
1717, 1566721909769, 3561, 1566721909973, 3765, 204, true
1718, 1566721909769, 3561, 1566721909975, 3767, 206, true
1719, 1566721909772, 3564, 1566721909988, 3780, 216, true
1720, 1566721909773, 3565, 1566721909988, 3780, 215, true
1721, 1566721909774, 3566, 1566721909988, 3780, 214, true
1722, 1566721909776, 3568, 1566721909988, 3780, 212, true
1723, 1566721909776, 3568, 1566721909987, 3779, 211, true
1724, 1566721909778, 3570, 1566721909987, 3779, 209, true
1725, 1566721909778, 3570, 1566721909987, 3779, 209, true
1726, 1566721909779, 3571, 1566721909987, 3779, 208, true
1727, 1566721909780, 3572, 1566721909987, 3779, 207, true
1728, 1566721909781, 3573, 1566721909997, 3789, 216, true
1729, 1566721909782, 3574, 1566721909987, 3779, 205, true
1730, 1566721909782, 3574, 1566721909996, 3788, 214, true
1731, 1566721909785, 3577, 1566721909998, 3790, 213, true
1732, 1566721909785, 3577, 1566721909997, 3789, 212, true
1733, 1566721909787, 3579, 1566721909998, 3790, 211, true
1734, 1566721909787, 3579, 1566721909999, 3791, 212, true
1735, 1566721909789, 3581, 1566721910000, 3792, 211, true
1736, 1566721909789, 3581, 1566721909999, 3791, 210, true
1737, 1566721909791, 3583, 1566721910001, 3793, 210, true
1738, 1566721909792, 3584, 1566721910005, 3797, 213, true
1739, 1566721909793, 3585, 1566721910005, 3797, 212, true
1740, 1566721909794, 3586, 1566721910005, 3797, 211, true
1741, 1566721909796, 3588, 1566721910005, 3797, 209, true
1742, 1566721909796, 3588, 1566721910005, 3797, 209, true
1743, 1566721909798, 3590, 1566721910015, 3807, 217, true
1744, 1566721909798, 3590, 1566721910005, 3797, 207, true
1745, 1566721909799, 3591, 1566721910005, 3797, 206, true
1746, 1566721909800, 3592, 1566721910009, 3801, 209, true
1747, 1566721909829, 3621, 1566721910034, 3826, 205, true
1748, 1566721909831, 3623, 1566721910034, 3826, 203, true
1749, 1566721909833, 3625, 1566721910037, 3829, 204, true
1750, 1566721909834, 3626, 1566721910037, 3829, 203, true
1751, 1566721909836, 3628, 1566721910039, 3831, 203, true
1752, 1566721909837, 3629, 1566721910238, 4030, 401, true
1753, 1566721909838, 3630, 1566721910226, 4018, 388, true
1754, 1566721909838, 3630, 1566721910228, 4020, 390, true
1755, 1566721909838, 3630, 1566721910224, 4016, 386, true
1756, 1566721909839, 3631, 1566721910215, 4007, 376, true
1757, 1566721909839, 3631, 1566721910236, 4028, 397, true
1758, 1566721909840, 3632, 1566721910236, 4028, 396, true
1759, 1566721909840, 3632, 1566721910220, 4012, 380, true
1760, 1566721909840, 3632, 1566721910226, 4018, 386, true
1761, 1566721909841, 3633, 1566721910236, 4028, 395, true
1762, 1566721909841, 3633, 1566721910236, 4028, 395, true
1763, 1566721909842, 3634, 1566721910221, 4013, 379, true
1764, 1566721909842, 3634, 1566721910237, 4029, 395, true
1765, 1566721909843, 3635, 1566721910216, 4008, 373, true
1766, 1566721909843, 3635, 1566721910228, 4020, 385, true
1767, 1566721909843, 3635, 1566721910212, 4004, 369, true
1768, 1566721909844, 3636, 1566721910237, 4029, 393, true
1769, 1566721909844, 3636, 1566721910224, 4016, 380, true
1770, 1566721909845, 3637, 1566721910213, 4005, 368, true
1771, 1566721909845, 3637, 1566721910213, 4005, 368, true
1772, 1566721909845, 3637, 1566721910228, 4020, 383, true
1773, 1566721909846, 3638, 1566721910213, 4005, 367, true
1774, 1566721909846, 3638, 1566721910238, 4030, 392, true
1775, 1566721909846, 3638, 1566721910220, 4012, 374, true
1776, 1566721909846, 3638, 1566721910216, 4008, 370, true
1777, 1566721909847, 3639, 1566721910227, 4019, 380, true
1778, 1566721909847, 3639, 1566721910213, 4005, 366, true
1779, 1566721909847, 3639, 1566721910227, 4019, 380, true
1780, 1566721909847, 3639, 1566721910215, 4007, 368, true
1781, 1566721909848, 3640, 1566721910238, 4030, 390, true
1782, 1566721909848, 3640, 1566721910227, 4019, 379, true
1783, 1566721909848, 3640, 1566721910235, 4027, 387, true
1784, 1566721909848, 3640, 1566721910246, 4038, 398, true
1785, 1566721909848, 3640, 1566721910248, 4040, 400, true
1786, 1566721909848, 3640, 1566721910239, 4031, 391, true
1787, 1566721909849, 3641, 1566721910238, 4030, 389, true
1788, 1566721909849, 3641, 1566721910248, 4040, 399, true
1789, 1566721909849, 3641, 1566721910246, 4038, 397, true
1790, 1566721909849, 3641, 1566721910238, 4030, 389, true
1791, 1566721909849, 3641, 1566721910249, 4041, 400, true
1792, 1566721909850, 3642, 1566721910248, 4040, 398, true
1793, 1566721909850, 3642, 1566721910249, 4041, 399, true
1794, 1566721909850, 3642, 1566721910248, 4040, 398, true
1795, 1566721909850, 3642, 1566721910247, 4039, 397, true
1796, 1566721909851, 3643, 1566721910239, 4031, 388, true
1797, 1566721909851, 3643, 1566721910246, 4038, 395, true
1798, 1566721909851, 3643, 1566721910249, 4041, 398, true
1799, 1566721909851, 3643, 1566721910248, 4040, 397, true
1800, 1566721909852, 3644, 1566721910247, 4039, 395, true
1801, 1566721909852, 3644, 1566721910249, 4041, 397, true
1802, 1566721909852, 3644, 1566721910247, 4039, 395, true
1803, 1566721909852, 3644, 1566721910249, 4041, 397, true
1804, 1566721909852, 3644, 1566721910248, 4040, 396, true
1805, 1566721909853, 3645, 1566721910239, 4031, 386, true
1806, 1566721909853, 3645, 1566721910238, 4030, 385, true
1807, 1566721909853, 3645, 1566721910060, 3852, 207, true
1808, 1566721909853, 3645, 1566721910061, 3853, 208, true
1809, 1566721909854, 3646, 1566721910060, 3852, 206, true
1810, 1566721909856, 3648, 1566721910061, 3853, 205, true
1811, 1566721909856, 3648, 1566721910060, 3852, 204, true
1812, 1566721909857, 3649, 1566721910061, 3853, 204, true
1813, 1566721909859, 3651, 1566721910065, 3857, 206, true
1814, 1566721909860, 3652, 1566721910066, 3858, 206, true
1815, 1566721909862, 3654, 1566721910069, 3861, 207, true
1816, 1566721909865, 3657, 1566721910071, 3863, 206, true
1817, 1566721909865, 3657, 1566721910071, 3863, 206, true
1818, 1566721909866, 3658, 1566721910071, 3863, 205, true
1819, 1566721909867, 3659, 1566721910071, 3863, 204, true
1820, 1566721909868, 3660, 1566721910071, 3863, 203, true
1821, 1566721909869, 3661, 1566721910072, 3864, 203, true
1822, 1566721909870, 3662, 1566721910088, 3880, 218, true
1823, 1566721909886, 3678, 1566721910098, 3890, 212, true
1824, 1566721909888, 3680, 1566721910098, 3890, 210, true
1825, 1566721909890, 3682, 1566721910098, 3890, 208, true
1826, 1566721909891, 3683, 1566721910098, 3890, 207, true
1827, 1566721909894, 3686, 1566721910106, 3898, 212, true
1828, 1566721909895, 3687, 1566721910106, 3898, 211, true
1829, 1566721909896, 3688, 1566721910107, 3899, 211, true
1830, 1566721909897, 3689, 1566721910249, 4041, 352, true
1831, 1566721909897, 3689, 1566721910249, 4041, 352, true
1832, 1566721909897, 3689, 1566721910247, 4039, 350, true
1833, 1566721909898, 3690, 1566721910239, 4031, 341, true
1834, 1566721909898, 3690, 1566721910240, 4032, 342, true
1835, 1566721909898, 3690, 1566721910239, 4031, 341, true
1836, 1566721909898, 3690, 1566721910248, 4040, 350, true
1837, 1566721909898, 3690, 1566721910247, 4039, 349, true
1838, 1566721909898, 3690, 1566721910239, 4031, 341, true
1839, 1566721909899, 3691, 1566721910247, 4039, 348, true
1840, 1566721909899, 3691, 1566721910239, 4031, 340, true
1841, 1566721909899, 3691, 1566721910239, 4031, 340, true
1842, 1566721909900, 3692, 1566721910239, 4031, 339, true
1843, 1566721909900, 3692, 1566721910246, 4038, 346, true
1844, 1566721909901, 3693, 1566721910105, 3897, 204, true
1845, 1566721909903, 3695, 1566721910108, 3900, 205, true
1846, 1566721909903, 3695, 1566721910108, 3900, 205, true
1847, 1566721909904, 3696, 1566721910249, 4041, 345, true
1848, 1566721909905, 3697, 1566721910239, 4031, 334, true
1849, 1566721909905, 3697, 1566721910238, 4030, 333, true
1850, 1566721909905, 3697, 1566721910239, 4031, 334, true
1851, 1566721909906, 3698, 1566721910249, 4041, 343, true
1852, 1566721909906, 3698, 1566721910246, 4038, 340, true
1853, 1566721909906, 3698, 1566721910249, 4041, 343, true
1854, 1566721909906, 3698, 1566721910246, 4038, 340, true
1855, 1566721909907, 3699, 1566721910239, 4031, 332, true
1856, 1566721909911, 3703, 1566721910115, 3907, 204, true
1857, 1566721909913, 3705, 1566721910116, 3908, 203, true
1858, 1566721909914, 3706, 1566721910116, 3908, 202, true
1859, 1566721909918, 3710, 1566721910123, 3915, 205, true
1860, 1566721909918, 3710, 1566721910123, 3915, 205, true
1861, 1566721909919, 3711, 1566721910123, 3915, 204, true
1862, 1566721909920, 3712, 1566721910123, 3915, 203, true
1863, 1566721909922, 3714, 1566721910126, 3918, 204, true
1864, 1566721909922, 3714, 1566721910130, 3922, 208, true
1865, 1566721909926, 3718, 1566721910135, 3927, 209, true
1866, 1566721909926, 3718, 1566721910137, 3929, 211, true
1867, 1566721909935, 3727, 1566721910145, 3937, 210, true
1868, 1566721909988, 3780, 1566721910216, 4008, 228, true
1869, 1566721910047, 3839, 1566721910251, 4043, 204, true
1870, 1566721910049, 3841, 1566721910255, 4047, 206, true
1871, 1566721910050, 3842, 1566721910255, 4047, 205, true
1872, 1566721910052, 3844, 1566721910260, 4052, 208, true
1873, 1566721910053, 3845, 1566721910260, 4052, 207, true
1874, 1566721910055, 3847, 1566721910260, 4052, 205, true
1875, 1566721910057, 3849, 1566721910269, 4061, 212, true
1876, 1566721910062, 3854, 1566721910268, 4060, 206, true
1877, 1566721910064, 3856, 1566721910269, 4061, 205, true
1878, 1566721910066, 3858, 1566721910270, 4062, 204, true
1879, 1566721910066, 3858, 1566721910270, 4062, 204, true
1880, 1566721910067, 3859, 1566721910272, 4064, 205, true
1881, 1566721910068, 3860, 1566721910274, 4066, 206, true
1882, 1566721910073, 3865, 1566721910281, 4073, 208, true
1883, 1566721910074, 3866, 1566721910285, 4077, 211, true
1884, 1566721910075, 3867, 1566721910281, 4073, 206, true
1885, 1566721910075, 3867, 1566721910285, 4077, 210, true
1886, 1566721910077, 3869, 1566721910286, 4078, 209, true
1887, 1566721910077, 3869, 1566721910286, 4078, 209, true
1888, 1566721910078, 3870, 1566721910286, 4078, 208, true
1889, 1566721910079, 3871, 1566721910286, 4078, 207, true
1890, 1566721910080, 3872, 1566721910287, 4079, 207, true
1891, 1566721910081, 3873, 1566721910287, 4079, 206, true
1892, 1566721910083, 3875, 1566721910292, 4084, 209, true
1893, 1566721910083, 3875, 1566721910292, 4084, 209, true
1894, 1566721910084, 3876, 1566721910292, 4084, 208, true
1895, 1566721910085, 3877, 1566721910296, 4088, 211, true
1896, 1566721910086, 3878, 1566721910296, 4088, 210, true
1897, 1566721910089, 3881, 1566721910296, 4088, 207, true
1898, 1566721910089, 3881, 1566721910296, 4088, 207, true
1899, 1566721910090, 3882, 1566721910296, 4088, 206, true
1900, 1566721910092, 3884, 1566721910297, 4089, 205, true
1901, 1566721910092, 3884, 1566721910307, 4099, 215, true
1902, 1566721910093, 3885, 1566721910297, 4089, 204, true
1903, 1566721910094, 3886, 1566721910307, 4099, 213, true
1904, 1566721910095, 3887, 1566721910308, 4100, 213, true
1905, 1566721910098, 3890, 1566721910308, 4100, 210, true
1906, 1566721910099, 3891, 1566721910308, 4100, 209, true
1907, 1566721910100, 3892, 1566721910308, 4100, 208, true
1908, 1566721910100, 3892, 1566721910308, 4100, 208, true
1909, 1566721910101, 3893, 1566721910313, 4105, 212, true
1910, 1566721910102, 3894, 1566721910313, 4105, 211, true
1911, 1566721910104, 3896, 1566721910313, 4105, 209, true
1912, 1566721910109, 3901, 1566721910316, 4108, 207, true
1913, 1566721910110, 3902, 1566721910315, 4107, 205, true
1914, 1566721910110, 3902, 1566721910316, 4108, 206, true
1915, 1566721910111, 3903, 1566721910320, 4112, 209, true
1916, 1566721910111, 3903, 1566721910320, 4112, 209, true
1917, 1566721910112, 3904, 1566721910317, 4109, 205, true
1918, 1566721910114, 3906, 1566721910320, 4112, 206, true
1919, 1566721910118, 3910, 1566721910324, 4116, 206, true
1920, 1566721910119, 3911, 1566721910324, 4116, 205, true
1921, 1566721910119, 3911, 1566721910323, 4115, 204, true
1922, 1566721910120, 3912, 1566721910332, 4124, 212, true
1923, 1566721910121, 3913, 1566721910327, 4119, 206, true
1924, 1566721910124, 3916, 1566721910332, 4124, 208, true
1925, 1566721910125, 3917, 1566721910332, 4124, 207, true
1926, 1566721910127, 3919, 1566721910332, 4124, 205, true
1927, 1566721910127, 3919, 1566721910332, 4124, 205, true
1928, 1566721910128, 3920, 1566721910333, 4125, 205, true
1929, 1566721910128, 3920, 1566721910334, 4126, 206, true
1930, 1566721910131, 3923, 1566721910336, 4128, 205, true
1931, 1566721910131, 3923, 1566721910336, 4128, 205, true
1932, 1566721910132, 3924, 1566721910344, 4136, 212, true
1933, 1566721910134, 3926, 1566721910345, 4137, 211, true
1934, 1566721910137, 3929, 1566721910345, 4137, 208, true
1935, 1566721910137, 3929, 1566721910345, 4137, 208, true
1936, 1566721910138, 3930, 1566721910348, 4140, 210, true
1937, 1566721910139, 3931, 1566721910348, 4140, 209, true
1938, 1566721910140, 3932, 1566721910349, 4141, 209, true
1939, 1566721910141, 3933, 1566721910349, 4141, 208, true
1940, 1566721910143, 3935, 1566721910351, 4143, 208, true
1941, 1566721910143, 3935, 1566721910353, 4145, 210, true
1942, 1566721910144, 3936, 1566721910353, 4145, 209, true
1943, 1566721910146, 3938, 1566721910352, 4144, 206, true
1944, 1566721910146, 3938, 1566721910353, 4145, 207, true
1945, 1566721910148, 3940, 1566721910355, 4147, 207, true
1946, 1566721910153, 3945, 1566721910359, 4151, 206, true
1947, 1566721910155, 3947, 1566721910360, 4152, 205, true
1948, 1566721910156, 3948, 1566721910362, 4154, 206, true
1949, 1566721910158, 3950, 1566721910365, 4157, 207, true
1950, 1566721910159, 3951, 1566721910364, 4156, 205, true
1951, 1566721910160, 3952, 1566721910364, 4156, 204, true
1952, 1566721910161, 3953, 1566721910367, 4159, 206, true
1953, 1566721910162, 3954, 1566721910366, 4158, 204, true
1954, 1566721910163, 3955, 1566721910367, 4159, 204, true
1955, 1566721910164, 3956, 1566721910369, 4161, 205, true
1956, 1566721910165, 3957, 1566721910375, 4167, 210, true
1957, 1566721910166, 3958, 1566721910375, 4167, 209, true
1958, 1566721910167, 3959, 1566721910370, 4162, 203, true
1959, 1566721910169, 3961, 1566721910376, 4168, 207, true
1960, 1566721910169, 3961, 1566721910375, 4167, 206, true
1961, 1566721910170, 3962, 1566721910376, 4168, 206, true
1962, 1566721910171, 3963, 1566721910376, 4168, 205, true
1963, 1566721910173, 3965, 1566721910383, 4175, 210, true
1964, 1566721910173, 3965, 1566721910384, 4176, 211, true
1965, 1566721910175, 3967, 1566721910384, 4176, 209, true
1966, 1566721910175, 3967, 1566721910384, 4176, 209, true
1967, 1566721910177, 3969, 1566721910385, 4177, 208, true
1968, 1566721910177, 3969, 1566721910385, 4177, 208, true
1969, 1566721910178, 3970, 1566721910386, 4178, 208, true
1970, 1566721910179, 3971, 1566721910386, 4178, 207, true
1971, 1566721910181, 3973, 1566721910393, 4185, 212, true
1972, 1566721910182, 3974, 1566721910398, 4190, 216, true
1973, 1566721910183, 3975, 1566721910398, 4190, 215, true
1974, 1566721910183, 3975, 1566721910398, 4190, 215, true
1975, 1566721910184, 3976, 1566721910401, 4193, 217, true
1976, 1566721910185, 3977, 1566721910398, 4190, 213, true
1977, 1566721910186, 3978, 1566721910401, 4193, 215, true
1978, 1566721910187, 3979, 1566721910401, 4193, 214, true
1979, 1566721910189, 3981, 1566721910401, 4193, 212, true
1980, 1566721910190, 3982, 1566721910399, 4191, 209, true
1981, 1566721910190, 3982, 1566721910401, 4193, 211, true
1982, 1566721910191, 3983, 1566721910401, 4193, 210, true
1983, 1566721910192, 3984, 1566721910398, 4190, 206, true
1984, 1566721910205, 3997, 1566721910421, 4213, 216, true
1985, 1566721910289, 4081, 1566721910494, 4286, 205, true
1986, 1566721910293, 4085, 1566721910497, 4289, 204, true
1987, 1566721910299, 4091, 1566721910507, 4299, 208, true
1988, 1566721910300, 4092, 1566721910507, 4299, 207, true
1989, 1566721910301, 4093, 1566721910507, 4299, 206, true
1990, 1566721910303, 4095, 1566721910508, 4300, 205, true
1991, 1566721910304, 4096, 1566721910509, 4301, 205, true
1992, 1566721910304, 4096, 1566721910511, 4303, 207, true
1993, 1566721910309, 4101, 1566721910514, 4306, 205, true
1994, 1566721910309, 4101, 1566721910514, 4306, 205, true
1995, 1566721910311, 4103, 1566721910515, 4307, 204, true
1996, 1566721910317, 4109, 1566721910524, 4316, 207, true
1997, 1566721910318, 4110, 1566721910524, 4316, 206, true
1998, 1566721910321, 4113, 1566721910530, 4322, 209, true
1999, 1566721910321, 4113, 1566721910530, 4322, 209, true
2000, 1566721910321, 4113, 1566721910530, 4322, 209, true
2001, 1566721910322, 4114, 1566721910536, 4328, 214, true
2002, 1566721910325, 4117, 1566721910530, 4322, 205, true
2003, 1566721910326, 4118, 1566721910534, 4326, 208, true
2004, 1566721910328, 4120, 1566721910536, 4328, 208, true
2005, 1566721910329, 4121, 1566721910540, 4332, 211, true
2006, 1566721910330, 4122, 1566721910540, 4332, 210, true
2007, 1566721910334, 4126, 1566721910540, 4332, 206, true
2008, 1566721910336, 4128, 1566721910540, 4332, 204, true
2009, 1566721910337, 4129, 1566721910542, 4334, 205, true
2010, 1566721910338, 4130, 1566721910560, 4352, 222, true
2011, 1566721910338, 4130, 1566721910547, 4339, 209, true
2012, 1566721910338, 4130, 1566721910557, 4349, 219, true
2013, 1566721910339, 4131, 1566721910548, 4340, 209, true
2014, 1566721910339, 4131, 1566721910580, 4372, 241, true
2015, 1566721910339, 4131, 1566721910580, 4372, 241, true
2016, 1566721910340, 4132, 1566721910580, 4372, 240, true
2017, 1566721910340, 4132, 1566721910587, 4379, 247, true
2018, 1566721910341, 4133, 1566721910585, 4377, 244, true
2019, 1566721910341, 4133, 1566721910586, 4378, 245, true
2020, 1566721910342, 4134, 1566721910580, 4372, 238, true
2021, 1566721910343, 4135, 1566721910584, 4376, 241, true
2022, 1566721910343, 4135, 1566721910580, 4372, 237, true
2023, 1566721910344, 4136, 1566721910563, 4355, 219, true
2024, 1566721910345, 4137, 1566721910561, 4353, 216, true
2025, 1566721910346, 4138, 1566721910561, 4353, 215, true
2026, 1566721910347, 4139, 1566721910563, 4355, 216, true
2027, 1566721910348, 4140, 1566721910559, 4351, 211, true
2028, 1566721910349, 4141, 1566721910560, 4352, 211, true
2029, 1566721910349, 4141, 1566721910563, 4355, 214, true
2030, 1566721910353, 4145, 1566721910563, 4355, 210, true
2031, 1566721910356, 4148, 1566721910563, 4355, 207, true
2032, 1566721910356, 4148, 1566721910563, 4355, 207, true
2033, 1566721910357, 4149, 1566721910565, 4357, 208, true
2034, 1566721910360, 4152, 1566721910567, 4359, 207, true
2035, 1566721910361, 4153, 1566721910566, 4358, 205, true
2036, 1566721910363, 4155, 1566721910567, 4359, 204, true
2037, 1566721910369, 4161, 1566721910584, 4376, 215, true
2038, 1566721910370, 4162, 1566721910584, 4376, 214, true
2039, 1566721910372, 4164, 1566721910586, 4378, 214, true
2040, 1566721910380, 4172, 1566721910586, 4378, 206, true
2041, 1566721910381, 4173, 1566721910590, 4382, 209, true
2042, 1566721910387, 4179, 1566721910594, 4386, 207, true
2043, 1566721910388, 4180, 1566721910594, 4386, 206, true
2044, 1566721910389, 4181, 1566721910594, 4386, 205, true
2045, 1566721910390, 4182, 1566721910597, 4389, 207, true
2046, 1566721910390, 4182, 1566721910596, 4388, 206, true
2047, 1566721910390, 4182, 1566721910598, 4390, 208, true
2048, 1566721910391, 4183, 1566721910599, 4391, 208, true
2049, 1566721910394, 4186, 1566721910608, 4400, 214, true
2050, 1566721910395, 4187, 1566721910608, 4400, 213, true
2051, 1566721910401, 4193, 1566721910609, 4401, 208, true
2052, 1566721910402, 4194, 1566721910616, 4408, 214, true
2053, 1566721910403, 4195, 1566721910611, 4403, 208, true
2054, 1566721910403, 4195, 1566721910609, 4401, 206, true
2055, 1566721910404, 4196, 1566721910615, 4407, 211, true
2056, 1566721910405, 4197, 1566721910615, 4407, 210, true
2057, 1566721910406, 4198, 1566721910613, 4405, 207, true
2058, 1566721910407, 4199, 1566721910616, 4408, 209, true
2059, 1566721910409, 4201, 1566721910615, 4407, 206, true
2060, 1566721910410, 4202, 1566721910616, 4408, 206, true
2061, 1566721910412, 4204, 1566721910616, 4408, 204, true
2062, 1566721910413, 4205, 1566721910616, 4408, 203, true
2063, 1566721910415, 4207, 1566721910620, 4412, 205, true
2064, 1566721910415, 4207, 1566721910622, 4414, 207, true
2065, 1566721910416, 4208, 1566721910629, 4421, 213, true
2066, 1566721910417, 4209, 1566721910634, 4426, 217, true
2067, 1566721910418, 4210, 1566721910634, 4426, 216, true
2068, 1566721910418, 4210, 1566721910626, 4418, 208, true
2069, 1566721910419, 4211, 1566721910626, 4418, 207, true
2070, 1566721910420, 4212, 1566721910634, 4426, 214, true
2071, 1566721910421, 4213, 1566721910634, 4426, 213, true
2072, 1566721910421, 4213, 1566721910634, 4426, 213, true
2073, 1566721910422, 4214, 1566721910634, 4426, 212, true
2074, 1566721910423, 4215, 1566721910634, 4426, 211, true
2075, 1566721910424, 4216, 1566721910634, 4426, 210, true
2076, 1566721910424, 4216, 1566721910634, 4426, 210, true
2077, 1566721910425, 4217, 1566721910634, 4426, 209, true
2078, 1566721910426, 4218, 1566721910634, 4426, 208, true
2079, 1566721910430, 4222, 1566721910637, 4429, 207, true
2080, 1566721910430, 4222, 1566721910637, 4429, 207, true
2081, 1566721910431, 4223, 1566721910637, 4429, 206, true
2082, 1566721910432, 4224, 1566721910637, 4429, 205, true
2083, 1566721910433, 4225, 1566721910637, 4429, 204, true
2084, 1566721910434, 4226, 1566721910645, 4437, 211, true
2085, 1566721910436, 4228, 1566721910645, 4437, 209, true
2086, 1566721910436, 4228, 1566721910640, 4432, 204, true
2087, 1566721910437, 4229, 1566721910645, 4437, 208, true
2088, 1566721910439, 4231, 1566721910647, 4439, 208, true
2089, 1566721910440, 4232, 1566721910647, 4439, 207, true
2090, 1566721910440, 4232, 1566721910647, 4439, 207, true
2091, 1566721910442, 4234, 1566721910647, 4439, 205, true
2092, 1566721910445, 4237, 1566721910654, 4446, 209, true
2093, 1566721910446, 4238, 1566721910657, 4449, 211, true
2094, 1566721910456, 4248, 1566721910661, 4453, 205, true
2095, 1566721910460, 4252, 1566721910664, 4456, 204, true
2096, 1566721910462, 4254, 1566721910666, 4458, 204, true
2097, 1566721910465, 4257, 1566721910668, 4460, 203, true
2098, 1566721910466, 4258, 1566721910672, 4464, 206, true
2099, 1566721910468, 4260, 1566721910672, 4464, 204, true
2100, 1566721910470, 4262, 1566721910675, 4467, 205, true
2101, 1566721910473, 4265, 1566721910677, 4469, 204, true
2102, 1566721910475, 4267, 1566721910680, 4472, 205, true
2103, 1566721910476, 4268, 1566721910680, 4472, 204, true
2104, 1566721910481, 4273, 1566721910688, 4480, 207, true
2105, 1566721910482, 4274, 1566721910689, 4481, 207, true
2106, 1566721910484, 4276, 1566721910689, 4481, 205, true
2107, 1566721910485, 4277, 1566721910689, 4481, 204, true
2108, 1566721910487, 4279, 1566721910694, 4486, 207, true
2109, 1566721910489, 4281, 1566721910701, 4493, 212, true
2110, 1566721910490, 4282, 1566721910697, 4489, 207, true
2111, 1566721910491, 4283, 1566721910701, 4493, 210, true
2112, 1566721910495, 4287, 1566721910701, 4493, 206, true
2113, 1566721910498, 4290, 1566721910704, 4496, 206, true
2114, 1566721910499, 4291, 1566721910704, 4496, 205, true
2115, 1566721910500, 4292, 1566721910708, 4500, 208, true
2116, 1566721910503, 4295, 1566721910711, 4503, 208, true
2117, 1566721910504, 4296, 1566721910711, 4503, 207, true
2118, 1566721910510, 4302, 1566721910715, 4507, 205, true
2119, 1566721910512, 4304, 1566721910718, 4510, 206, true
2120, 1566721910516, 4308, 1566721910721, 4513, 205, true
2121, 1566721910517, 4309, 1566721910720, 4512, 203, true
2122, 1566721910519, 4311, 1566721910722, 4514, 203, true
2123, 1566721910519, 4311, 1566721910722, 4514, 203, true
2124, 1566721910520, 4312, 1566721910723, 4515, 203, true
2125, 1566721910520, 4312, 1566721910729, 4521, 209, true
2126, 1566721910521, 4313, 1566721910730, 4522, 209, true
2127, 1566721910522, 4314, 1566721910729, 4521, 207, true
2128, 1566721910525, 4317, 1566721910730, 4522, 205, true
2129, 1566721910525, 4317, 1566721910730, 4522, 205, true
2130, 1566721910526, 4318, 1566721910735, 4527, 209, true
2131, 1566721910527, 4319, 1566721910735, 4527, 208, true
2132, 1566721910531, 4323, 1566721910735, 4527, 204, true
2133, 1566721910531, 4323, 1566721910735, 4527, 204, true
2134, 1566721910532, 4324, 1566721910740, 4532, 208, true
2135, 1566721910533, 4325, 1566721910740, 4532, 207, true
2136, 1566721910533, 4325, 1566721910740, 4532, 207, true
2137, 1566721910536, 4328, 1566721910740, 4532, 204, true
2138, 1566721910537, 4329, 1566721910746, 4538, 209, true
2139, 1566721910540, 4332, 1566721910743, 4535, 203, true
2140, 1566721910540, 4332, 1566721910743, 4535, 203, true
2141, 1566721910541, 4333, 1566721910747, 4539, 206, true
2142, 1566721910543, 4335, 1566721910747, 4539, 204, true
2143, 1566721910543, 4335, 1566721910747, 4539, 204, true
2144, 1566721910543, 4335, 1566721910748, 4540, 205, true
2145, 1566721910544, 4336, 1566721910748, 4540, 204, true
2146, 1566721910546, 4338, 1566721910750, 4542, 204, true
2147, 1566721910548, 4340, 1566721910752, 4544, 204, true
2148, 1566721910549, 4341, 1566721910752, 4544, 203, true
2149, 1566721910550, 4342, 1566721910755, 4547, 205, true
2150, 1566721910550, 4342, 1566721910755, 4547, 205, true
2151, 1566721910552, 4344, 1566721910758, 4550, 206, true
2152, 1566721910552, 4344, 1566721910758, 4550, 206, true
2153, 1566721910554, 4346, 1566721910759, 4551, 205, true
2154, 1566721910554, 4346, 1566721910758, 4550, 204, true
2155, 1566721910555, 4347, 1566721910771, 4563, 216, true
2156, 1566721910564, 4356, 1566721910775, 4567, 211, true
2157, 1566721910569, 4361, 1566721910772, 4564, 203, true
2158, 1566721910571, 4363, 1566721910775, 4567, 204, true
2159, 1566721910572, 4364, 1566721910775, 4567, 203, true
2160, 1566721910574, 4366, 1566721910777, 4569, 203, true
2161, 1566721910575, 4367, 1566721910777, 4569, 202, true
2162, 1566721910576, 4368, 1566721910783, 4575, 207, true
2163, 1566721910588, 4380, 1566721910792, 4584, 204, true
2164, 1566721910590, 4382, 1566721910797, 4589, 207, true
2165, 1566721910592, 4384, 1566721910797, 4589, 205, true
2166, 1566721910595, 4387, 1566721910800, 4592, 205, true
2167, 1566721910600, 4392, 1566721910805, 4597, 205, true
2168, 1566721910601, 4393, 1566721910811, 4603, 210, true
2169, 1566721910603, 4395, 1566721910809, 4601, 206, true
2170, 1566721910604, 4396, 1566721910809, 4601, 205, true
2171, 1566721910606, 4398, 1566721910811, 4603, 205, true
2172, 1566721910609, 4401, 1566721910816, 4608, 207, true
2173, 1566721910611, 4403, 1566721910817, 4609, 206, true
2174, 1566721910618, 4410, 1566721910825, 4617, 207, true
2175, 1566721910620, 4412, 1566721910825, 4617, 205, true
2176, 1566721910622, 4414, 1566721910828, 4620, 206, true
2177, 1566721910624, 4416, 1566721910828, 4620, 204, true
2178, 1566721910627, 4419, 1566721910835, 4627, 208, true
2179, 1566721910635, 4427, 1566721910841, 4633, 206, true
2180, 1566721910641, 4433, 1566721910844, 4636, 203, true
2181, 1566721910643, 4435, 1566721910849, 4641, 206, true
2182, 1566721910648, 4440, 1566721910854, 4646, 206, true
2183, 1566721910650, 4442, 1566721910856, 4648, 206, true
2184, 1566721910651, 4443, 1566721910858, 4650, 207, true
2185, 1566721910652, 4444, 1566721910858, 4650, 206, true
2186, 1566721910654, 4446, 1566721910858, 4650, 204, true
2187, 1566721910656, 4448, 1566721910859, 4651, 203, true
2188, 1566721910659, 4451, 1566721910865, 4657, 206, true
2189, 1566721910661, 4453, 1566721910865, 4657, 204, true
2190, 1566721910662, 4454, 1566721910868, 4660, 206, true
2191, 1566721910665, 4457, 1566721910868, 4660, 203, true
2192, 1566721910667, 4459, 1566721910872, 4664, 205, true
2193, 1566721910669, 4461, 1566721910872, 4664, 203, true
2194, 1566721910670, 4462, 1566721910874, 4666, 204, true
2195, 1566721910675, 4467, 1566721910878, 4670, 203, true
2196, 1566721910677, 4469, 1566721910880, 4672, 203, true
2197, 1566721910678, 4470, 1566721910881, 4673, 203, true
2198, 1566721910681, 4473, 1566721910885, 4677, 204, true
2199, 1566721910682, 4474, 1566721910885, 4677, 203, true
2200, 1566721910686, 4478, 1566721910890, 4682, 204, true
2201, 1566721910690, 4482, 1566721910895, 4687, 205, true
2202, 1566721910691, 4483, 1566721910896, 4688, 205, true
2203, 1566721910691, 4483, 1566721910896, 4688, 205, true
2204, 1566721910692, 4484, 1566721910898, 4690, 206, true
2205, 1566721910693, 4485, 1566721910898, 4690, 205, true
2206, 1566721910694, 4486, 1566721910900, 4692, 206, true
2207, 1566721910695, 4487, 1566721910905, 4697, 210, true
2208, 1566721910697, 4489, 1566721910906, 4698, 209, true
2209, 1566721910702, 4494, 1566721910914, 4706, 212, true
2210, 1566721910702, 4494, 1566721910910, 4702, 208, true
2211, 1566721910704, 4496, 1566721910916, 4708, 212, true
2212, 1566721910704, 4496, 1566721910918, 4710, 214, true
2213, 1566721910705, 4497, 1566721910916, 4708, 211, true
2214, 1566721910705, 4497, 1566721910918, 4710, 213, true
2215, 1566721910705, 4497, 1566721910913, 4705, 208, true
2216, 1566721910706, 4498, 1566721910920, 4712, 214, true
2217, 1566721910707, 4499, 1566721910920, 4712, 213, true
2218, 1566721910708, 4500, 1566721910920, 4712, 212, true
2219, 1566721910709, 4501, 1566721910926, 4718, 217, true
2220, 1566721910712, 4504, 1566721910925, 4717, 213, true
2221, 1566721910712, 4504, 1566721910925, 4717, 213, true
2222, 1566721910713, 4505, 1566721910926, 4718, 213, true
2223, 1566721910715, 4507, 1566721910925, 4717, 210, true
2224, 1566721910716, 4508, 1566721910926, 4718, 210, true
2225, 1566721910717, 4509, 1566721910925, 4717, 208, true
2226, 1566721910722, 4514, 1566721910926, 4718, 204, true
2227, 1566721910723, 4515, 1566721910928, 4720, 205, true
2228, 1566721910724, 4516, 1566721910928, 4720, 204, true
2229, 1566721910725, 4517, 1566721910928, 4720, 203, true
2230, 1566721910725, 4517, 1566721910930, 4722, 205, true
2231, 1566721910726, 4518, 1566721910937, 4729, 211, true
2232, 1566721910727, 4519, 1566721910952, 4744, 225, true
2233, 1566721910730, 4522, 1566721910952, 4744, 222, true
2234, 1566721910730, 4522, 1566721910946, 4738, 216, true
2235, 1566721910731, 4523, 1566721910946, 4738, 215, true
2236, 1566721910731, 4523, 1566721910952, 4744, 221, true
2237, 1566721910731, 4523, 1566721910952, 4744, 221, true
2238, 1566721910731, 4523, 1566721910952, 4744, 221, true
2239, 1566721910732, 4524, 1566721910948, 4740, 216, true
2240, 1566721910732, 4524, 1566721910953, 4745, 221, true
2241, 1566721910736, 4528, 1566721910946, 4738, 210, true
2242, 1566721910736, 4528, 1566721910952, 4744, 216, true
2243, 1566721910736, 4528, 1566721910952, 4744, 216, true
2244, 1566721910736, 4528, 1566721910952, 4744, 216, true
2245, 1566721910737, 4529, 1566721910946, 4738, 209, true
2246, 1566721910737, 4529, 1566721910953, 4745, 216, true
2247, 1566721910740, 4532, 1566721910953, 4745, 213, true
2248, 1566721910750, 4542, 1566721910954, 4746, 204, true
2249, 1566721910752, 4544, 1566721910956, 4748, 204, true
2250, 1566721910753, 4545, 1566721910956, 4748, 203, true
2251, 1566721910753, 4545, 1566721910957, 4749, 204, true
2252, 1566721910755, 4547, 1566721910960, 4752, 205, true
2253, 1566721910755, 4547, 1566721910960, 4752, 205, true
2254, 1566721910756, 4548, 1566721910961, 4753, 205, true
2255, 1566721910760, 4552, 1566721910965, 4757, 205, true
2256, 1566721910760, 4552, 1566721910965, 4757, 205, true
2257, 1566721910761, 4553, 1566721910964, 4756, 203, true
2258, 1566721910761, 4553, 1566721910966, 4758, 205, true
2259, 1566721910762, 4554, 1566721910966, 4758, 204, true
2260, 1566721910763, 4555, 1566721910966, 4758, 203, true
2261, 1566721910763, 4555, 1566721910970, 4762, 207, true
2262, 1566721910765, 4557, 1566721910971, 4763, 206, true
2263, 1566721910765, 4557, 1566721910974, 4766, 209, true
2264, 1566721910766, 4558, 1566721910970, 4762, 204, true
2265, 1566721910768, 4560, 1566721910975, 4767, 207, true
2266, 1566721910768, 4560, 1566721910974, 4766, 206, true
2267, 1566721910769, 4561, 1566721910975, 4767, 206, true
2268, 1566721910772, 4564, 1566721910978, 4770, 206, true
2269, 1566721910773, 4565, 1566721910976, 4768, 203, true
2270, 1566721910775, 4567, 1566721910978, 4770, 203, true
2271, 1566721910775, 4567, 1566721910978, 4770, 203, true
2272, 1566721910778, 4570, 1566721910980, 4772, 202, true
2273, 1566721910778, 4570, 1566721910986, 4778, 208, true
2274, 1566721910779, 4571, 1566721910986, 4778, 207, true
2275, 1566721910779, 4571, 1566721910984, 4776, 205, true
2276, 1566721910780, 4572, 1566721910988, 4780, 208, true
2277, 1566721910781, 4573, 1566721910985, 4777, 204, true
2278, 1566721910783, 4575, 1566721910988, 4780, 205, true
2279, 1566721910783, 4575, 1566721910988, 4780, 205, true
2280, 1566721910785, 4577, 1566721910988, 4780, 203, true
2281, 1566721910785, 4577, 1566721910988, 4780, 203, true
2282, 1566721910786, 4578, 1566721910990, 4782, 204, true
2283, 1566721910788, 4580, 1566721910992, 4784, 204, true
2284, 1566721910789, 4581, 1566721910998, 4790, 209, true
2285, 1566721910790, 4582, 1566721910997, 4789, 207, true
2286, 1566721910792, 4584, 1566721910998, 4790, 206, true
2287, 1566721910794, 4586, 1566721910998, 4790, 204, true
2288, 1566721910794, 4586, 1566721910999, 4791, 205, true
2289, 1566721910797, 4589, 1566721911003, 4795, 206, true
2290, 1566721910797, 4589, 1566721911001, 4793, 204, true
2291, 1566721910798, 4590, 1566721911004, 4796, 206, true
2292, 1566721910800, 4592, 1566721911012, 4804, 212, true
2293, 1566721910800, 4592, 1566721911005, 4797, 205, true
2294, 1566721910802, 4594, 1566721911012, 4804, 210, true
2295, 1566721910802, 4594, 1566721911012, 4804, 210, true
2296, 1566721910803, 4595, 1566721911008, 4800, 205, true
2297, 1566721910805, 4597, 1566721911013, 4805, 208, true
2298, 1566721910806, 4598, 1566721911019, 4811, 213, true
2299, 1566721910807, 4599, 1566721911019, 4811, 212, true
2300, 1566721910808, 4600, 1566721911019, 4811, 211, true
2301, 1566721910811, 4603, 1566721911019, 4811, 208, true
2302, 1566721910811, 4603, 1566721911019, 4811, 208, true
2303, 1566721910812, 4604, 1566721911019, 4811, 207, true
2304, 1566721910813, 4605, 1566721911019, 4811, 206, true
2305, 1566721910813, 4605, 1566721911019, 4811, 206, true
2306, 1566721910814, 4606, 1566721911019, 4811, 205, true
2307, 1566721910817, 4609, 1566721911025, 4817, 208, true
2308, 1566721910818, 4610, 1566721911021, 4813, 203, true
2309, 1566721910818, 4610, 1566721911022, 4814, 204, true
2310, 1566721910820, 4612, 1566721911029, 4821, 209, true
2311, 1566721910820, 4612, 1566721911029, 4821, 209, true
2312, 1566721910821, 4613, 1566721911027, 4819, 206, true
2313, 1566721910821, 4613, 1566721911029, 4821, 208, true
2314, 1566721910822, 4614, 1566721911034, 4826, 212, true
2315, 1566721910823, 4615, 1566721911033, 4825, 210, true
2316, 1566721910826, 4618, 1566721911033, 4825, 207, true
2317, 1566721910828, 4620, 1566721911032, 4824, 204, true
2318, 1566721910830, 4622, 1566721911034, 4826, 204, true
2319, 1566721910830, 4622, 1566721911033, 4825, 203, true
2320, 1566721910831, 4623, 1566721911037, 4829, 206, true
2321, 1566721910832, 4624, 1566721911040, 4832, 208, true
2322, 1566721910832, 4624, 1566721911042, 4834, 210, true
2323, 1566721910832, 4624, 1566721911042, 4834, 210, true
2324, 1566721910833, 4625, 1566721911040, 4832, 207, true
2325, 1566721910835, 4627, 1566721911041, 4833, 206, true
2326, 1566721910837, 4629, 1566721911044, 4836, 207, true
2327, 1566721910838, 4630, 1566721911042, 4834, 204, true
2328, 1566721910838, 4630, 1566721911042, 4834, 204, true
2329, 1566721910839, 4631, 1566721911044, 4836, 205, true
2330, 1566721910839, 4631, 1566721911045, 4837, 206, true
2331, 1566721910842, 4634, 1566721911047, 4839, 205, true
2332, 1566721910842, 4634, 1566721911052, 4844, 210, true
2333, 1566721910844, 4636, 1566721911052, 4844, 208, true
2334, 1566721910845, 4637, 1566721911052, 4844, 207, true
2335, 1566721910846, 4638, 1566721911058, 4850, 212, true
2336, 1566721910847, 4639, 1566721911058, 4850, 211, true
2337, 1566721910848, 4640, 1566721911058, 4850, 210, true
2338, 1566721910850, 4642, 1566721911053, 4845, 203, true
2339, 1566721910850, 4642, 1566721911058, 4850, 208, true
2340, 1566721910852, 4644, 1566721911060, 4852, 208, true
2341, 1566721910852, 4644, 1566721911059, 4851, 207, true
2342, 1566721910853, 4645, 1566721911061, 4853, 208, true
2343, 1566721910855, 4647, 1566721911059, 4851, 204, true
2344, 1566721910859, 4651, 1566721911063, 4855, 204, true
2345, 1566721910860, 4652, 1566721911063, 4855, 203, true
2346, 1566721910861, 4653, 1566721911066, 4858, 205, true
2347, 1566721910862, 4654, 1566721911068, 4860, 206, true
2348, 1566721910863, 4655, 1566721911068, 4860, 205, true
2349, 1566721910863, 4655, 1566721911068, 4860, 205, true
2350, 1566721910866, 4658, 1566721911070, 4862, 204, true
2351, 1566721910866, 4658, 1566721911072, 4864, 206, true
2352, 1566721910868, 4660, 1566721911072, 4864, 204, true
2353, 1566721910869, 4661, 1566721911072, 4864, 203, true
2354, 1566721910869, 4661, 1566721911076, 4868, 207, true
2355, 1566721910870, 4662, 1566721911076, 4868, 206, true
2356, 1566721910872, 4664, 1566721911076, 4868, 204, true
2357, 1566721910874, 4666, 1566721911077, 4869, 203, true
2358, 1566721910875, 4667, 1566721911077, 4869, 202, true
2359, 1566721910875, 4667, 1566721911080, 4872, 205, true
2360, 1566721910876, 4668, 1566721911080, 4872, 204, true
2361, 1566721910878, 4670, 1566721911081, 4873, 203, true
2362, 1566721910878, 4670, 1566721911082, 4874, 204, true
2363, 1566721910881, 4673, 1566721911084, 4876, 203, true
2364, 1566721910882, 4674, 1566721911085, 4877, 203, true
2365, 1566721910882, 4674, 1566721911088, 4880, 206, true
2366, 1566721910883, 4675, 1566721911088, 4880, 205, true
2367, 1566721910886, 4678, 1566721911090, 4882, 204, true
2368, 1566721910886, 4678, 1566721911090, 4882, 204, true
2369, 1566721910887, 4679, 1566721911091, 4883, 204, true
2370, 1566721910888, 4680, 1566721911096, 4888, 208, true
2371, 1566721910890, 4682, 1566721911096, 4888, 206, true
2372, 1566721910891, 4683, 1566721911096, 4888, 205, true
2373, 1566721910892, 4684, 1566721911096, 4888, 204, true
2374, 1566721910893, 4685, 1566721911105, 4897, 212, true
2375, 1566721910896, 4688, 1566721911105, 4897, 209, true
2376, 1566721910898, 4690, 1566721911105, 4897, 207, true
2377, 1566721910900, 4692, 1566721911107, 4899, 207, true
2378, 1566721910902, 4694, 1566721911111, 4903, 209, true
2379, 1566721910902, 4694, 1566721911106, 4898, 204, true
2380, 1566721910903, 4695, 1566721911111, 4903, 208, true
2381, 1566721910906, 4698, 1566721911111, 4903, 205, true
2382, 1566721910906, 4698, 1566721911111, 4903, 205, true
2383, 1566721910907, 4699, 1566721911117, 4909, 210, true
2384, 1566721910908, 4700, 1566721911117, 4909, 209, true
2385, 1566721910910, 4702, 1566721911117, 4909, 207, true
2386, 1566721910910, 4702, 1566721911120, 4912, 210, true
2387, 1566721910911, 4703, 1566721911117, 4909, 206, true
2388, 1566721910914, 4706, 1566721911120, 4912, 206, true
2389, 1566721910914, 4706, 1566721911120, 4912, 206, true
2390, 1566721910918, 4710, 1566721911126, 4918, 208, true
2391, 1566721910918, 4710, 1566721911127, 4919, 209, true
2392, 1566721910921, 4713, 1566721911127, 4919, 206, true
2393, 1566721910921, 4713, 1566721911126, 4918, 205, true
2394, 1566721910922, 4714, 1566721911127, 4919, 205, true
2395, 1566721910928, 4720, 1566721911138, 4930, 210, true
2396, 1566721910931, 4723, 1566721911138, 4930, 207, true
2397, 1566721910931, 4723, 1566721911138, 4930, 207, true
2398, 1566721910932, 4724, 1566721911138, 4930, 206, true
2399, 1566721910933, 4725, 1566721911138, 4930, 205, true
2400, 1566721910933, 4725, 1566721911138, 4930, 205, true
2401, 1566721910934, 4726, 1566721911138, 4930, 204, true
2402, 1566721910935, 4727, 1566721911140, 4932, 205, true
2403, 1566721910935, 4727, 1566721911142, 4934, 207, true
2404, 1566721910938, 4730, 1566721911141, 4933, 203, true
2405, 1566721910938, 4730, 1566721911142, 4934, 204, true
2406, 1566721910940, 4732, 1566721911145, 4937, 205, true
2407, 1566721910940, 4732, 1566721911148, 4940, 208, true
2408, 1566721910941, 4733, 1566721911154, 4946, 213, true
2409, 1566721910946, 4738, 1566721911154, 4946, 208, true
2410, 1566721910954, 4746, 1566721911161, 4953, 207, true
2411, 1566721910963, 4755, 1566721911170, 4962, 207, true
2412, 1566721910968, 4760, 1566721911172, 4964, 204, true
2413, 1566721910972, 4764, 1566721911177, 4969, 205, true
2414, 1566721910979, 4771, 1566721911183, 4975, 204, true
2415, 1566721910982, 4774, 1566721911188, 4980, 206, true
2416, 1566721910982, 4774, 1566721911188, 4980, 206, true
2417, 1566721910989, 4781, 1566721911193, 4985, 204, true
2418, 1566721910993, 4785, 1566721911196, 4988, 203, true
2419, 1566721910995, 4787, 1566721911212, 5004, 217, true
2420, 1566721910999, 4791, 1566721911213, 5005, 214, true
2421, 1566721911001, 4793, 1566721911212, 5004, 211, true
2422, 1566721911023, 4815, 1566721911228, 5020, 205, true
2423, 1566721911026, 4818, 1566721911229, 5021, 203, true
2424, 1566721911030, 4822, 1566721911237, 5029, 207, true
2425, 1566721911035, 4827, 1566721911240, 5032, 205, true
2426, 1566721911037, 4829, 1566721911244, 5036, 207, true
2427, 1566721911046, 4838, 1566721911248, 5040, 202, true
2428, 1566721911048, 4840, 1566721911255, 5047, 207, true
2429, 1566721911049, 4841, 1566721911256, 5048, 207, true
2430, 1566721911053, 4845, 1566721911258, 5050, 205, true
2431, 1566721911055, 4847, 1566721911259, 5051, 204, true
2432, 1566721911055, 4847, 1566721911259, 5051, 204, true
2433, 1566721911065, 4857, 1566721911270, 5062, 205, true
2434, 1566721911068, 4860, 1566721911274, 5066, 206, true
2435, 1566721911074, 4866, 1566721911278, 5070, 204, true
2436, 1566721911078, 4870, 1566721911284, 5076, 206, true
2437, 1566721911086, 4878, 1566721911291, 5083, 205, true
2438, 1566721911086, 4878, 1566721911298, 5090, 212, true
2439, 1566721911087, 4879, 1566721911291, 5083, 204, true
2440, 1566721911091, 4883, 1566721911297, 5089, 206, true
2441, 1566721911092, 4884, 1566721911298, 5090, 206, true
2442, 1566721911092, 4884, 1566721911300, 5092, 208, true
2443, 1566721911093, 4885, 1566721911298, 5090, 205, true
2444, 1566721911097, 4889, 1566721911312, 5104, 215, true
2445, 1566721911113, 4905, 1566721911321, 5113, 208, true
2446, 1566721911113, 4905, 1566721911323, 5115, 210, true
2447, 1566721911113, 4905, 1566721911321, 5113, 208, true
2448, 1566721911114, 4906, 1566721911320, 5112, 206, true
2449, 1566721911114, 4906, 1566721911321, 5113, 207, true
2450, 1566721911122, 4914, 1566721911335, 5127, 213, true
2451, 1566721911123, 4915, 1566721911335, 5127, 212, true
2452, 1566721911123, 4915, 1566721911335, 5127, 212, true
2453, 1566721911124, 4916, 1566721911335, 5127, 211, true
2454, 1566721911124, 4916, 1566721911330, 5122, 206, true
2455, 1566721911139, 4931, 1566721911346, 5138, 207, true
2456, 1566721911143, 4935, 1566721911353, 5145, 210, true
2457, 1566721911144, 4936, 1566721911351, 5143, 207, true
2458, 1566721911144, 4936, 1566721911355, 5147, 211, true
2459, 1566721911145, 4937, 1566721911352, 5144, 207, true
2460, 1566721911145, 4937, 1566721911352, 5144, 207, true
2461, 1566721911146, 4938, 1566721911352, 5144, 206, true
2462, 1566721911146, 4938, 1566721911360, 5152, 214, true
2463, 1566721911155, 4947, 1566721911360, 5152, 205, true
2464, 1566721911157, 4949, 1566721911363, 5155, 206, true
2465, 1566721911157, 4949, 1566721911367, 5159, 210, true
2466, 1566721911158, 4950, 1566721911365, 5157, 207, true
2467, 1566721911159, 4951, 1566721911367, 5159, 208, true
2468, 1566721911162, 4954, 1566721911367, 5159, 205, true
2469, 1566721911163, 4955, 1566721911367, 5159, 204, true
2470, 1566721911165, 4957, 1566721911370, 5162, 205, true
2471, 1566721911166, 4958, 1566721911371, 5163, 205, true
2472, 1566721911168, 4960, 1566721911374, 5166, 206, true
2473, 1566721911171, 4963, 1566721911374, 5166, 203, true
2474, 1566721911173, 4965, 1566721911380, 5172, 207, true
2475, 1566721911174, 4966, 1566721911380, 5172, 206, true
2476, 1566721911175, 4967, 1566721911380, 5172, 205, true
2477, 1566721911178, 4970, 1566721911383, 5175, 205, true
2478, 1566721911179, 4971, 1566721911385, 5177, 206, true
2479, 1566721911180, 4972, 1566721911385, 5177, 205, true
2480, 1566721911184, 4976, 1566721911395, 5187, 211, true
2481, 1566721911184, 4976, 1566721911394, 5186, 210, true
2482, 1566721911185, 4977, 1566721911394, 5186, 209, true
2483, 1566721911189, 4981, 1566721911394, 5186, 205, true
2484, 1566721911191, 4983, 1566721911397, 5189, 206, true
2485, 1566721911192, 4984, 1566721911395, 5187, 203, true
2486, 1566721911193, 4985, 1566721911398, 5190, 205, true
2487, 1566721911194, 4986, 1566721911398, 5190, 204, true
2488, 1566721911194, 4986, 1566721911398, 5190, 204, true
2489, 1566721911196, 4988, 1566721911400, 5192, 204, true
2490, 1566721911197, 4989, 1566721911400, 5192, 203, true
2491, 1566721911198, 4990, 1566721911407, 5199, 209, true
2492, 1566721911200, 4992, 1566721911417, 5209, 217, true
2493, 1566721911200, 4992, 1566721911416, 5208, 216, true
2494, 1566721911202, 4994, 1566721911428, 5220, 226, true
2495, 1566721911203, 4995, 1566721911428, 5220, 225, true
2496, 1566721911203, 4995, 1566721911429, 5221, 226, true
2497, 1566721911203, 4995, 1566721911428, 5220, 225, true
2498, 1566721911204, 4996, 1566721911428, 5220, 224, true
2499, 1566721911204, 4996, 1566721911428, 5220, 224, true
2500, 1566721911205, 4997, 1566721911428, 5220, 223, true
2501, 1566721911206, 4998, 1566721911432, 5224, 226, true
2502, 1566721911206, 4998, 1566721911428, 5220, 222, true
2503, 1566721911206, 4998, 1566721911425, 5217, 219, true
2504, 1566721911207, 4999, 1566721911428, 5220, 221, true
2505, 1566721911207, 4999, 1566721911423, 5215, 216, true
2506, 1566721911208, 5000, 1566721911425, 5217, 217, true
2507, 1566721911208, 5000, 1566721911425, 5217, 217, true
2508, 1566721911208, 5000, 1566721911432, 5224, 224, true
2509, 1566721911209, 5001, 1566721911424, 5216, 215, true
2510, 1566721911209, 5001, 1566721911428, 5220, 219, true
2511, 1566721911210, 5002, 1566721911429, 5221, 219, true
2512, 1566721911211, 5003, 1566721911432, 5224, 221, true
2513, 1566721911213, 5005, 1566721911428, 5220, 215, true
2514, 1566721911213, 5005, 1566721911432, 5224, 219, true
2515, 1566721911213, 5005, 1566721911432, 5224, 219, true
2516, 1566721911213, 5005, 1566721911423, 5215, 210, true
2517, 1566721911214, 5006, 1566721911429, 5221, 215, true
2518, 1566721911215, 5007, 1566721911428, 5220, 213, true
2519, 1566721911216, 5008, 1566721911425, 5217, 209, true
2520, 1566721911216, 5008, 1566721911428, 5220, 212, true
2521, 1566721911217, 5009, 1566721911433, 5225, 216, true
2522, 1566721911225, 5017, 1566721911435, 5227, 210, true
2523, 1566721911227, 5019, 1566721911441, 5233, 214, true
2524, 1566721911228, 5020, 1566721911435, 5227, 207, true
2525, 1566721911229, 5021, 1566721911441, 5233, 212, true
2526, 1566721911230, 5022, 1566721911436, 5228, 206, true
2527, 1566721911231, 5023, 1566721911441, 5233, 210, true
2528, 1566721911232, 5024, 1566721911441, 5233, 209, true
2529, 1566721911233, 5025, 1566721911441, 5233, 208, true
2530, 1566721911234, 5026, 1566721911441, 5233, 207, true
2531, 1566721911235, 5027, 1566721911441, 5233, 206, true
2532, 1566721911238, 5030, 1566721911443, 5235, 205, true
2533, 1566721911238, 5030, 1566721911451, 5243, 213, true
2534, 1566721911239, 5031, 1566721911443, 5235, 204, true
2535, 1566721911241, 5033, 1566721911447, 5239, 206, true
2536, 1566721911241, 5033, 1566721911447, 5239, 206, true
2537, 1566721911243, 5035, 1566721911448, 5240, 205, true
2538, 1566721911245, 5037, 1566721911449, 5241, 204, true
2539, 1566721911245, 5037, 1566721911451, 5243, 206, true
2540, 1566721911246, 5038, 1566721911451, 5243, 205, true
2541, 1566721911249, 5041, 1566721911454, 5246, 205, true
2542, 1566721911249, 5041, 1566721911453, 5245, 204, true
2543, 1566721911250, 5042, 1566721911459, 5251, 209, true
2544, 1566721911251, 5043, 1566721911459, 5251, 208, true
2545, 1566721911252, 5044, 1566721911460, 5252, 208, true
2546, 1566721911253, 5045, 1566721911461, 5253, 208, true
2547, 1566721911253, 5045, 1566721911459, 5251, 206, true
2548, 1566721911257, 5049, 1566721911460, 5252, 203, true
2549, 1566721911259, 5051, 1566721911464, 5256, 205, true
2550, 1566721911259, 5051, 1566721911464, 5256, 205, true
2551, 1566721911260, 5052, 1566721911464, 5256, 204, true
2552, 1566721911261, 5053, 1566721911464, 5256, 203, true
2553, 1566721911261, 5053, 1566721911467, 5259, 206, true
2554, 1566721911262, 5054, 1566721911467, 5259, 205, true
2555, 1566721911263, 5055, 1566721911467, 5259, 204, true
2556, 1566721911264, 5056, 1566721911469, 5261, 205, true
2557, 1566721911264, 5056, 1566721911469, 5261, 205, true
2558, 1566721911265, 5057, 1566721911469, 5261, 204, true
2559, 1566721911267, 5059, 1566721911470, 5262, 203, true
2560, 1566721911268, 5060, 1566721911471, 5263, 203, true
2561, 1566721911270, 5062, 1566721911473, 5265, 203, true
2562, 1566721911270, 5062, 1566721911475, 5267, 205, true
2563, 1566721911271, 5063, 1566721911475, 5267, 204, true
2564, 1566721911272, 5064, 1566721911476, 5268, 204, true
2565, 1566721911275, 5067, 1566721911479, 5271, 204, true
2566, 1566721911275, 5067, 1566721911485, 5277, 210, true
2567, 1566721911277, 5069, 1566721911485, 5277, 208, true
2568, 1566721911278, 5070, 1566721911485, 5277, 207, true
2569, 1566721911279, 5071, 1566721911485, 5277, 206, true
2570, 1566721911280, 5072, 1566721911485, 5277, 205, true
2571, 1566721911281, 5073, 1566721911486, 5278, 205, true
2572, 1566721911282, 5074, 1566721911486, 5278, 204, true
2573, 1566721911284, 5076, 1566721911493, 5285, 209, true
2574, 1566721911284, 5076, 1566721911493, 5285, 209, true
2575, 1566721911286, 5078, 1566721911493, 5285, 207, true
2576, 1566721911286, 5078, 1566721911493, 5285, 207, true
2577, 1566721911287, 5079, 1566721911493, 5285, 206, true
2578, 1566721911288, 5080, 1566721911496, 5288, 208, true
2579, 1566721911289, 5081, 1566721911496, 5288, 207, true
2580, 1566721911291, 5083, 1566721911497, 5289, 206, true
2581, 1566721911292, 5084, 1566721911496, 5288, 204, true
2582, 1566721911292, 5084, 1566721911498, 5290, 206, true
2583, 1566721911294, 5086, 1566721911499, 5291, 205, true
2584, 1566721911294, 5086, 1566721911499, 5291, 205, true
2585, 1566721911295, 5087, 1566721911499, 5291, 204, true
2586, 1566721911298, 5090, 1566721911501, 5293, 203, true
2587, 1566721911300, 5092, 1566721911508, 5300, 208, true
2588, 1566721911300, 5092, 1566721911513, 5305, 213, true
2589, 1566721911301, 5093, 1566721911514, 5306, 213, true
2590, 1566721911301, 5093, 1566721911514, 5306, 213, true
2591, 1566721911302, 5094, 1566721911514, 5306, 212, true
2592, 1566721911303, 5095, 1566721911514, 5306, 211, true
2593, 1566721911304, 5096, 1566721911517, 5309, 213, true
2594, 1566721911304, 5096, 1566721911509, 5301, 205, true
2595, 1566721911305, 5097, 1566721911516, 5308, 211, true
2596, 1566721911307, 5099, 1566721911516, 5308, 209, true
2597, 1566721911307, 5099, 1566721911513, 5305, 206, true
2598, 1566721911308, 5100, 1566721911516, 5308, 208, true
2599, 1566721911309, 5101, 1566721911514, 5306, 205, true
2600, 1566721911309, 5101, 1566721911517, 5309, 208, true
2601, 1566721911310, 5102, 1566721911517, 5309, 207, true
2602, 1566721911313, 5105, 1566721911517, 5309, 204, true
2603, 1566721911313, 5105, 1566721911517, 5309, 204, true
2604, 1566721911314, 5106, 1566721911518, 5310, 204, true
2605, 1566721911314, 5106, 1566721911518, 5310, 204, true
2606, 1566721911316, 5108, 1566721911527, 5319, 211, true
2607, 1566721911316, 5108, 1566721911527, 5319, 211, true
2608, 1566721911317, 5109, 1566721911525, 5317, 208, true
2609, 1566721911317, 5109, 1566721911531, 5323, 214, true
2610, 1566721911318, 5110, 1566721911531, 5323, 213, true
2611, 1566721911323, 5115, 1566721911531, 5323, 208, true
2612, 1566721911325, 5117, 1566721911532, 5324, 207, true
2613, 1566721911328, 5120, 1566721911535, 5327, 207, true
2614, 1566721911331, 5123, 1566721911535, 5327, 204, true
2615, 1566721911332, 5124, 1566721911537, 5329, 205, true
2616, 1566721911336, 5128, 1566721911538, 5330, 202, true
2617, 1566721911337, 5129, 1566721911540, 5332, 203, true
2618, 1566721911338, 5130, 1566721911545, 5337, 207, true
2619, 1566721911340, 5132, 1566721911545, 5337, 205, true
2620, 1566721911341, 5133, 1566721911545, 5337, 204, true
2621, 1566721911342, 5134, 1566721911546, 5338, 204, true
2622, 1566721911344, 5136, 1566721911552, 5344, 208, true
2623, 1566721911347, 5139, 1566721911552, 5344, 205, true
2624, 1566721911348, 5140, 1566721911559, 5351, 211, true
2625, 1566721911350, 5142, 1566721911559, 5351, 209, true
2626, 1566721911353, 5145, 1566721911559, 5351, 206, true
2627, 1566721911355, 5147, 1566721911559, 5351, 204, true
2628, 1566721911355, 5147, 1566721911566, 5358, 211, true
2629, 1566721911355, 5147, 1566721911562, 5354, 207, true
2630, 1566721911356, 5148, 1566721911565, 5357, 209, true
2631, 1566721911356, 5148, 1566721911560, 5352, 204, true
2632, 1566721911356, 5148, 1566721911566, 5358, 210, true
2633, 1566721911357, 5149, 1566721911566, 5358, 209, true
2634, 1566721911358, 5150, 1566721911566, 5358, 208, true
2635, 1566721911361, 5153, 1566721911566, 5358, 205, true
2636, 1566721911364, 5156, 1566721911567, 5359, 203, true
2637, 1566721911365, 5157, 1566721911575, 5367, 210, true
2638, 1566721911368, 5160, 1566721911579, 5371, 211, true
2639, 1566721911368, 5160, 1566721911575, 5367, 207, true
2640, 1566721911368, 5160, 1566721911579, 5371, 211, true
2641, 1566721911369, 5161, 1566721911579, 5371, 210, true
2642, 1566721911369, 5161, 1566721911579, 5371, 210, true
2643, 1566721911372, 5164, 1566721911579, 5371, 207, true
2644, 1566721911375, 5167, 1566721911579, 5371, 204, true
2645, 1566721911375, 5167, 1566721911580, 5372, 205, true
2646, 1566721911376, 5168, 1566721911589, 5381, 213, true
2647, 1566721911377, 5169, 1566721911589, 5381, 212, true
2648, 1566721911380, 5172, 1566721911584, 5376, 204, true
2649, 1566721911382, 5174, 1566721911589, 5381, 207, true
2650, 1566721911383, 5175, 1566721911590, 5382, 207, true
2651, 1566721911386, 5178, 1566721911592, 5384, 206, true
2652, 1566721911387, 5179, 1566721911592, 5384, 205, true
2653, 1566721911389, 5181, 1566721911593, 5385, 204, true
2654, 1566721911389, 5181, 1566721911592, 5384, 203, true
2655, 1566721911390, 5182, 1566721911598, 5390, 208, true
2656, 1566721911391, 5183, 1566721911598, 5390, 207, true
2657, 1566721911395, 5187, 1566721911598, 5390, 203, true
2658, 1566721911408, 5200, 1566721911612, 5404, 204, true
2659, 1566721911408, 5200, 1566721911612, 5404, 204, true
2660, 1566721911409, 5201, 1566721911614, 5406, 205, true
2661, 1566721911409, 5201, 1566721911614, 5406, 205, true
2662, 1566721911410, 5202, 1566721911614, 5406, 204, true
2663, 1566721911411, 5203, 1566721911617, 5409, 206, true
2664, 1566721911412, 5204, 1566721911626, 5418, 214, true
2665, 1566721911413, 5205, 1566721911625, 5417, 212, true
2666, 1566721911413, 5205, 1566721911626, 5418, 213, true
2667, 1566721911414, 5206, 1566721911625, 5417, 211, true
2668, 1566721911414, 5206, 1566721911626, 5418, 212, true
2669, 1566721911417, 5209, 1566721911626, 5418, 209, true
2670, 1566721911418, 5210, 1566721911625, 5417, 207, true
2671, 1566721911419, 5211, 1566721911626, 5418, 207, true
2672, 1566721911420, 5212, 1566721911644, 5436, 224, true
2673, 1566721911444, 5236, 1566721911665, 5457, 221, true
2674, 1566721911444, 5236, 1566721911665, 5457, 221, true
2675, 1566721911446, 5238, 1566721911661, 5453, 215, true
2676, 1566721911452, 5244, 1566721911661, 5453, 209, true
2677, 1566721911453, 5245, 1566721911661, 5453, 208, true
2678, 1566721911454, 5246, 1566721911665, 5457, 211, true
2679, 1566721911454, 5246, 1566721911665, 5457, 211, true
2680, 1566721911462, 5254, 1566721911670, 5462, 208, true
2681, 1566721911465, 5257, 1566721911677, 5469, 212, true
2682, 1566721911466, 5258, 1566721911677, 5469, 211, true
2683, 1566721911472, 5264, 1566721911678, 5470, 206, true
2684, 1566721911475, 5267, 1566721911679, 5471, 204, true
2685, 1566721911476, 5268, 1566721911683, 5475, 207, true
2686, 1566721911478, 5270, 1566721911683, 5475, 205, true
2687, 1566721911480, 5272, 1566721911686, 5478, 206, true
2688, 1566721911480, 5272, 1566721911686, 5478, 206, true
2689, 1566721911481, 5273, 1566721911688, 5480, 207, true
2690, 1566721911481, 5273, 1566721911695, 5487, 214, true
2691, 1566721911482, 5274, 1566721911695, 5487, 213, true
2692, 1566721911486, 5278, 1566721911691, 5483, 205, true
2693, 1566721911488, 5280, 1566721911695, 5487, 207, true
2694, 1566721911488, 5280, 1566721911695, 5487, 207, true
2695, 1566721911488, 5280, 1566721911695, 5487, 207, true
2696, 1566721911489, 5281, 1566721911701, 5493, 212, true
2697, 1566721911489, 5281, 1566721911702, 5494, 213, true
2698, 1566721911490, 5282, 1566721911701, 5493, 211, true
2699, 1566721911494, 5286, 1566721911700, 5492, 206, true
2700, 1566721911500, 5292, 1566721911704, 5496, 204, true
2701, 1566721911501, 5293, 1566721911704, 5496, 203, true
2702, 1566721911503, 5295, 1566721911708, 5500, 205, true
2703, 1566721911503, 5295, 1566721911706, 5498, 203, true
2704, 1566721911503, 5295, 1566721911708, 5500, 205, true
2705, 1566721911504, 5296, 1566721911708, 5500, 204, true
2706, 1566721911505, 5297, 1566721911715, 5507, 210, true
2707, 1566721911506, 5298, 1566721911715, 5507, 209, true
2708, 1566721911506, 5298, 1566721911715, 5507, 209, true
2709, 1566721911506, 5298, 1566721911715, 5507, 209, true
2710, 1566721911509, 5301, 1566721911715, 5507, 206, true
2711, 1566721911512, 5304, 1566721911724, 5516, 212, true
2712, 1566721911520, 5312, 1566721911724, 5516, 204, true
2713, 1566721911521, 5313, 1566721911724, 5516, 203, true
2714, 1566721911522, 5314, 1566721911728, 5520, 206, true
2715, 1566721911522, 5314, 1566721911728, 5520, 206, true
2716, 1566721911522, 5314, 1566721911728, 5520, 206, true
2717, 1566721911523, 5315, 1566721911729, 5521, 206, true
2718, 1566721911523, 5315, 1566721911729, 5521, 206, true
2719, 1566721911523, 5315, 1566721911729, 5521, 206, true
2720, 1566721911528, 5320, 1566721911730, 5522, 202, true
2721, 1566721911528, 5320, 1566721911733, 5525, 205, true
2722, 1566721911528, 5320, 1566721911734, 5526, 206, true
2723, 1566721911529, 5321, 1566721911735, 5527, 206, true
2724, 1566721911533, 5325, 1566721911736, 5528, 203, true
2725, 1566721911533, 5325, 1566721911739, 5531, 206, true
2726, 1566721911535, 5327, 1566721911739, 5531, 204, true
2727, 1566721911536, 5328, 1566721911739, 5531, 203, true
2728, 1566721911538, 5330, 1566721911741, 5533, 203, true
2729, 1566721911538, 5330, 1566721911741, 5533, 203, true
2730, 1566721911539, 5331, 1566721911743, 5535, 204, true
2731, 1566721911540, 5332, 1566721911745, 5537, 205, true
2732, 1566721911541, 5333, 1566721911744, 5536, 203, true
2733, 1566721911541, 5333, 1566721911745, 5537, 204, true
2734, 1566721911543, 5335, 1566721911750, 5542, 207, true
2735, 1566721911543, 5335, 1566721911754, 5546, 211, true
2736, 1566721911547, 5339, 1566721911755, 5547, 208, true
2737, 1566721911547, 5339, 1566721911755, 5547, 208, true
2738, 1566721911548, 5340, 1566721911755, 5547, 207, true
2739, 1566721911548, 5340, 1566721911755, 5547, 207, true
2740, 1566721911552, 5344, 1566721911761, 5553, 209, true
2741, 1566721911552, 5344, 1566721911761, 5553, 209, true
2742, 1566721911553, 5345, 1566721911761, 5553, 208, true
2743, 1566721911554, 5346, 1566721911761, 5553, 207, true
2744, 1566721911554, 5346, 1566721911761, 5553, 207, true
2745, 1566721911555, 5347, 1566721911765, 5557, 210, true
2746, 1566721911556, 5348, 1566721911762, 5554, 206, true
2747, 1566721911561, 5353, 1566721911768, 5560, 207, true
2748, 1566721911561, 5353, 1566721911768, 5560, 207, true
2749, 1566721911561, 5353, 1566721911768, 5560, 207, true
2750, 1566721911562, 5354, 1566721911768, 5560, 206, true
2751, 1566721911568, 5360, 1566721911771, 5563, 203, true
2752, 1566721911568, 5360, 1566721911771, 5563, 203, true
2753, 1566721911581, 5373, 1566721911788, 5580, 207, true
2754, 1566721911581, 5373, 1566721911788, 5580, 207, true
2755, 1566721911582, 5374, 1566721911788, 5580, 206, true
2756, 1566721911582, 5374, 1566721911788, 5580, 206, true
2757, 1566721911583, 5375, 1566721911788, 5580, 205, true
2758, 1566721911585, 5377, 1566721911788, 5580, 203, true
2759, 1566721911585, 5377, 1566721911789, 5581, 204, true
2760, 1566721911586, 5378, 1566721911799, 5591, 213, true
2761, 1566721911594, 5386, 1566721911801, 5593, 207, true
2762, 1566721911594, 5386, 1566721911800, 5592, 206, true
2763, 1566721911596, 5388, 1566721911799, 5591, 203, true
2764, 1566721911596, 5388, 1566721911800, 5592, 204, true
2765, 1566721911598, 5390, 1566721911803, 5595, 205, true
2766, 1566721911600, 5392, 1566721911803, 5595, 203, true
2767, 1566721911601, 5393, 1566721911803, 5595, 202, true
2768, 1566721911602, 5394, 1566721911805, 5597, 203, true
2769, 1566721911603, 5395, 1566721911806, 5598, 203, true
2770, 1566721911605, 5397, 1566721911809, 5601, 204, true
2771, 1566721911606, 5398, 1566721911815, 5607, 209, true
2772, 1566721911607, 5399, 1566721911815, 5607, 208, true
2773, 1566721911608, 5400, 1566721911815, 5607, 207, true
2774, 1566721911609, 5401, 1566721911815, 5607, 206, true
2775, 1566721911610, 5402, 1566721911818, 5610, 208, true
2776, 1566721911612, 5404, 1566721911821, 5613, 209, true
2777, 1566721911615, 5407, 1566721911817, 5609, 202, true
2778, 1566721911616, 5408, 1566721911821, 5613, 205, true
2779, 1566721911616, 5408, 1566721911822, 5614, 206, true
2780, 1566721911618, 5410, 1566721911822, 5614, 204, true
2781, 1566721911618, 5410, 1566721911822, 5614, 204, true
2782, 1566721911619, 5411, 1566721911828, 5620, 209, true
2783, 1566721911619, 5411, 1566721911829, 5621, 210, true
2784, 1566721911620, 5412, 1566721911824, 5616, 204, true
2785, 1566721911620, 5412, 1566721911829, 5621, 209, true
2786, 1566721911620, 5412, 1566721911831, 5623, 211, true
2787, 1566721911621, 5413, 1566721911831, 5623, 210, true
2788, 1566721911627, 5419, 1566721911831, 5623, 204, true
2789, 1566721911628, 5420, 1566721911832, 5624, 204, true
2790, 1566721911630, 5422, 1566721911833, 5625, 203, true
2791, 1566721911630, 5422, 1566721911834, 5626, 204, true
2792, 1566721911631, 5423, 1566721911834, 5626, 203, true
2793, 1566721911632, 5424, 1566721911837, 5629, 205, true
2794, 1566721911632, 5424, 1566721911835, 5627, 203, true
2795, 1566721911633, 5425, 1566721911837, 5629, 204, true
2796, 1566721911635, 5427, 1566721911840, 5632, 205, true
2797, 1566721911635, 5427, 1566721911842, 5634, 207, true
2798, 1566721911635, 5427, 1566721911844, 5636, 209, true
2799, 1566721911636, 5428, 1566721911842, 5634, 206, true
2800, 1566721911636, 5428, 1566721911842, 5634, 206, true
2801, 1566721911637, 5429, 1566721911844, 5636, 207, true
2802, 1566721911638, 5430, 1566721911844, 5636, 206, true
2803, 1566721911640, 5432, 1566721911844, 5636, 204, true
2804, 1566721911642, 5434, 1566721911845, 5637, 203, true
2805, 1566721911644, 5436, 1566721911847, 5639, 203, true
2806, 1566721911645, 5437, 1566721911852, 5644, 207, true
2807, 1566721911647, 5439, 1566721911852, 5644, 205, true
2808, 1566721911659, 5451, 1566721911867, 5659, 208, true
2809, 1566721911662, 5454, 1566721911867, 5659, 205, true
2810, 1566721911666, 5458, 1566721911871, 5663, 205, true
2811, 1566721911668, 5460, 1566721911875, 5667, 207, true
2812, 1566721911669, 5461, 1566721911875, 5667, 206, true
2813, 1566721911671, 5463, 1566721911876, 5668, 205, true
2814, 1566721911672, 5464, 1566721911877, 5669, 205, true
2815, 1566721911673, 5465, 1566721911877, 5669, 204, true
2816, 1566721911674, 5466, 1566721911881, 5673, 207, true
2817, 1566721911688, 5480, 1566721911892, 5684, 204, true
2818, 1566721911690, 5482, 1566721911892, 5684, 202, true
2819, 1566721911691, 5483, 1566721911897, 5689, 206, true
2820, 1566721911695, 5487, 1566721911901, 5693, 206, true
2821, 1566721911698, 5490, 1566721911904, 5696, 206, true
2822, 1566721911702, 5494, 1566721911906, 5698, 204, true
2823, 1566721911706, 5498, 1566721911915, 5707, 209, true
2824, 1566721911709, 5501, 1566721911915, 5707, 206, true
2825, 1566721911711, 5503, 1566721911915, 5707, 204, true
2826, 1566721911712, 5504, 1566721911916, 5708, 204, true
2827, 1566721911715, 5507, 1566721911918, 5710, 203, true
2828, 1566721911717, 5509, 1566721911920, 5712, 203, true
2829, 1566721911719, 5511, 1566721911922, 5714, 203, true
2830, 1566721911720, 5512, 1566721911924, 5716, 204, true
2831, 1566721911722, 5514, 1566721911926, 5718, 204, true
2832, 1566721911725, 5517, 1566721911927, 5719, 202, true
2833, 1566721911726, 5518, 1566721911933, 5725, 207, true
2834, 1566721911726, 5518, 1566721911934, 5726, 208, true
2835, 1566721911731, 5523, 1566721911936, 5728, 205, true
2836, 1566721911731, 5523, 1566721911936, 5728, 205, true
2837, 1566721911731, 5523, 1566721911936, 5728, 205, true
2838, 1566721911732, 5524, 1566721911936, 5728, 204, true
2839, 1566721911735, 5527, 1566721911938, 5730, 203, true
2840, 1566721911736, 5528, 1566721911938, 5730, 202, true
2841, 1566721911737, 5529, 1566721911939, 5731, 202, true
2842, 1566721911737, 5529, 1566721911940, 5732, 203, true
2843, 1566721911738, 5530, 1566721911944, 5736, 206, true
2844, 1566721911741, 5533, 1566721911944, 5736, 203, true
2845, 1566721911741, 5533, 1566721911944, 5736, 203, true
2846, 1566721911743, 5535, 1566721911947, 5739, 204, true
2847, 1566721911743, 5535, 1566721911947, 5739, 204, true
2848, 1566721911746, 5538, 1566721911953, 5745, 207, true
2849, 1566721911746, 5538, 1566721911953, 5745, 207, true
2850, 1566721911746, 5538, 1566721911953, 5745, 207, true
2851, 1566721911747, 5539, 1566721911953, 5745, 206, true
2852, 1566721911747, 5539, 1566721911953, 5745, 206, true
2853, 1566721911747, 5539, 1566721911955, 5747, 208, true
2854, 1566721911749, 5541, 1566721911965, 5757, 216, true
2855, 1566721911751, 5543, 1566721911961, 5753, 210, true
2856, 1566721911751, 5543, 1566721911954, 5746, 203, true
2857, 1566721911752, 5544, 1566721911965, 5757, 213, true
2858, 1566721911756, 5548, 1566721911961, 5753, 205, true
2859, 1566721911757, 5549, 1566721911965, 5757, 208, true
2860, 1566721911757, 5549, 1566721911965, 5757, 208, true
2861, 1566721911758, 5550, 1566721911965, 5757, 207, true
2862, 1566721911759, 5551, 1566721911965, 5757, 206, true
2863, 1566721911763, 5555, 1566721911966, 5758, 203, true
2864, 1566721911763, 5555, 1566721911972, 5764, 209, true
2865, 1566721911763, 5555, 1566721911971, 5763, 208, true
2866, 1566721911764, 5556, 1566721911969, 5761, 205, true
2867, 1566721911765, 5557, 1566721911974, 5766, 209, true
2868, 1566721911766, 5558, 1566721911974, 5766, 208, true
2869, 1566721911769, 5561, 1566721911972, 5764, 203, true
2870, 1566721911770, 5562, 1566721911973, 5765, 203, true
2871, 1566721911772, 5564, 1566721911981, 5773, 209, true
2872, 1566721911772, 5564, 1566721911981, 5773, 209, true
2873, 1566721911773, 5565, 1566721911981, 5773, 208, true
2874, 1566721911773, 5565, 1566721911981, 5773, 208, true
2875, 1566721911774, 5566, 1566721911981, 5773, 207, true
2876, 1566721911776, 5568, 1566721911981, 5773, 205, true
2877, 1566721911776, 5568, 1566721911981, 5773, 205, true
2878, 1566721911777, 5569, 1566721911983, 5775, 206, true
2879, 1566721911778, 5570, 1566721911988, 5780, 210, true
2880, 1566721911779, 5571, 1566721911989, 5781, 210, true
2881, 1566721911781, 5573, 1566721911989, 5781, 208, true
2882, 1566721911782, 5574, 1566721911989, 5781, 207, true
2883, 1566721911784, 5576, 1566721911996, 5788, 212, true
2884, 1566721911784, 5576, 1566721911996, 5788, 212, true
2885, 1566721911788, 5580, 1566721911996, 5788, 208, true
2886, 1566721911790, 5582, 1566721911996, 5788, 206, true
2887, 1566721911791, 5583, 1566721911996, 5788, 205, true
2888, 1566721911791, 5583, 1566721912000, 5792, 209, true
2889, 1566721911792, 5584, 1566721911997, 5789, 205, true
2890, 1566721911792, 5584, 1566721911997, 5789, 205, true
2891, 1566721911792, 5584, 1566721912000, 5792, 208, true
2892, 1566721911794, 5586, 1566721912000, 5792, 206, true
2893, 1566721911794, 5586, 1566721912000, 5792, 206, true
2894, 1566721911795, 5587, 1566721912007, 5799, 212, true
2895, 1566721911796, 5588, 1566721912004, 5796, 208, true
2896, 1566721911797, 5589, 1566721912007, 5799, 210, true
2897, 1566721911801, 5593, 1566721912006, 5798, 205, true
2898, 1566721911804, 5596, 1566721912008, 5800, 204, true
2899, 1566721911805, 5597, 1566721912010, 5802, 205, true
2900, 1566721911807, 5599, 1566721912010, 5802, 203, true
2901, 1566721911807, 5599, 1566721912016, 5808, 209, true
2902, 1566721911807, 5599, 1566721912011, 5803, 204, true
2903, 1566721911808, 5600, 1566721912017, 5809, 209, true
2904, 1566721911809, 5601, 1566721912017, 5809, 208, true
2905, 1566721911809, 5601, 1566721912017, 5809, 208, true
2906, 1566721911810, 5602, 1566721912017, 5809, 207, true
2907, 1566721911811, 5603, 1566721912017, 5809, 206, true
2908, 1566721911811, 5603, 1566721912017, 5809, 206, true
2909, 1566721911812, 5604, 1566721912018, 5810, 206, true
2910, 1566721911816, 5608, 1566721912019, 5811, 203, true
2911, 1566721911816, 5608, 1566721912024, 5816, 208, true
2912, 1566721911818, 5610, 1566721912030, 5822, 212, true
2913, 1566721911819, 5611, 1566721912030, 5822, 211, true
2914, 1566721911822, 5614, 1566721912031, 5823, 209, true
2915, 1566721911824, 5616, 1566721912033, 5825, 209, true
2916, 1566721911825, 5617, 1566721912031, 5823, 206, true
2917, 1566721911826, 5618, 1566721912031, 5823, 205, true
2918, 1566721911826, 5618, 1566721912037, 5829, 211, true
2919, 1566721911827, 5619, 1566721912032, 5824, 205, true
2920, 1566721911827, 5619, 1566721912037, 5829, 210, true
2921, 1566721911832, 5624, 1566721912039, 5831, 207, true
2922, 1566721911837, 5629, 1566721912042, 5834, 205, true
2923, 1566721911838, 5630, 1566721912044, 5836, 206, true
2924, 1566721911839, 5631, 1566721912043, 5835, 204, true
2925, 1566721911840, 5632, 1566721912049, 5841, 209, true
2926, 1566721911841, 5633, 1566721912046, 5838, 205, true
2927, 1566721911841, 5633, 1566721912049, 5841, 208, true
2928, 1566721911845, 5637, 1566721912052, 5844, 207, true
2929, 1566721911847, 5639, 1566721912054, 5846, 207, true
2930, 1566721911848, 5640, 1566721912054, 5846, 206, true
2931, 1566721911849, 5641, 1566721912054, 5846, 205, true
2932, 1566721911850, 5642, 1566721912057, 5849, 207, true
2933, 1566721911851, 5643, 1566721912055, 5847, 204, true
2934, 1566721911853, 5645, 1566721912057, 5849, 204, true
2935, 1566721911854, 5646, 1566721912057, 5849, 203, true
2936, 1566721911854, 5646, 1566721912062, 5854, 208, true
2937, 1566721911855, 5647, 1566721912062, 5854, 207, true
2938, 1566721911856, 5648, 1566721912065, 5857, 209, true
2939, 1566721911857, 5649, 1566721912062, 5854, 205, true
2940, 1566721911860, 5652, 1566721912065, 5857, 205, true
2941, 1566721911860, 5652, 1566721912064, 5856, 204, true
2942, 1566721911862, 5654, 1566721912066, 5858, 204, true
2943, 1566721911862, 5654, 1566721912067, 5859, 205, true
2944, 1566721911863, 5655, 1566721912074, 5866, 211, true
2945, 1566721911864, 5656, 1566721912074, 5866, 210, true
2946, 1566721911865, 5657, 1566721912074, 5866, 209, true
2947, 1566721911867, 5659, 1566721912075, 5867, 208, true
2948, 1566721911868, 5660, 1566721912087, 5879, 219, true
2949, 1566721911868, 5660, 1566721912081, 5873, 213, true
2950, 1566721911869, 5661, 1566721912085, 5877, 216, true
2951, 1566721911869, 5661, 1566721912085, 5877, 216, true
2952, 1566721911870, 5662, 1566721912085, 5877, 215, true
2953, 1566721911871, 5663, 1566721912085, 5877, 214, true
2954, 1566721911871, 5663, 1566721912085, 5877, 214, true
2955, 1566721911872, 5664, 1566721912085, 5877, 213, true
2956, 1566721911872, 5664, 1566721912087, 5879, 215, true
2957, 1566721911873, 5665, 1566721912085, 5877, 212, true
2958, 1566721911874, 5666, 1566721912081, 5873, 207, true
2959, 1566721911875, 5667, 1566721912085, 5877, 210, true
2960, 1566721911876, 5668, 1566721912085, 5877, 209, true
2961, 1566721911877, 5669, 1566721912090, 5882, 213, true
2962, 1566721911881, 5673, 1566721912089, 5881, 208, true
2963, 1566721911882, 5674, 1566721912088, 5880, 206, true
2964, 1566721911882, 5674, 1566721912088, 5880, 206, true
2965, 1566721911883, 5675, 1566721912093, 5885, 210, true
2966, 1566721911884, 5676, 1566721912094, 5886, 210, true
2967, 1566721911885, 5677, 1566721912091, 5883, 206, true
2968, 1566721911886, 5678, 1566721912094, 5886, 208, true
2969, 1566721911887, 5679, 1566721912099, 5891, 212, true
2970, 1566721911888, 5680, 1566721912094, 5886, 206, true
2971, 1566721911890, 5682, 1566721912099, 5891, 209, true
2972, 1566721911893, 5685, 1566721912100, 5892, 207, true
2973, 1566721911893, 5685, 1566721912096, 5888, 203, true
2974, 1566721911894, 5686, 1566721912101, 5893, 207, true
2975, 1566721911895, 5687, 1566721912100, 5892, 205, true
2976, 1566721911897, 5689, 1566721912101, 5893, 204, true
2977, 1566721911898, 5690, 1566721912103, 5895, 205, true
2978, 1566721911898, 5690, 1566721912102, 5894, 204, true
2979, 1566721911899, 5691, 1566721912103, 5895, 204, true
2980, 1566721911901, 5693, 1566721912107, 5899, 206, true
2981, 1566721911902, 5694, 1566721912108, 5900, 206, true
2982, 1566721911902, 5694, 1566721912108, 5900, 206, true
2983, 1566721911903, 5695, 1566721912109, 5901, 206, true
2984, 1566721911907, 5699, 1566721912115, 5907, 208, true
2985, 1566721911907, 5699, 1566721912115, 5907, 208, true
2986, 1566721911907, 5699, 1566721912115, 5907, 208, true
2987, 1566721911908, 5700, 1566721912115, 5907, 207, true
2988, 1566721911908, 5700, 1566721912117, 5909, 209, true
2989, 1566721911909, 5701, 1566721912117, 5909, 208, true
2990, 1566721911910, 5702, 1566721912117, 5909, 207, true
2991, 1566721911911, 5703, 1566721912117, 5909, 206, true
2992, 1566721911915, 5707, 1566721912119, 5911, 204, true
2993, 1566721911916, 5708, 1566721912124, 5916, 208, true
2994, 1566721911918, 5710, 1566721912124, 5916, 206, true
2995, 1566721911918, 5710, 1566721912125, 5917, 207, true
2996, 1566721911919, 5711, 1566721912126, 5918, 207, true
2997, 1566721911919, 5711, 1566721912133, 5925, 214, true
2998, 1566721911922, 5714, 1566721912133, 5925, 211, true
2999, 1566721911922, 5714, 1566721912140, 5932, 218, true
3000, 1566721911923, 5715, 1566721912134, 5926, 211, true
3001, 1566721911924, 5716, 1566721912134, 5926, 210, true
3002, 1566721911928, 5720, 1566721912140, 5932, 212, true
3003, 1566721911929, 5721, 1566721912140, 5932, 211, true
3004, 1566721911929, 5721, 1566721912140, 5932, 211, true
3005, 1566721911930, 5722, 1566721912142, 5934, 212, true
3006, 1566721911931, 5723, 1566721912140, 5932, 209, true
3007, 1566721911932, 5724, 1566721912140, 5932, 208, true
3008, 1566721911934, 5726, 1566721912142, 5934, 208, true
3009, 1566721911937, 5729, 1566721912142, 5934, 205, true
3010, 1566721911941, 5733, 1566721912145, 5937, 204, true
3011, 1566721911941, 5733, 1566721912145, 5937, 204, true
3012, 1566721911942, 5734, 1566721912146, 5938, 204, true
3013, 1566721911945, 5737, 1566721912158, 5950, 213, true
3014, 1566721911967, 5759, 1566721912174, 5966, 207, true
3015, 1566721911969, 5761, 1566721912174, 5966, 205, true
3016, 1566721911975, 5767, 1566721912178, 5970, 203, true
3017, 1566721911975, 5767, 1566721912181, 5973, 206, true
3018, 1566721911976, 5768, 1566721912183, 5975, 207, true
3019, 1566721911976, 5768, 1566721912184, 5976, 208, true
3020, 1566721911977, 5769, 1566721912184, 5976, 207, true
3021, 1566721911977, 5769, 1566721912186, 5978, 209, true
3022, 1566721911983, 5775, 1566721912188, 5980, 205, true
3023, 1566721911984, 5776, 1566721913214, 7006, 1230, true
3024, 1566721911985, 5777, 1566721913212, 7004, 1227, true
3025, 1566721911985, 5777, 1566721913214, 7006, 1229, true
3026, 1566721911986, 5778, 1566721912189, 5981, 203, true
3027, 1566721911986, 5778, 1566721913214, 7006, 1228, true
3028, 1566721911990, 5782, 1566721913214, 7006, 1224, true
3029, 1566721911990, 5782, 1566721913198, 6990, 1208, true
3030, 1566721911991, 5783, 1566721913214, 7006, 1223, true
3031, 1566721911991, 5783, 1566721913061, 6853, 1070, true
3032, 1566721911991, 5783, 1566721913062, 6854, 1071, true
3033, 1566721911993, 5785, 1566721913062, 6854, 1069, true
3034, 1566721911997, 5789, 1566721913062, 6854, 1065, true
3035, 1566721912000, 5792, 1566721913062, 6854, 1062, true
3036, 1566721912001, 5793, 1566721913211, 7003, 1210, true
3037, 1566721912002, 5794, 1566721913211, 7003, 1209, true
3038, 1566721912002, 5794, 1566721913080, 6872, 1078, true
3039, 1566721912003, 5795, 1566721913081, 6873, 1078, true
3040, 1566721912003, 5795, 1566721913080, 6872, 1077, true
3041, 1566721912020, 5812, 1566721913209, 7001, 1189, true
3042, 1566721912021, 5813, 1566721913081, 6873, 1060, true
3043, 1566721912022, 5814, 1566721913081, 6873, 1059, true
3044, 1566721912023, 5815, 1566721913081, 6873, 1058, true
3045, 1566721912033, 5825, 1566721913081, 6873, 1048, true
3046, 1566721912034, 5826, 1566721913211, 7003, 1177, true
3047, 1566721912050, 5842, 1566721913061, 6853, 1011, true
3048, 1566721912052, 5844, 1566721913127, 6919, 1075, true
3049, 1566721912059, 5851, 1566721913146, 6938, 1087, true
3050, 1566721912060, 5852, 1566721913173, 6965, 1113, true
3051, 1566721912063, 5855, 1566721913191, 6983, 1128, true
3052, 1566721912075, 5867, 1566721913206, 6998, 1131, true
3053, 1566721912075, 5867, 1566721913210, 7002, 1135, true
3054, 1566721912076, 5868, 1566721913200, 6992, 1124, true
3055, 1566721912077, 5869, 1566721913206, 6998, 1129, true
3056, 1566721912078, 5870, 1566721913210, 7002, 1132, true
3057, 1566721912078, 5870, 1566721913213, 7005, 1135, true
3058, 1566721912097, 5889, 1566721913210, 7002, 1113, true
3059, 1566721912109, 5901, 1566721913210, 7002, 1101, true
3060, 1566721912109, 5901, 1566721913210, 7002, 1101, true
3061, 1566721912110, 5902, 1566721913210, 7002, 1100, true
3062, 1566721913102, 6894, 1566721913890, 7682, 788, true
3063, 1566721912127, 5919, 1566721913213, 7005, 1086, true
3064, 1566721912127, 5919, 1566721913210, 7002, 1083, true
3065, 1566721912128, 5920, 1566721913210, 7002, 1082, true
3066, 1566721912128, 5920, 1566721913210, 7002, 1082, true
3067, 1566721912128, 5920, 1566721913210, 7002, 1082, true
3068, 1566721912129, 5921, 1566721913210, 7002, 1081, true
3069, 1566721912147, 5939, 1566721913209, 7001, 1062, true
3070, 1566721912147, 5939, 1566721913209, 7001, 1062, true
3071, 1566721912147, 5939, 1566721913214, 7006, 1067, true
3072, 1566721912148, 5940, 1566721913212, 7004, 1064, true
3073, 1566721912148, 5940, 1566721913213, 7005, 1065, true
3074, 1566721912164, 5956, 1566721913213, 7005, 1049, true
3075, 1566721912164, 5956, 1566721913213, 7005, 1049, true
3076, 1566721912164, 5956, 1566721913213, 7005, 1049, true
3077, 1566721912165, 5957, 1566721913213, 7005, 1048, true
3078, 1566721912166, 5958, 1566721913213, 7005, 1047, true
3079, 1566721912167, 5959, 1566721913213, 7005, 1046, true
3080, 1566721912170, 5962, 1566721913211, 7003, 1041, true
3081, 1566721912170, 5962, 1566721913211, 7003, 1041, true
3082, 1566721912172, 5964, 1566721913211, 7003, 1039, true
3083, 1566721912175, 5967, 1566721913214, 7006, 1039, true
3084, 1566721912175, 5967, 1566721913212, 7004, 1037, true
3085, 1566721912175, 5967, 1566721913212, 7004, 1037, true
3086, 1566721912179, 5971, 1566721913212, 7004, 1033, true
3087, 1566721912179, 5971, 1566721913212, 7004, 1033, true
3088, 1566721912182, 5974, 1566721913212, 7004, 1030, true
3089, 1566721912185, 5977, 1566721913212, 7004, 1027, true
3090, 1566721912186, 5978, 1566721913212, 7004, 1026, true
3091, 1566721912582, 6374, 1566721913891, 7683, 1309, true
3092, 1566721912583, 6375, 1566721913528, 7320, 945, true
3093, 1566721912583, 6375, 1566721913514, 7306, 931, true
3094, 1566721912583, 6375, 1566721913890, 7682, 1307, true
3095, 1566721912583, 6375, 1566721913527, 7319, 944, true
3096, 1566721912584, 6376, 1566721913521, 7313, 937, true
3097, 1566721912584, 6376, 1566721913680, 7472, 1096, true
3098, 1566721912584, 6376, 1566721913512, 7304, 928, true
3099, 1566721912584, 6376, 1566721913892, 7684, 1308, true
3100, 1566721912584, 6376, 1566721913513, 7305, 929, true
3101, 1566721912584, 6376, 1566721913555, 7347, 971, true
3102, 1566721912585, 6377, 1566721913513, 7305, 928, true
3103, 1566721912585, 6377, 1566721913519, 7311, 934, true
3104, 1566721912585, 6377, 1566721913528, 7320, 943, true
3105, 1566721912585, 6377, 1566721913564, 7356, 979, true
3106, 1566721912585, 6377, 1566721913892, 7684, 1307, true
3107, 1566721912586, 6378, 1566721913570, 7362, 984, true
3108, 1566721912586, 6378, 1566721913513, 7305, 927, true
3109, 1566721912586, 6378, 1566721913515, 7307, 929, true
3110, 1566721912586, 6378, 1566721913650, 7442, 1064, true
3111, 1566721912586, 6378, 1566721913891, 7683, 1305, true
3112, 1566721912587, 6379, 1566721913891, 7683, 1304, true
3113, 1566721912587, 6379, 1566721913521, 7313, 934, true
3114, 1566721912666, 6458, 1566721913557, 7349, 891, true
3115, 1566721912666, 6458, 1566721913520, 7312, 854, true
3116, 1566721912667, 6459, 1566721913514, 7306, 847, true
3117, 1566721912667, 6459, 1566721913510, 7302, 843, true
3118, 1566721912667, 6459, 1566721913524, 7316, 857, true
3119, 1566721912667, 6459, 1566721913524, 7316, 857, true
3120, 1566721912667, 6459, 1566721913523, 7315, 856, true
3121, 1566721912668, 6460, 1566721913529, 7321, 861, true
3122, 1566721912668, 6460, 1566721913891, 7683, 1223, true
3123, 1566721912668, 6460, 1566721913541, 7333, 873, true
3124, 1566721912668, 6460, 1566721913514, 7306, 846, true
3125, 1566721912668, 6460, 1566721913510, 7302, 842, true
3126, 1566721912669, 6461, 1566721913891, 7683, 1222, true
3127, 1566721912669, 6461, 1566721913555, 7347, 886, true
3128, 1566721912669, 6461, 1566721913516, 7308, 847, true
3129, 1566721912669, 6461, 1566721913511, 7303, 842, true
3130, 1566721912669, 6461, 1566721913511, 7303, 842, true
3131, 1566721912670, 6462, 1566721913560, 7352, 890, true
3132, 1566721912670, 6462, 1566721913513, 7305, 843, true
3133, 1566721912670, 6462, 1566721913682, 7474, 1012, true
3134, 1566721912670, 6462, 1566721913523, 7315, 853, true
3135, 1566721912670, 6462, 1566721913516, 7308, 846, true
3136, 1566721912670, 6462, 1566721913512, 7304, 842, true
3137, 1566721912671, 6463, 1566721913519, 7311, 848, true
3138, 1566721912671, 6463, 1566721913525, 7317, 854, true
3139, 1566721912671, 6463, 1566721913893, 7685, 1222, true
3140, 1566721912671, 6463, 1566721913514, 7306, 843, true
3141, 1566721912672, 6464, 1566721913892, 7684, 1220, true
3142, 1566721912672, 6464, 1566721913522, 7314, 850, true
3143, 1566721912672, 6464, 1566721913515, 7307, 843, true
3144, 1566721912672, 6464, 1566721913892, 7684, 1220, true
3145, 1566721912672, 6464, 1566721913516, 7308, 844, true
3146, 1566721912672, 6464, 1566721913563, 7355, 891, true
3147, 1566721912673, 6465, 1566721913562, 7354, 889, true
3148, 1566721912673, 6465, 1566721913513, 7305, 840, true
3149, 1566721912673, 6465, 1566721913541, 7333, 868, true
3150, 1566721912673, 6465, 1566721913524, 7316, 851, true
3151, 1566721912673, 6465, 1566721913515, 7307, 842, true
3152, 1566721912673, 6465, 1566721913519, 7311, 846, true
3153, 1566721912674, 6466, 1566721913524, 7316, 850, true
3154, 1566721912674, 6466, 1566721913541, 7333, 867, true
3155, 1566721912674, 6466, 1566721913528, 7320, 854, true
3156, 1566721912674, 6466, 1566721913560, 7352, 886, true
3157, 1566721912674, 6466, 1566721913515, 7307, 841, true
3158, 1566721912675, 6467, 1566721913518, 7310, 843, true
3159, 1566721912675, 6467, 1566721913570, 7362, 895, true
3160, 1566721912675, 6467, 1566721913522, 7314, 847, true
3161, 1566721912675, 6467, 1566721913516, 7308, 841, true
3162, 1566721912675, 6467, 1566721913511, 7303, 836, true
3163, 1566721912676, 6468, 1566721913890, 7682, 1214, true
3164, 1566721912676, 6468, 1566721913890, 7682, 1214, true
3165, 1566721912676, 6468, 1566721913892, 7684, 1216, true
3166, 1566721912676, 6468, 1566721913892, 7684, 1216, true
3167, 1566721912677, 6469, 1566721913892, 7684, 1215, true
3168, 1566721912677, 6469, 1566721913890, 7682, 1213, true
3169, 1566721912678, 6470, 1566721913891, 7683, 1213, true
3170, 1566721912678, 6470, 1566721913892, 7684, 1214, true
3171, 1566721912678, 6470, 1566721913514, 7306, 836, true
3172, 1566721912678, 6470, 1566721913512, 7304, 834, true
3173, 1566721912678, 6470, 1566721913512, 7304, 834, true
3174, 1566721912678, 6470, 1566721913540, 7332, 862, true
3175, 1566721912679, 6471, 1566721913511, 7303, 832, true
3176, 1566721912679, 6471, 1566721913560, 7352, 881, true
3177, 1566721912679, 6471, 1566721913525, 7317, 846, true
3178, 1566721912679, 6471, 1566721913513, 7305, 834, true
3179, 1566721912679, 6471, 1566721913893, 7685, 1214, true
3180, 1566721912679, 6471, 1566721913541, 7333, 862, true
3181, 1566721912680, 6472, 1566721913528, 7320, 848, true
3182, 1566721912680, 6472, 1566721913560, 7352, 880, true
3183, 1566721912680, 6472, 1566721913510, 7302, 830, true
3184, 1566721912680, 6472, 1566721913891, 7683, 1211, true
3185, 1566721912680, 6472, 1566721913527, 7319, 847, true
3186, 1566721912681, 6473, 1566721913527, 7319, 846, true
3187, 1566721912681, 6473, 1566721913560, 7352, 879, true
3188, 1566721912681, 6473, 1566721913514, 7306, 833, true
3189, 1566721912681, 6473, 1566721913516, 7308, 835, true
3190, 1566721912681, 6473, 1566721913543, 7335, 862, true
3191, 1566721912682, 6474, 1566721913548, 7340, 866, true
3192, 1566721912682, 6474, 1566721913515, 7307, 833, true
3193, 1566721912682, 6474, 1566721913549, 7341, 867, true
3194, 1566721912682, 6474, 1566721913516, 7308, 834, true
3195, 1566721912682, 6474, 1566721913635, 7427, 953, true
3196, 1566721912683, 6475, 1566721913547, 7339, 864, true
3197, 1566721912683, 6475, 1566721913548, 7340, 865, true
3198, 1566721912683, 6475, 1566721913547, 7339, 864, true
3199, 1566721912683, 6475, 1566721913546, 7338, 863, true
3200, 1566721912684, 6476, 1566721913548, 7340, 864, true
3201, 1566721912684, 6476, 1566721913544, 7336, 860, true
3202, 1566721912684, 6476, 1566721913520, 7312, 836, true
3203, 1566721912684, 6476, 1566721913544, 7336, 860, true
3204, 1566721912684, 6476, 1566721913520, 7312, 836, true
3205, 1566721912685, 6477, 1566721913546, 7338, 861, true
3206, 1566721912685, 6477, 1566721913543, 7335, 858, true
3207, 1566721912685, 6477, 1566721913543, 7335, 858, true
3208, 1566721912685, 6477, 1566721913519, 7311, 834, true
3209, 1566721912685, 6477, 1566721913627, 7419, 942, true
3210, 1566721912685, 6477, 1566721913545, 7337, 860, true
3211, 1566721912686, 6478, 1566721913548, 7340, 862, true
3212, 1566721912686, 6478, 1566721913548, 7340, 862, true
3213, 1566721912686, 6478, 1566721913521, 7313, 835, true
3214, 1566721912686, 6478, 1566721913545, 7337, 859, true
3215, 1566721912686, 6478, 1566721913545, 7337, 859, true
3216, 1566721912687, 6479, 1566721913544, 7336, 857, true
3217, 1566721912687, 6479, 1566721913549, 7341, 862, true
3218, 1566721912687, 6479, 1566721913519, 7311, 832, true
3219, 1566721912687, 6479, 1566721913516, 7308, 829, true
3220, 1566721912687, 6479, 1566721913542, 7334, 855, true
3221, 1566721912688, 6480, 1566721913515, 7307, 827, true
3222, 1566721912688, 6480, 1566721913550, 7342, 862, true
3223, 1566721912688, 6480, 1566721913547, 7339, 859, true
3224, 1566721912688, 6480, 1566721913549, 7341, 861, true
3225, 1566721912688, 6480, 1566721913544, 7336, 856, true
3226, 1566721912689, 6481, 1566721913545, 7337, 856, true
3227, 1566721912689, 6481, 1566721913519, 7311, 830, true
3228, 1566721912689, 6481, 1566721913549, 7341, 860, true
3229, 1566721912689, 6481, 1566721913544, 7336, 855, true
3230, 1566721912689, 6481, 1566721913549, 7341, 860, true
3231, 1566721912690, 6482, 1566721913550, 7342, 860, true
3232, 1566721912699, 6491, 1566721913516, 7308, 817, true
3233, 1566721912699, 6491, 1566721913547, 7339, 848, true
3234, 1566721912699, 6491, 1566721913541, 7333, 842, true
3235, 1566721912701, 6493, 1566721913546, 7338, 845, true
3236, 1566721912701, 6493, 1566721913548, 7340, 847, true
3237, 1566721912701, 6493, 1566721913542, 7334, 841, true
3238, 1566721912701, 6493, 1566721913515, 7307, 814, true
3239, 1566721912701, 6493, 1566721913541, 7333, 840, true
3240, 1566721912702, 6494, 1566721913547, 7339, 845, true
3241, 1566721912702, 6494, 1566721913542, 7334, 840, true
3242, 1566721912702, 6494, 1566721913545, 7337, 843, true
3243, 1566721912702, 6494, 1566721913543, 7335, 841, true
3244, 1566721912703, 6495, 1566721913544, 7336, 841, true
3245, 1566721912703, 6495, 1566721913543, 7335, 840, true
3246, 1566721912703, 6495, 1566721913551, 7343, 848, true
3247, 1566721912703, 6495, 1566721913542, 7334, 839, true
3248, 1566721912703, 6495, 1566721913542, 7334, 839, true
3249, 1566721912704, 6496, 1566721913546, 7338, 842, true
3250, 1566721912704, 6496, 1566721913547, 7339, 843, true
3251, 1566721912704, 6496, 1566721913544, 7336, 840, true
3252, 1566721912704, 6496, 1566721913546, 7338, 842, true
3253, 1566721912704, 6496, 1566721913551, 7343, 847, true
3254, 1566721912704, 6496, 1566721913545, 7337, 841, true
3255, 1566721912704, 6496, 1566721913515, 7307, 811, true
3256, 1566721912705, 6497, 1566721913549, 7341, 844, true
3257, 1566721912705, 6497, 1566721913543, 7335, 838, true
3258, 1566721912705, 6497, 1566721913522, 7314, 817, true
3259, 1566721912705, 6497, 1566721913542, 7334, 837, true
3260, 1566721912705, 6497, 1566721913547, 7339, 842, true
3261, 1566721912705, 6497, 1566721913550, 7342, 845, true
3262, 1566721912705, 6497, 1566721913546, 7338, 841, true
3263, 1566721912705, 6497, 1566721913520, 7312, 815, true
3264, 1566721912705, 6497, 1566721913547, 7339, 842, true
3265, 1566721912705, 6497, 1566721913549, 7341, 844, true
3266, 1566721912706, 6498, 1566721913515, 7307, 809, true
3267, 1566721912706, 6498, 1566721913517, 7309, 811, true
3268, 1566721912706, 6498, 1566721913546, 7338, 840, true
3269, 1566721912706, 6498, 1566721913548, 7340, 842, true
3270, 1566721912706, 6498, 1566721913542, 7334, 836, true
3271, 1566721912706, 6498, 1566721913550, 7342, 844, true
3272, 1566721912706, 6498, 1566721913551, 7343, 845, true
3273, 1566721912706, 6498, 1566721913521, 7313, 815, true
3274, 1566721912706, 6498, 1566721913549, 7341, 843, true
3275, 1566721912707, 6499, 1566721913543, 7335, 836, true
3276, 1566721912707, 6499, 1566721913545, 7337, 838, true
3277, 1566721912707, 6499, 1566721913547, 7339, 840, true
3278, 1566721912707, 6499, 1566721913551, 7343, 844, true
3279, 1566721912707, 6499, 1566721913548, 7340, 841, true
3280, 1566721912707, 6499, 1566721913350, 7142, 643, true
3281, 1566721912707, 6499, 1566721913551, 7343, 844, true
3282, 1566721913116, 6908, 1566721913579, 7371, 463, true
3283, 1566721913117, 6909, 1566721913890, 7682, 773, true
3284, 1566721913117, 6909, 1566721913889, 7681, 772, true
3285, 1566721913118, 6910, 1566721913890, 7682, 772, true
3286, 1566721913118, 6910, 1566721913890, 7682, 772, true
3287, 1566721913119, 6911, 1566721913585, 7377, 466, true
3288, 1566721913119, 6911, 1566721913890, 7682, 771, true
3289, 1566721913119, 6911, 1566721913893, 7685, 774, true
3290, 1566721913120, 6912, 1566721913889, 7681, 769, true
3291, 1566721913120, 6912, 1566721913597, 7389, 477, true
3292, 1566721913121, 6913, 1566721913586, 7378, 465, true
3293, 1566721913121, 6913, 1566721913964, 7756, 843, true
3294, 1566721913122, 6914, 1566721913884, 7676, 762, true
3295, 1566721913122, 6914, 1566721913884, 7676, 762, true
3296, 1566721913123, 6915, 1566721913889, 7681, 766, true
3297, 1566721913123, 6915, 1566721913883, 7675, 760, true
3298, 1566721913124, 6916, 1566721913591, 7383, 467, true
3299, 1566721913125, 6917, 1566721913595, 7387, 470, true
3300, 1566721913125, 6917, 1566721913889, 7681, 764, true
3301, 1566721913126, 6918, 1566721913883, 7675, 757, true
3302, 1566721913126, 6918, 1566721913597, 7389, 471, true
3303, 1566721913127, 6919, 1566721913890, 7682, 763, true
3304, 1566721913127, 6919, 1566721913889, 7681, 762, true
3305, 1566721913127, 6919, 1566721913884, 7676, 757, true
3306, 1566721913128, 6920, 1566721913597, 7389, 469, true
3307, 1566721913128, 6920, 1566721913889, 7681, 761, true
3308, 1566721913129, 6921, 1566721913599, 7391, 470, true
3309, 1566721913129, 6921, 1566721913883, 7675, 754, true
3310, 1566721913130, 6922, 1566721913884, 7676, 754, true
3311, 1566721913130, 6922, 1566721913597, 7389, 467, true
3312, 1566721913131, 6923, 1566721913883, 7675, 752, true
3313, 1566721913131, 6923, 1566721913884, 7676, 753, true
3314, 1566721913132, 6924, 1566721913605, 7397, 473, true
3315, 1566721913133, 6925, 1566721913883, 7675, 750, true
3316, 1566721913134, 6926, 1566721913883, 7675, 749, true
3317, 1566721913134, 6926, 1566721913883, 7675, 749, true
3318, 1566721913135, 6927, 1566721913633, 7425, 498, true
3319, 1566721913135, 6927, 1566721913633, 7425, 498, true
3320, 1566721913136, 6928, 1566721913633, 7425, 497, true
3321, 1566721913136, 6928, 1566721913879, 7671, 743, true
3322, 1566721913137, 6929, 1566721913879, 7671, 742, true
3323, 1566721913137, 6929, 1566721913624, 7416, 487, true
3324, 1566721913138, 6930, 1566721913624, 7416, 486, true
3325, 1566721913138, 6930, 1566721913880, 7672, 742, true
3326, 1566721913139, 6931, 1566721913880, 7672, 741, true
3327, 1566721913139, 6931, 1566721913624, 7416, 485, true
3328, 1566721913140, 6932, 1566721913883, 7675, 743, true
3329, 1566721913140, 6932, 1566721913630, 7422, 490, true
3330, 1566721913141, 6933, 1566721913892, 7684, 751, true
3331, 1566721913141, 6933, 1566721913879, 7671, 738, true
3332, 1566721913142, 6934, 1566721913879, 7671, 737, true
3333, 1566721913142, 6934, 1566721913633, 7425, 491, true
3334, 1566721913143, 6935, 1566721913633, 7425, 490, true
3335, 1566721913143, 6935, 1566721913879, 7671, 736, true
3336, 1566721913144, 6936, 1566721913879, 7671, 735, true
3337, 1566721913145, 6937, 1566721913880, 7672, 735, true
3338, 1566721913146, 6938, 1566721913879, 7671, 733, true
3339, 1566721913146, 6938, 1566721913879, 7671, 733, true
3340, 1566721913146, 6938, 1566721913633, 7425, 487, true
3341, 1566721913147, 6939, 1566721913883, 7675, 736, true
3342, 1566721913147, 6939, 1566721913878, 7670, 731, true
3343, 1566721913148, 6940, 1566721913878, 7670, 730, true
3344, 1566721913148, 6940, 1566721913878, 7670, 730, true
3345, 1566721913150, 6942, 1566721913878, 7670, 728, true
3346, 1566721913151, 6943, 1566721913879, 7671, 728, true
3347, 1566721913152, 6944, 1566721913878, 7670, 726, true
3348, 1566721913153, 6945, 1566721913878, 7670, 725, true
3349, 1566721913154, 6946, 1566721913879, 7671, 725, true
3350, 1566721913155, 6947, 1566721913633, 7425, 478, true
3351, 1566721913155, 6947, 1566721913879, 7671, 724, true
3352, 1566721913156, 6948, 1566721913633, 7425, 477, true
3353, 1566721913157, 6949, 1566721913879, 7671, 722, true
3354, 1566721913157, 6949, 1566721913878, 7670, 721, true
3355, 1566721913158, 6950, 1566721913633, 7425, 475, true
3356, 1566721913159, 6951, 1566721913879, 7671, 720, true
3357, 1566721913159, 6951, 1566721913878, 7670, 719, true
3358, 1566721913160, 6952, 1566721913649, 7441, 489, true
3359, 1566721913160, 6952, 1566721913889, 7681, 729, true
3360, 1566721913161, 6953, 1566721913877, 7669, 716, true
3361, 1566721913161, 6953, 1566721913878, 7670, 717, true
3362, 1566721913162, 6954, 1566721913644, 7436, 482, true
3363, 1566721913162, 6954, 1566721913878, 7670, 716, true
3364, 1566721913163, 6955, 1566721913878, 7670, 715, true
3365, 1566721913163, 6955, 1566721913877, 7669, 714, true
3366, 1566721913164, 6956, 1566721913877, 7669, 713, true
3367, 1566721913165, 6957, 1566721913644, 7436, 479, true
3368, 1566721913169, 6961, 1566721913877, 7669, 708, true
3369, 1566721913169, 6961, 1566721913878, 7670, 709, true
3370, 1566721913172, 6964, 1566721913878, 7670, 706, true
3371, 1566721913172, 6964, 1566721913649, 7441, 477, true
3372, 1566721913174, 6966, 1566721913889, 7681, 715, true
3373, 1566721913175, 6967, 1566721913877, 7669, 702, true
3374, 1566721913175, 6967, 1566721913877, 7669, 702, true
3375, 1566721913178, 6970, 1566721913876, 7668, 698, true
3376, 1566721913178, 6970, 1566721913876, 7668, 698, true
3377, 1566721913180, 6972, 1566721913877, 7669, 697, true
3378, 1566721913181, 6973, 1566721913877, 7669, 696, true
3379, 1566721913182, 6974, 1566721913649, 7441, 467, true
3380, 1566721913182, 6974, 1566721913650, 7442, 468, true
3381, 1566721913183, 6975, 1566721913877, 7669, 694, true
3382, 1566721913183, 6975, 1566721913650, 7442, 467, true
3383, 1566721913184, 6976, 1566721913649, 7441, 465, true
3384, 1566721913185, 6977, 1566721913867, 7659, 682, true
3385, 1566721913185, 6977, 1566721913877, 7669, 692, true
3386, 1566721913186, 6978, 1566721913877, 7669, 691, true
3387, 1566721913186, 6978, 1566721913867, 7659, 681, true
3388, 1566721913187, 6979, 1566721913891, 7683, 704, true
3389, 1566721913188, 6980, 1566721913867, 7659, 679, true
3390, 1566721913190, 6982, 1566721913711, 7503, 521, true
3391, 1566721913190, 6982, 1566721913711, 7503, 521, true
3392, 1566721913191, 6983, 1566721913893, 7685, 702, true
3393, 1566721913191, 6983, 1566721913710, 7502, 519, true
3394, 1566721913191, 6983, 1566721913579, 7371, 388, true
3395, 1566721913192, 6984, 1566721913711, 7503, 519, true
3396, 1566721913192, 6984, 1566721913928, 7720, 736, true
3397, 1566721913193, 6985, 1566721913710, 7502, 517, true
3398, 1566721913193, 6985, 1566721913893, 7685, 700, true
3399, 1566721913194, 6986, 1566721913893, 7685, 699, true
3400, 1566721913194, 6986, 1566721913928, 7720, 734, true
3401, 1566721913195, 6987, 1566721913712, 7504, 517, true
3402, 1566721913196, 6988, 1566721913712, 7504, 516, true
3403, 1566721913197, 6989, 1566721913712, 7504, 515, true
3404, 1566721913197, 6989, 1566721913711, 7503, 514, true
3405, 1566721913198, 6990, 1566721913712, 7504, 514, true
3406, 1566721913198, 6990, 1566721913893, 7685, 695, true
3407, 1566721913198, 6990, 1566721913712, 7504, 514, true
3408, 1566721913199, 6991, 1566721913712, 7504, 513, true
3409, 1566721913199, 6991, 1566721913891, 7683, 692, true
3410, 1566721913199, 6991, 1566721913893, 7685, 694, true
3411, 1566721913200, 6992, 1566721913889, 7681, 689, true
3412, 1566721913200, 6992, 1566721913712, 7504, 512, true
3413, 1566721913201, 6993, 1566721913893, 7685, 692, true
3414, 1566721913201, 6993, 1566721913719, 7511, 518, true
3415, 1566721913202, 6994, 1566721913893, 7685, 691, true
3416, 1566721913203, 6995, 1566721913720, 7512, 517, true
3417, 1566721913203, 6995, 1566721913893, 7685, 690, true
3418, 1566721913204, 6996, 1566721913712, 7504, 508, true
3419, 1566721913204, 6996, 1566721913720, 7512, 516, true
3420, 1566721913205, 6997, 1566721913719, 7511, 514, true
3421, 1566721913205, 6997, 1566721913712, 7504, 507, true
3422, 1566721913206, 6998, 1566721913891, 7683, 685, true
3423, 1566721913206, 6998, 1566721913889, 7681, 683, true
3424, 1566721913207, 6999, 1566721913892, 7684, 685, true
3425, 1566721913207, 6999, 1566721913893, 7685, 686, true
3426, 1566721913208, 7000, 1566721913892, 7684, 684, true
3427, 1566721913208, 7000, 1566721913720, 7512, 512, true
3428, 1566721913208, 7000, 1566721913719, 7511, 511, true
3429, 1566721913208, 7000, 1566721913892, 7684, 684, true
3430, 1566721913209, 7001, 1566721913720, 7512, 511, true
3431, 1566721913224, 7016, 1566721913890, 7682, 666, true
3432, 1566721913225, 7017, 1566721913890, 7682, 665, true
3433, 1566721913225, 7017, 1566721913579, 7371, 354, true
3434, 1566721913226, 7018, 1566721913573, 7365, 347, true
3435, 1566721913226, 7018, 1566721913570, 7362, 344, true
3436, 1566721913226, 7018, 1566721913650, 7442, 424, true
3437, 1566721913227, 7019, 1566721913877, 7669, 650, true
3438, 1566721913228, 7020, 1566721913877, 7669, 649, true
3439, 1566721913229, 7021, 1566721913867, 7659, 638, true
3440, 1566721913229, 7021, 1566721913866, 7658, 637, true
3441, 1566721913230, 7022, 1566721913867, 7659, 637, true
3442, 1566721913230, 7022, 1566721913650, 7442, 420, true
3443, 1566721913231, 7023, 1566721913866, 7658, 635, true
3444, 1566721913232, 7024, 1566721913866, 7658, 634, true
3445, 1566721913232, 7024, 1566721913650, 7442, 418, true
3446, 1566721913233, 7025, 1566721913866, 7658, 633, true
3447, 1566721913233, 7025, 1566721913866, 7658, 633, true
3448, 1566721913234, 7026, 1566721913866, 7658, 632, true
3449, 1566721913234, 7026, 1566721913650, 7442, 416, true
3450, 1566721913235, 7027, 1566721913866, 7658, 631, true
3451, 1566721913235, 7027, 1566721913866, 7658, 631, true
3452, 1566721913236, 7028, 1566721913662, 7454, 426, true
3453, 1566721913236, 7028, 1566721913866, 7658, 630, true
3454, 1566721913236, 7028, 1566721913662, 7454, 426, true
3455, 1566721913236, 7028, 1566721913660, 7452, 424, true
3456, 1566721913237, 7029, 1566721913866, 7658, 629, true
3457, 1566721913237, 7029, 1566721913866, 7658, 629, true
3458, 1566721913237, 7029, 1566721913662, 7454, 425, true
3459, 1566721913237, 7029, 1566721913866, 7658, 629, true
3460, 1566721913238, 7030, 1566721913866, 7658, 628, true
3461, 1566721913238, 7030, 1566721913865, 7657, 627, true
3462, 1566721913238, 7030, 1566721913663, 7455, 425, true
3463, 1566721913238, 7030, 1566721913865, 7657, 627, true
3464, 1566721913239, 7031, 1566721913865, 7657, 626, true
3465, 1566721913239, 7031, 1566721913666, 7458, 427, true
3466, 1566721913239, 7031, 1566721913865, 7657, 626, true
3467, 1566721913240, 7032, 1566721913865, 7657, 625, true
3468, 1566721913240, 7032, 1566721913662, 7454, 422, true
3469, 1566721913240, 7032, 1566721913865, 7657, 625, true
3470, 1566721913240, 7032, 1566721913865, 7657, 625, true
3471, 1566721913241, 7033, 1566721913865, 7657, 624, true
3472, 1566721913241, 7033, 1566721913663, 7455, 422, true
3473, 1566721913241, 7033, 1566721913666, 7458, 425, true
3474, 1566721913241, 7033, 1566721913864, 7656, 623, true
3475, 1566721913242, 7034, 1566721913865, 7657, 623, true
3476, 1566721913242, 7034, 1566721913865, 7657, 623, true
3477, 1566721913242, 7034, 1566721913667, 7459, 425, true
3478, 1566721913243, 7035, 1566721913865, 7657, 622, true
3479, 1566721913243, 7035, 1566721913667, 7459, 424, true
3480, 1566721913243, 7035, 1566721913865, 7657, 622, true
3481, 1566721913244, 7036, 1566721913864, 7656, 620, true
3482, 1566721913244, 7036, 1566721913859, 7651, 615, true
3483, 1566721913244, 7036, 1566721913859, 7651, 615, true
3484, 1566721913244, 7036, 1566721913667, 7459, 423, true
3485, 1566721913245, 7037, 1566721913859, 7651, 614, true
3486, 1566721913245, 7037, 1566721913667, 7459, 422, true
3487, 1566721913245, 7037, 1566721913864, 7656, 619, true
3488, 1566721913245, 7037, 1566721913864, 7656, 619, true
3489, 1566721913246, 7038, 1566721913667, 7459, 421, true
3490, 1566721913246, 7038, 1566721913859, 7651, 613, true
3491, 1566721913247, 7039, 1566721913859, 7651, 612, true
3492, 1566721913247, 7039, 1566721913667, 7459, 420, true
3493, 1566721913247, 7039, 1566721913859, 7651, 612, true
3494, 1566721913247, 7039, 1566721913860, 7652, 613, true
3495, 1566721913248, 7040, 1566721913667, 7459, 419, true
3496, 1566721913248, 7040, 1566721913860, 7652, 612, true
3497, 1566721913248, 7040, 1566721913669, 7461, 421, true
3498, 1566721913249, 7041, 1566721913858, 7650, 609, true
3499, 1566721913249, 7041, 1566721913669, 7461, 420, true
3500, 1566721913249, 7041, 1566721913858, 7650, 609, true
3501, 1566721913250, 7042, 1566721913858, 7650, 608, true
3502, 1566721913250, 7042, 1566721913858, 7650, 608, true
3503, 1566721913250, 7042, 1566721913859, 7651, 609, true
3504, 1566721913251, 7043, 1566721913858, 7650, 607, true
3505, 1566721913252, 7044, 1566721913858, 7650, 606, true
3506, 1566721913253, 7045, 1566721913858, 7650, 605, true
3507, 1566721913253, 7045, 1566721913669, 7461, 416, true
3508, 1566721913254, 7046, 1566721913858, 7650, 604, true
3509, 1566721913255, 7047, 1566721913669, 7461, 414, true
3510, 1566721913256, 7048, 1566721913858, 7650, 602, true
3511, 1566721913256, 7048, 1566721913858, 7650, 602, true
3512, 1566721913257, 7049, 1566721913867, 7659, 610, true
3513, 1566721913258, 7050, 1566721913674, 7466, 416, true
3514, 1566721913259, 7051, 1566721913672, 7464, 413, true
3515, 1566721913260, 7052, 1566721913858, 7650, 598, true
3516, 1566721913260, 7052, 1566721913867, 7659, 607, true
3517, 1566721913260, 7052, 1566721913674, 7466, 414, true
3518, 1566721913260, 7052, 1566721913674, 7466, 414, true
3519, 1566721913261, 7053, 1566721913864, 7656, 603, true
3520, 1566721913261, 7053, 1566721913866, 7658, 605, true
3521, 1566721913262, 7054, 1566721913671, 7463, 409, true
3522, 1566721913262, 7054, 1566721913850, 7642, 588, true
3523, 1566721913262, 7054, 1566721913867, 7659, 605, true
3524, 1566721913263, 7055, 1566721913857, 7649, 594, true
3525, 1566721913263, 7055, 1566721913850, 7642, 587, true
3526, 1566721913263, 7055, 1566721913850, 7642, 587, true
3527, 1566721913264, 7056, 1566721913867, 7659, 603, true
3528, 1566721913264, 7056, 1566721913850, 7642, 586, true
3529, 1566721913264, 7056, 1566721913674, 7466, 410, true
3530, 1566721913265, 7057, 1566721913850, 7642, 585, true
3531, 1566721913267, 7059, 1566721913672, 7464, 405, true
3532, 1566721913268, 7060, 1566721913850, 7642, 582, true
3533, 1566721913268, 7060, 1566721913679, 7471, 411, true
3534, 1566721913268, 7060, 1566721913720, 7512, 452, true
3535, 1566721913269, 7061, 1566721913720, 7512, 451, true
3536, 1566721913269, 7061, 1566721913679, 7471, 410, true
3537, 1566721913269, 7061, 1566721913712, 7504, 443, true
3538, 1566721913270, 7062, 1566721913720, 7512, 450, true
3539, 1566721913270, 7062, 1566721913719, 7511, 449, true
3540, 1566721913270, 7062, 1566721913679, 7471, 409, true
3541, 1566721913270, 7062, 1566721913712, 7504, 442, true
3542, 1566721913271, 7063, 1566721913719, 7511, 448, true
3543, 1566721913271, 7063, 1566721913720, 7512, 449, true
3544, 1566721913272, 7064, 1566721913679, 7471, 407, true
3545, 1566721913272, 7064, 1566721913711, 7503, 439, true
3546, 1566721913272, 7064, 1566721913712, 7504, 440, true
3547, 1566721913273, 7065, 1566721913679, 7471, 406, true
3548, 1566721913273, 7065, 1566721913719, 7511, 446, true
3549, 1566721913273, 7065, 1566721913712, 7504, 439, true
3550, 1566721913274, 7066, 1566721913679, 7471, 405, true
3551, 1566721913274, 7066, 1566721913719, 7511, 445, true
3552, 1566721913274, 7066, 1566721913710, 7502, 436, true
3553, 1566721913274, 7066, 1566721913679, 7471, 405, true
3554, 1566721913275, 7067, 1566721913711, 7503, 436, true
3555, 1566721913275, 7067, 1566721913712, 7504, 437, true
3556, 1566721913278, 7070, 1566721913680, 7472, 402, true
3557, 1566721913278, 7070, 1566721913710, 7502, 432, true
3558, 1566721913279, 7071, 1566721913700, 7492, 421, true
3559, 1566721913279, 7071, 1566721913701, 7493, 422, true
3560, 1566721913280, 7072, 1566721913687, 7479, 407, true
3561, 1566721913280, 7072, 1566721913700, 7492, 420, true
3562, 1566721913281, 7073, 1566721913685, 7477, 404, true
3563, 1566721913281, 7073, 1566721913680, 7472, 399, true
3564, 1566721913281, 7073, 1566721913684, 7476, 403, true
3565, 1566721913281, 7073, 1566721913680, 7472, 399, true
3566, 1566721913282, 7074, 1566721913700, 7492, 418, true
3567, 1566721913282, 7074, 1566721913700, 7492, 418, true
3568, 1566721913282, 7074, 1566721913680, 7472, 398, true
3569, 1566721913283, 7075, 1566721913697, 7489, 414, true
3570, 1566721913283, 7075, 1566721913682, 7474, 399, true
3571, 1566721913283, 7075, 1566721913680, 7472, 397, true
3572, 1566721913284, 7076, 1566721913686, 7478, 402, true
3573, 1566721913284, 7076, 1566721913929, 7721, 645, true
3574, 1566721913285, 7077, 1566721913683, 7475, 398, true
3575, 1566721913285, 7077, 1566721913683, 7475, 398, true
3576, 1566721913285, 7077, 1566721913686, 7478, 401, true
3577, 1566721913286, 7078, 1566721913682, 7474, 396, true
3578, 1566721913286, 7078, 1566721913685, 7477, 399, true
3579, 1566721913286, 7078, 1566721913682, 7474, 396, true
3580, 1566721913287, 7079, 1566721913687, 7479, 400, true
3581, 1566721913287, 7079, 1566721913687, 7479, 400, true
3582, 1566721913287, 7079, 1566721913697, 7489, 410, true
3583, 1566721913287, 7079, 1566721913687, 7479, 400, true
3584, 1566721913288, 7080, 1566721913683, 7475, 395, true
3585, 1566721913288, 7080, 1566721913683, 7475, 395, true
3586, 1566721913289, 7081, 1566721913928, 7720, 639, true
3587, 1566721913289, 7081, 1566721913929, 7721, 640, true
3588, 1566721913289, 7081, 1566721913697, 7489, 408, true
3589, 1566721913289, 7081, 1566721913697, 7489, 408, true
3590, 1566721913290, 7082, 1566721913894, 7686, 604, true
3591, 1566721913290, 7082, 1566721913928, 7720, 638, true
3592, 1566721913291, 7083, 1566721913697, 7489, 406, true
3593, 1566721913291, 7083, 1566721913688, 7480, 397, true
3594, 1566721913291, 7083, 1566721913697, 7489, 406, true
3595, 1566721913292, 7084, 1566721913688, 7480, 396, true
3596, 1566721913292, 7084, 1566721913697, 7489, 405, true
3597, 1566721913293, 7085, 1566721913698, 7490, 405, true
3598, 1566721913293, 7085, 1566721913894, 7686, 601, true
3599, 1566721913293, 7085, 1566721913697, 7489, 404, true
3600, 1566721913293, 7085, 1566721913697, 7489, 404, true
3601, 1566721913294, 7086, 1566721913700, 7492, 406, true
3602, 1566721913294, 7086, 1566721913700, 7492, 406, true
3603, 1566721913295, 7087, 1566721913929, 7721, 634, true
3604, 1566721913295, 7087, 1566721913697, 7489, 402, true
3605, 1566721913295, 7087, 1566721913700, 7492, 405, true
3606, 1566721913295, 7087, 1566721913700, 7492, 405, true
3607, 1566721913296, 7088, 1566721913928, 7720, 632, true
3608, 1566721913296, 7088, 1566721913700, 7492, 404, true
3609, 1566721913297, 7089, 1566721913700, 7492, 403, true
3610, 1566721913297, 7089, 1566721913700, 7492, 403, true
3611, 1566721913297, 7089, 1566721913701, 7493, 404, true
3612, 1566721913297, 7089, 1566721913701, 7493, 404, true
3613, 1566721913298, 7090, 1566721913894, 7686, 596, true
3614, 1566721913298, 7090, 1566721913701, 7493, 403, true
3615, 1566721913299, 7091, 1566721913701, 7493, 402, true
3616, 1566721913299, 7091, 1566721913701, 7493, 402, true
3617, 1566721913299, 7091, 1566721913701, 7493, 402, true
3618, 1566721913299, 7091, 1566721913701, 7493, 402, true
3619, 1566721913300, 7092, 1566721913701, 7493, 401, true
3620, 1566721913301, 7093, 1566721913701, 7493, 400, true
3621, 1566721913301, 7093, 1566721913711, 7503, 410, true
3622, 1566721913302, 7094, 1566721913701, 7493, 399, true
3623, 1566721913302, 7094, 1566721913701, 7493, 399, true
3624, 1566721913302, 7094, 1566721913701, 7493, 399, true
3625, 1566721913303, 7095, 1566721913703, 7495, 400, true
3626, 1566721913304, 7096, 1566721913894, 7686, 590, true
3627, 1566721913305, 7097, 1566721913711, 7503, 406, true
3628, 1566721913306, 7098, 1566721913702, 7494, 396, true
3629, 1566721913307, 7099, 1566721913703, 7495, 396, true
3630, 1566721913313, 7105, 1566721913711, 7503, 398, true
3631, 1566721913314, 7106, 1566721913711, 7503, 397, true
3632, 1566721913315, 7107, 1566721913711, 7503, 396, true
3633, 1566721913316, 7108, 1566721913893, 7685, 577, true
3634, 1566721913317, 7109, 1566721913712, 7504, 395, true
3635, 1566721913318, 7110, 1566721913712, 7504, 394, true
3636, 1566721913319, 7111, 1566721913711, 7503, 392, true
3637, 1566721913320, 7112, 1566721913954, 7746, 634, true
3638, 1566721913322, 7114, 1566721913892, 7684, 570, true
3639, 1566721913323, 7115, 1566721913712, 7504, 389, true
3640, 1566721913326, 7118, 1566721913712, 7504, 386, true
3641, 1566721913327, 7119, 1566721913720, 7512, 393, true
3642, 1566721913328, 7120, 1566721913720, 7512, 392, true
3643, 1566721913329, 7121, 1566721913720, 7512, 391, true
3644, 1566721913331, 7123, 1566721913720, 7512, 389, true
3645, 1566721913341, 7133, 1566721913850, 7642, 509, true
3646, 1566721913343, 7135, 1566721913851, 7643, 508, true
3647, 1566721913355, 7147, 1566721913940, 7732, 585, true
3648, 1566721913597, 7389, 1566721913928, 7720, 331, true
3649, 1566721913606, 7398, 1566721913928, 7720, 322, true
3650, 1566721913606, 7398, 1566721913928, 7720, 322, true
3651, 1566721913607, 7399, 1566721913928, 7720, 321, true
3652, 1566721913607, 7399, 1566721913928, 7720, 321, true
3653, 1566721913607, 7399, 1566721913928, 7720, 321, true
3654, 1566721913608, 7400, 1566721913928, 7720, 320, true
3655, 1566721913608, 7400, 1566721913928, 7720, 320, true
3656, 1566721913628, 7420, 1566721913928, 7720, 300, true
3657, 1566721913628, 7420, 1566721913928, 7720, 300, true
3658, 1566721913629, 7421, 1566721913928, 7720, 299, true
3659, 1566721913634, 7426, 1566721913928, 7720, 294, true
3660, 1566721913639, 7431, 1566721913927, 7719, 288, true
3661, 1566721913640, 7432, 1566721913927, 7719, 287, true
3662, 1566721913642, 7434, 1566721913927, 7719, 285, true
3663, 1566721913643, 7435, 1566721913927, 7719, 284, true
3664, 1566721913645, 7437, 1566721913927, 7719, 282, true
3665, 1566721913652, 7444, 1566721913927, 7719, 275, true
3666, 1566721913652, 7444, 1566721913927, 7719, 275, true
3667, 1566721913652, 7444, 1566721913927, 7719, 275, true
3668, 1566721913654, 7446, 1566721913927, 7719, 273, true
3669, 1566721913655, 7447, 1566721913927, 7719, 272, true
3670, 1566721913657, 7449, 1566721913927, 7719, 270, true
3671, 1566721913659, 7451, 1566721913927, 7719, 268, true
3672, 1566721913669, 7461, 1566721913927, 7719, 258, true
3673, 1566721913732, 7524, 1566721914048, 7840, 316, true
3674, 1566721913735, 7527, 1566721914115, 7907, 380, true
3675, 1566721913736, 7528, 1566721914149, 7941, 413, true
3676, 1566721913736, 7528, 1566721914115, 7907, 379, true
3677, 1566721913736, 7528, 1566721914048, 7840, 312, true
3678, 1566721913736, 7528, 1566721914048, 7840, 312, true
3679, 1566721913737, 7529, 1566721914148, 7940, 411, true
3680, 1566721913737, 7529, 1566721914149, 7941, 412, true
3681, 1566721913738, 7530, 1566721914048, 7840, 310, true
3682, 1566721913738, 7530, 1566721914148, 7940, 410, true
3683, 1566721913738, 7530, 1566721914048, 7840, 310, true
3684, 1566721913739, 7531, 1566721914146, 7938, 407, true
3685, 1566721913739, 7531, 1566721914146, 7938, 407, true
3686, 1566721913740, 7532, 1566721914146, 7938, 406, true
3687, 1566721913740, 7532, 1566721914049, 7841, 309, true
3688, 1566721913741, 7533, 1566721914147, 7939, 406, true
3689, 1566721913741, 7533, 1566721914148, 7940, 407, true
3690, 1566721913741, 7533, 1566721914148, 7940, 407, true
3691, 1566721913742, 7534, 1566721914049, 7841, 307, true
3692, 1566721913742, 7534, 1566721914147, 7939, 405, true
3693, 1566721913743, 7535, 1566721914049, 7841, 306, true
3694, 1566721913743, 7535, 1566721914147, 7939, 404, true
3695, 1566721913743, 7535, 1566721914148, 7940, 405, true
3696, 1566721913744, 7536, 1566721914049, 7841, 305, true
3697, 1566721913744, 7536, 1566721914147, 7939, 403, true
3698, 1566721913745, 7537, 1566721914049, 7841, 304, true
3699, 1566721913745, 7537, 1566721914147, 7939, 402, true
3700, 1566721913745, 7537, 1566721914147, 7939, 402, true
3701, 1566721913746, 7538, 1566721914148, 7940, 402, true
3702, 1566721913747, 7539, 1566721914146, 7938, 399, true
3703, 1566721913747, 7539, 1566721914054, 7846, 307, true
3704, 1566721913747, 7539, 1566721914148, 7940, 401, true
3705, 1566721913748, 7540, 1566721914049, 7841, 301, true
3706, 1566721913748, 7540, 1566721914146, 7938, 398, true
3707, 1566721913749, 7541, 1566721914148, 7940, 399, true
3708, 1566721913749, 7541, 1566721914147, 7939, 398, true
3709, 1566721913749, 7541, 1566721914147, 7939, 398, true
3710, 1566721913750, 7542, 1566721914145, 7937, 395, true
3711, 1566721913750, 7542, 1566721914145, 7937, 395, true
3712, 1566721913751, 7543, 1566721914054, 7846, 303, true
3713, 1566721913751, 7543, 1566721914148, 7940, 397, true
3714, 1566721913751, 7543, 1566721914054, 7846, 303, true
3715, 1566721913752, 7544, 1566721914146, 7938, 394, true
3716, 1566721913753, 7545, 1566721914054, 7846, 301, true
3717, 1566721913753, 7545, 1566721914144, 7936, 391, true
3718, 1566721913753, 7545, 1566721914054, 7846, 301, true
3719, 1566721913754, 7546, 1566721914146, 7938, 392, true
3720, 1566721913754, 7546, 1566721914146, 7938, 392, true
3721, 1566721913755, 7547, 1566721914144, 7936, 389, true
3722, 1566721913755, 7547, 1566721914054, 7846, 299, true
3723, 1566721913755, 7547, 1566721914145, 7937, 390, true
3724, 1566721913756, 7548, 1566721914144, 7936, 388, true
3725, 1566721913756, 7548, 1566721914057, 7849, 301, true
3726, 1566721913757, 7549, 1566721914145, 7937, 388, true
3727, 1566721913759, 7551, 1566721914145, 7937, 386, true
3728, 1566721913759, 7551, 1566721914134, 7926, 375, true
3729, 1566721913759, 7551, 1566721914134, 7926, 375, true
3730, 1566721913760, 7552, 1566721914145, 7937, 385, true
3731, 1566721913760, 7552, 1566721914057, 7849, 297, true
3732, 1566721913761, 7553, 1566721914059, 7851, 298, true
3733, 1566721913761, 7553, 1566721914134, 7926, 373, true
3734, 1566721913762, 7554, 1566721914145, 7937, 383, true
3735, 1566721913762, 7554, 1566721914133, 7925, 371, true
3736, 1566721913764, 7556, 1566721914071, 7863, 307, true
3737, 1566721913764, 7556, 1566721914145, 7937, 381, true
3738, 1566721913765, 7557, 1566721914133, 7925, 368, true
3739, 1566721913766, 7558, 1566721914130, 7922, 364, true
3740, 1566721913767, 7559, 1566721914111, 7903, 344, true
3741, 1566721913767, 7559, 1566721914126, 7918, 359, true
3742, 1566721913768, 7560, 1566721914130, 7922, 362, true
3743, 1566721913769, 7561, 1566721914130, 7922, 361, true
3744, 1566721913770, 7562, 1566721914110, 7902, 340, true
3745, 1566721913770, 7562, 1566721914110, 7902, 340, true
3746, 1566721913770, 7562, 1566721914110, 7902, 340, true
3747, 1566721913771, 7563, 1566721914110, 7902, 339, true
3748, 1566721913771, 7563, 1566721914130, 7922, 359, true
3749, 1566721913771, 7563, 1566721914121, 7913, 350, true
3750, 1566721913772, 7564, 1566721914109, 7901, 337, true
3751, 1566721913772, 7564, 1566721914131, 7923, 359, true
3752, 1566721913773, 7565, 1566721914121, 7913, 348, true
3753, 1566721913773, 7565, 1566721914129, 7921, 356, true
3754, 1566721913773, 7565, 1566721914109, 7901, 336, true
3755, 1566721913774, 7566, 1566721914126, 7918, 352, true
3756, 1566721913774, 7566, 1566721914121, 7913, 347, true
3757, 1566721913774, 7566, 1566721914126, 7918, 352, true
3758, 1566721913775, 7567, 1566721914123, 7915, 348, true
3759, 1566721913775, 7567, 1566721914131, 7923, 356, true
3760, 1566721913775, 7567, 1566721914120, 7912, 345, true
3761, 1566721913776, 7568, 1566721914109, 7901, 333, true
3762, 1566721913776, 7568, 1566721914120, 7912, 344, true
3763, 1566721913776, 7568, 1566721914129, 7921, 353, true
3764, 1566721913777, 7569, 1566721914145, 7937, 368, true
3765, 1566721913777, 7569, 1566721914131, 7923, 354, true
3766, 1566721913777, 7569, 1566721914130, 7922, 353, true
3767, 1566721913778, 7570, 1566721914124, 7916, 346, true
3768, 1566721913778, 7570, 1566721914114, 7906, 336, true
3769, 1566721913779, 7571, 1566721914109, 7901, 330, true
3770, 1566721913779, 7571, 1566721914110, 7902, 331, true
3771, 1566721913779, 7571, 1566721914114, 7906, 335, true
3772, 1566721913780, 7572, 1566721914110, 7902, 330, true
3773, 1566721913780, 7572, 1566721914121, 7913, 341, true
3774, 1566721913781, 7573, 1566721914122, 7914, 341, true
3775, 1566721913781, 7573, 1566721914129, 7921, 348, true
3776, 1566721913781, 7573, 1566721914109, 7901, 328, true
3777, 1566721913782, 7574, 1566721914131, 7923, 349, true
3778, 1566721913782, 7574, 1566721914114, 7906, 332, true
3779, 1566721913783, 7575, 1566721914109, 7901, 326, true
3780, 1566721913783, 7575, 1566721914109, 7901, 326, true
3781, 1566721913783, 7575, 1566721914130, 7922, 347, true
3782, 1566721913784, 7576, 1566721914110, 7902, 326, true
3783, 1566721913784, 7576, 1566721914124, 7916, 340, true
3784, 1566721913785, 7577, 1566721914121, 7913, 336, true
3785, 1566721913785, 7577, 1566721914121, 7913, 336, true
3786, 1566721913785, 7577, 1566721914125, 7917, 340, true
3787, 1566721913786, 7578, 1566721914110, 7902, 324, true
3788, 1566721913786, 7578, 1566721914131, 7923, 345, true
3789, 1566721913787, 7579, 1566721914130, 7922, 343, true
3790, 1566721913787, 7579, 1566721914123, 7915, 336, true
3791, 1566721913787, 7579, 1566721914120, 7912, 333, true
3792, 1566721913788, 7580, 1566721914121, 7913, 333, true
3793, 1566721913788, 7580, 1566721914130, 7922, 342, true
3794, 1566721913789, 7581, 1566721914123, 7915, 334, true
3795, 1566721913789, 7581, 1566721914113, 7905, 324, true
3796, 1566721913790, 7582, 1566721914121, 7913, 331, true
3797, 1566721913790, 7582, 1566721914126, 7918, 336, true
3798, 1566721913791, 7583, 1566721914130, 7922, 339, true
3799, 1566721913791, 7583, 1566721914120, 7912, 329, true
3800, 1566721913791, 7583, 1566721914120, 7912, 329, true
3801, 1566721913792, 7584, 1566721914114, 7906, 322, true
3802, 1566721913792, 7584, 1566721914114, 7906, 322, true
3803, 1566721913793, 7585, 1566721914120, 7912, 327, true
3804, 1566721913794, 7586, 1566721914120, 7912, 326, true
3805, 1566721913795, 7587, 1566721914120, 7912, 325, true
3806, 1566721913795, 7587, 1566721914114, 7906, 319, true
3807, 1566721913796, 7588, 1566721914117, 7909, 321, true
3808, 1566721913796, 7588, 1566721914116, 7908, 320, true
3809, 1566721913797, 7589, 1566721914114, 7906, 317, true
3810, 1566721913797, 7589, 1566721914117, 7909, 320, true
3811, 1566721913797, 7589, 1566721914117, 7909, 320, true
3812, 1566721913798, 7590, 1566721914116, 7908, 318, true
3813, 1566721913798, 7590, 1566721914115, 7907, 317, true
3814, 1566721913799, 7591, 1566721914114, 7906, 315, true
3815, 1566721913799, 7591, 1566721914149, 7941, 350, true
3816, 1566721913799, 7591, 1566721914152, 7944, 353, true
3817, 1566721913800, 7592, 1566721914149, 7941, 349, true
3818, 1566721913801, 7593, 1566721914149, 7941, 348, true
3819, 1566721913802, 7594, 1566721914158, 7950, 356, true
3820, 1566721913802, 7594, 1566721914196, 7988, 394, true
3821, 1566721913803, 7595, 1566721914170, 7962, 367, true
3822, 1566721913803, 7595, 1566721914196, 7988, 393, true
3823, 1566721913803, 7595, 1566721914150, 7942, 347, true
3824, 1566721913804, 7596, 1566721914150, 7942, 346, true
3825, 1566721913804, 7596, 1566721914170, 7962, 366, true
3826, 1566721913804, 7596, 1566721914149, 7941, 345, true
3827, 1566721913804, 7596, 1566721914172, 7964, 368, true
3828, 1566721913805, 7597, 1566721914150, 7942, 345, true
3829, 1566721913806, 7598, 1566721914151, 7943, 345, true
3830, 1566721913807, 7599, 1566721914149, 7941, 342, true
3831, 1566721913807, 7599, 1566721914172, 7964, 365, true
3832, 1566721913807, 7599, 1566721914150, 7942, 343, true
3833, 1566721913808, 7600, 1566721914154, 7946, 346, true
3834, 1566721913808, 7600, 1566721914172, 7964, 364, true
3835, 1566721913808, 7600, 1566721914150, 7942, 342, true
3836, 1566721913809, 7601, 1566721914170, 7962, 361, true
3837, 1566721913809, 7601, 1566721914149, 7941, 340, true
3838, 1566721913809, 7601, 1566721914170, 7962, 361, true
3839, 1566721913810, 7602, 1566721914150, 7942, 340, true
3840, 1566721913810, 7602, 1566721914149, 7941, 339, true
3841, 1566721913810, 7602, 1566721914173, 7965, 363, true
3842, 1566721913811, 7603, 1566721914171, 7963, 360, true
3843, 1566721913812, 7604, 1566721914172, 7964, 360, true
3844, 1566721913813, 7605, 1566721914151, 7943, 338, true
3845, 1566721913814, 7606, 1566721914171, 7963, 357, true
3846, 1566721913814, 7606, 1566721914171, 7963, 357, true
3847, 1566721913817, 7609, 1566721914172, 7964, 355, true
3848, 1566721913820, 7612, 1566721914171, 7963, 351, true
3849, 1566721913821, 7613, 1566721914150, 7942, 329, true
3850, 1566721913821, 7613, 1566721914151, 7943, 330, true
3851, 1566721913822, 7614, 1566721914149, 7941, 327, true
3852, 1566721913822, 7614, 1566721914154, 7946, 332, true
3853, 1566721913823, 7615, 1566721914171, 7963, 348, true
3854, 1566721913824, 7616, 1566721914158, 7950, 334, true
3855, 1566721913824, 7616, 1566721914196, 7988, 372, true
3856, 1566721913824, 7616, 1566721914150, 7942, 326, true
3857, 1566721913825, 7617, 1566721914158, 7950, 333, true
3858, 1566721913825, 7617, 1566721914170, 7962, 345, true
3859, 1566721913826, 7618, 1566721914149, 7941, 323, true
3860, 1566721913827, 7619, 1566721914149, 7941, 322, true
3861, 1566721913827, 7619, 1566721914170, 7962, 343, true
3862, 1566721913828, 7620, 1566721914172, 7964, 344, true
3863, 1566721913828, 7620, 1566721914171, 7963, 343, true
3864, 1566721913828, 7620, 1566721914171, 7963, 343, true
3865, 1566721913829, 7621, 1566721914171, 7963, 342, true
3866, 1566721913829, 7621, 1566721914171, 7963, 342, true
3867, 1566721913829, 7621, 1566721914172, 7964, 343, true
3868, 1566721913830, 7622, 1566721914171, 7963, 341, true
3869, 1566721913831, 7623, 1566721914155, 7947, 324, true
3870, 1566721913832, 7624, 1566721914171, 7963, 339, true
3871, 1566721913832, 7624, 1566721914171, 7963, 339, true
3872, 1566721913832, 7624, 1566721914172, 7964, 340, true
3873, 1566721913833, 7625, 1566721914171, 7963, 338, true
3874, 1566721913833, 7625, 1566721914172, 7964, 339, true
3875, 1566721913833, 7625, 1566721914172, 7964, 339, true
3876, 1566721913837, 7629, 1566721914172, 7964, 335, true
3877, 1566721913838, 7630, 1566721914171, 7963, 333, true
3878, 1566721914020, 7812, 1566721914234, 8026, 214, true
3879, 1566721914022, 7814, 1566721914233, 8025, 211, true
3880, 1566721914023, 7815, 1566721914235, 8027, 212, true
3881, 1566721914025, 7817, 1566721914234, 8026, 209, true
3882, 1566721914026, 7818, 1566721914234, 8026, 208, true
3883, 1566721914028, 7820, 1566721914244, 8036, 216, true
3884, 1566721914030, 7822, 1566721914244, 8036, 214, true
3885, 1566721914030, 7822, 1566721914246, 8038, 216, true
3886, 1566721914031, 7823, 1566721914246, 8038, 215, true
3887, 1566721914032, 7824, 1566721914246, 8038, 214, true
3888, 1566721914032, 7824, 1566721914246, 8038, 214, true
3889, 1566721914036, 7828, 1566721914244, 8036, 208, true
3890, 1566721914038, 7830, 1566721914244, 8036, 206, true
3891, 1566721914040, 7832, 1566721914249, 8041, 209, true
3892, 1566721914041, 7833, 1566721914263, 8055, 222, true
3893, 1566721914042, 7834, 1566721914259, 8051, 217, true
3894, 1566721914042, 7834, 1566721914255, 8047, 213, true
3895, 1566721914043, 7835, 1566721914259, 8051, 216, true
3896, 1566721914055, 7847, 1566721914268, 8060, 213, true
3897, 1566721914061, 7853, 1566721914268, 8060, 207, true
3898, 1566721914063, 7855, 1566721914270, 8062, 207, true
3899, 1566721914065, 7857, 1566721914273, 8065, 208, true
3900, 1566721914071, 7863, 1566721914275, 8067, 204, true
3901, 1566721914073, 7865, 1566721914279, 8071, 206, true
3902, 1566721914074, 7866, 1566721914279, 8071, 205, true
3903, 1566721914076, 7868, 1566721914287, 8079, 211, true
3904, 1566721914077, 7869, 1566721914287, 8079, 210, true
3905, 1566721914077, 7869, 1566721914287, 8079, 210, true
3906, 1566721914078, 7870, 1566721914287, 8079, 209, true
3907, 1566721914079, 7871, 1566721914283, 8075, 204, true
3908, 1566721914082, 7874, 1566721914288, 8080, 206, true
3909, 1566721914083, 7875, 1566721914287, 8079, 204, true
3910, 1566721914085, 7877, 1566721914295, 8087, 210, true
3911, 1566721914086, 7878, 1566721914294, 8086, 208, true
3912, 1566721914087, 7879, 1566721914297, 8089, 210, true
3913, 1566721914092, 7884, 1566721914302, 8094, 210, true
3914, 1566721914093, 7885, 1566721914384, 8176, 291, true
3915, 1566721914094, 7886, 1566721914384, 8176, 290, true
3916, 1566721914095, 7887, 1566721914384, 8176, 289, true
3917, 1566721914096, 7888, 1566721914384, 8176, 288, true
3918, 1566721914097, 7889, 1566721914384, 8176, 287, true
3919, 1566721914097, 7889, 1566721914310, 8102, 213, true
3920, 1566721914203, 7995, 1566721914406, 8198, 203, true
3921, 1566721914206, 7998, 1566721914412, 8204, 206, true
3922, 1566721914207, 7999, 1566721914413, 8205, 206, true
3923, 1566721914209, 8001, 1566721914418, 8210, 209, true
3924, 1566721914210, 8002, 1566721914418, 8210, 208, true
3925, 1566721914211, 8003, 1566721914418, 8210, 207, true
3926, 1566721914212, 8004, 1566721914418, 8210, 206, true
3927, 1566721914213, 8005, 1566721914418, 8210, 205, true
3928, 1566721914215, 8007, 1566721914425, 8217, 210, true
3929, 1566721914216, 8008, 1566721914427, 8219, 211, true
3930, 1566721914217, 8009, 1566721914427, 8219, 210, true
3931, 1566721914217, 8009, 1566721914426, 8218, 209, true
3932, 1566721914218, 8010, 1566721914427, 8219, 209, true
3933, 1566721914219, 8011, 1566721914427, 8219, 208, true
3934, 1566721914220, 8012, 1566721914427, 8219, 207, true
3935, 1566721914221, 8013, 1566721914427, 8219, 206, true
3936, 1566721914223, 8015, 1566721914433, 8225, 210, true
3937, 1566721914223, 8015, 1566721914427, 8219, 204, true
3938, 1566721914223, 8015, 1566721914433, 8225, 210, true
3939, 1566721914225, 8017, 1566721914432, 8224, 207, true
3940, 1566721914226, 8018, 1566721914433, 8225, 207, true
3941, 1566721914227, 8019, 1566721914432, 8224, 205, true
3942, 1566721914227, 8019, 1566721914433, 8225, 206, true
3943, 1566721914228, 8020, 1566721914435, 8227, 207, true
3944, 1566721914229, 8021, 1566721914435, 8227, 206, true
3945, 1566721914230, 8022, 1566721914435, 8227, 205, true
3946, 1566721914230, 8022, 1566721914435, 8227, 205, true
3947, 1566721914231, 8023, 1566721914436, 8228, 205, true
3948, 1566721914235, 8027, 1566721914438, 8230, 203, true
3949, 1566721914235, 8027, 1566721914438, 8230, 203, true
3950, 1566721914236, 8028, 1566721914442, 8234, 206, true
3951, 1566721914236, 8028, 1566721914442, 8234, 206, true
3952, 1566721914236, 8028, 1566721914439, 8231, 203, true
3953, 1566721914237, 8029, 1566721914442, 8234, 205, true
3954, 1566721914237, 8029, 1566721914441, 8233, 204, true
3955, 1566721914238, 8030, 1566721914441, 8233, 203, true
3956, 1566721914239, 8031, 1566721914446, 8238, 207, true
3957, 1566721914240, 8032, 1566721914446, 8238, 206, true
3958, 1566721914241, 8033, 1566721914447, 8239, 206, true
3959, 1566721914241, 8033, 1566721914447, 8239, 206, true
3960, 1566721914244, 8036, 1566721914451, 8243, 207, true
3961, 1566721914247, 8039, 1566721914454, 8246, 207, true
3962, 1566721914247, 8039, 1566721914454, 8246, 207, true
3963, 1566721914249, 8041, 1566721914455, 8247, 206, true
3964, 1566721914249, 8041, 1566721914455, 8247, 206, true
3965, 1566721914249, 8041, 1566721914458, 8250, 209, true
3966, 1566721914250, 8042, 1566721914459, 8251, 209, true
3967, 1566721914250, 8042, 1566721914459, 8251, 209, true
3968, 1566721914251, 8043, 1566721914459, 8251, 208, true
3969, 1566721914252, 8044, 1566721914455, 8247, 203, true
3970, 1566721914252, 8044, 1566721914459, 8251, 207, true
3971, 1566721914253, 8045, 1566721914459, 8251, 206, true
3972, 1566721914255, 8047, 1566721914459, 8251, 204, true
3973, 1566721914255, 8047, 1566721914459, 8251, 204, true
3974, 1566721914256, 8048, 1566721914460, 8252, 204, true
3975, 1566721914257, 8049, 1566721914465, 8257, 208, true
3976, 1566721914259, 8051, 1566721914465, 8257, 206, true
3977, 1566721914259, 8051, 1566721914463, 8255, 204, true
3978, 1566721914260, 8052, 1566721914465, 8257, 205, true
3979, 1566721914260, 8052, 1566721914465, 8257, 205, true
3980, 1566721914261, 8053, 1566721914469, 8261, 208, true
3981, 1566721914262, 8054, 1566721914473, 8265, 211, true
3982, 1566721914263, 8055, 1566721914470, 8262, 207, true
3983, 1566721914264, 8056, 1566721914486, 8278, 222, true
3984, 1566721914264, 8056, 1566721914490, 8282, 226, true
3985, 1566721914265, 8057, 1566721914518, 8310, 253, true
3986, 1566721914266, 8058, 1566721914516, 8308, 250, true
3987, 1566721914267, 8059, 1566721914486, 8278, 219, true
3988, 1566721914268, 8060, 1566721914516, 8308, 248, true
3989, 1566721914268, 8060, 1566721914486, 8278, 218, true
3990, 1566721914269, 8061, 1566721914515, 8307, 246, true
3991, 1566721914270, 8062, 1566721914516, 8308, 246, true
3992, 1566721914270, 8062, 1566721914486, 8278, 216, true
3993, 1566721914271, 8063, 1566721914511, 8303, 240, true
3994, 1566721914272, 8064, 1566721914511, 8303, 239, true
3995, 1566721914274, 8066, 1566721914486, 8278, 212, true
3996, 1566721914274, 8066, 1566721914486, 8278, 212, true
3997, 1566721914275, 8067, 1566721914507, 8299, 232, true
3998, 1566721914276, 8068, 1566721914486, 8278, 210, true
3999, 1566721914276, 8068, 1566721914497, 8289, 221, true
4000, 1566721914277, 8069, 1566721914486, 8278, 209, true
4001, 1566721914278, 8070, 1566721914492, 8284, 214, true
4002, 1566721914279, 8071, 1566721914497, 8289, 218, true
4003, 1566721914280, 8072, 1566721914497, 8289, 217, true
4004, 1566721914280, 8072, 1566721914492, 8284, 212, true
4005, 1566721914281, 8073, 1566721914490, 8282, 209, true
4006, 1566721914282, 8074, 1566721914491, 8283, 209, true
4007, 1566721914282, 8074, 1566721914490, 8282, 208, true
4008, 1566721914283, 8075, 1566721914490, 8282, 207, true
4009, 1566721914288, 8080, 1566721914541, 8333, 253, true
4010, 1566721914288, 8080, 1566721914540, 8332, 252, true
4011, 1566721914289, 8081, 1566721914537, 8329, 248, true
4012, 1566721914289, 8081, 1566721914536, 8328, 247, true
4013, 1566721914289, 8081, 1566721914497, 8289, 208, true
4014, 1566721914290, 8082, 1566721914497, 8289, 207, true
4015, 1566721914290, 8082, 1566721914500, 8292, 210, true
4016, 1566721914291, 8083, 1566721914500, 8292, 209, true
4017, 1566721914292, 8084, 1566721914505, 8297, 213, true
4018, 1566721914293, 8085, 1566721914532, 8324, 239, true
4019, 1566721914294, 8086, 1566721914536, 8328, 242, true
4020, 1566721914294, 8086, 1566721914526, 8318, 232, true
4021, 1566721914296, 8088, 1566721914501, 8293, 205, true
4022, 1566721914296, 8088, 1566721914528, 8320, 232, true
4023, 1566721914297, 8089, 1566721914505, 8297, 208, true
4024, 1566721914298, 8090, 1566721914526, 8318, 228, true
4025, 1566721914298, 8090, 1566721914505, 8297, 207, true
4026, 1566721914299, 8091, 1566721914525, 8317, 226, true
4027, 1566721914300, 8092, 1566721914526, 8318, 226, true
4028, 1566721914301, 8093, 1566721914507, 8299, 206, true
4029, 1566721914302, 8094, 1566721914526, 8318, 224, true
4030, 1566721914303, 8095, 1566721914526, 8318, 223, true
4031, 1566721914303, 8095, 1566721914525, 8317, 222, true
4032, 1566721914304, 8096, 1566721914519, 8311, 215, true
4033, 1566721914306, 8098, 1566721914516, 8308, 210, true
4034, 1566721914306, 8098, 1566721914519, 8311, 213, true
4035, 1566721914307, 8099, 1566721914519, 8311, 212, true
4036, 1566721914308, 8100, 1566721914516, 8308, 208, true
4037, 1566721914309, 8101, 1566721914517, 8309, 208, true
4038, 1566721914310, 8102, 1566721914518, 8310, 208, true
4039, 1566721914311, 8103, 1566721914517, 8309, 206, true
4040, 1566721914312, 8104, 1566721914550, 8342, 238, true
4041, 1566721914313, 8105, 1566721914551, 8343, 238, true
4042, 1566721914314, 8106, 1566721914519, 8311, 205, true
4043, 1566721914315, 8107, 1566721914520, 8312, 205, true
4044, 1566721914315, 8107, 1566721914550, 8342, 235, true
4045, 1566721914316, 8108, 1566721914550, 8342, 234, true
4046, 1566721914317, 8109, 1566721914551, 8343, 234, true
4047, 1566721914318, 8110, 1566721914551, 8343, 233, true
4048, 1566721914319, 8111, 1566721914550, 8342, 231, true
4049, 1566721914320, 8112, 1566721914549, 8341, 229, true
4050, 1566721914321, 8113, 1566721914551, 8343, 230, true
4051, 1566721914322, 8114, 1566721914551, 8343, 229, true
4052, 1566721914322, 8114, 1566721914532, 8324, 210, true
4053, 1566721914323, 8115, 1566721914542, 8334, 219, true
4054, 1566721914324, 8116, 1566721914532, 8324, 208, true
4055, 1566721914325, 8117, 1566721914551, 8343, 226, true
4056, 1566721914326, 8118, 1566721914533, 8325, 207, true
4057, 1566721914327, 8119, 1566721914533, 8325, 206, true
4058, 1566721914327, 8119, 1566721914550, 8342, 223, true
4059, 1566721914328, 8120, 1566721914534, 8326, 206, true
4060, 1566721914329, 8121, 1566721914550, 8342, 221, true
4061, 1566721914330, 8122, 1566721914551, 8343, 221, true
4062, 1566721914330, 8122, 1566721914551, 8343, 221, true
4063, 1566721914331, 8123, 1566721914535, 8327, 204, true
4064, 1566721914332, 8124, 1566721914536, 8328, 204, true
4065, 1566721914333, 8125, 1566721914551, 8343, 218, true
4066, 1566721914334, 8126, 1566721914542, 8334, 208, true
4067, 1566721914335, 8127, 1566721914541, 8333, 206, true
4068, 1566721914336, 8128, 1566721914541, 8333, 205, true
4069, 1566721914336, 8128, 1566721914541, 8333, 205, true
4070, 1566721914337, 8129, 1566721914550, 8342, 213, true
4071, 1566721914338, 8130, 1566721914550, 8342, 212, true
4072, 1566721914346, 8138, 1566721914551, 8343, 205, true
4073, 1566721914348, 8140, 1566721914557, 8349, 209, true
4074, 1566721914350, 8142, 1566721914558, 8350, 208, true
4075, 1566721914354, 8146, 1566721914559, 8351, 205, true
4076, 1566721914356, 8148, 1566721914562, 8354, 206, true
4077, 1566721914358, 8150, 1566721914563, 8355, 205, true
4078, 1566721914359, 8151, 1566721914563, 8355, 204, true
4079, 1566721914362, 8154, 1566721914565, 8357, 203, true
4080, 1566721914363, 8155, 1566721914569, 8361, 206, true
4081, 1566721914365, 8157, 1566721914590, 8382, 225, true
4082, 1566721914386, 8178, 1566721914592, 8384, 206, true
4083, 1566721914390, 8182, 1566721914593, 8385, 203, true
4084, 1566721914397, 8189, 1566721914603, 8395, 206, true
4085, 1566721914403, 8195, 1566721914606, 8398, 203, true
4086, 1566721914405, 8197, 1566721914613, 8405, 208, true
4087, 1566721914407, 8199, 1566721914616, 8408, 209, true
4088, 1566721914407, 8199, 1566721914616, 8408, 209, true
4089, 1566721914407, 8199, 1566721914613, 8405, 206, true
4090, 1566721914408, 8200, 1566721914615, 8407, 207, true
4091, 1566721914409, 8201, 1566721914613, 8405, 204, true
4092, 1566721914410, 8202, 1566721914617, 8409, 207, true
4093, 1566721914412, 8204, 1566721914617, 8409, 205, true
4094, 1566721914414, 8206, 1566721914617, 8409, 203, true
4095, 1566721914414, 8206, 1566721914617, 8409, 203, true
4096, 1566721914415, 8207, 1566721914621, 8413, 206, true
4097, 1566721914419, 8211, 1566721914621, 8413, 202, true
4098, 1566721914419, 8211, 1566721914621, 8413, 202, true
4099, 1566721914420, 8212, 1566721914622, 8414, 202, true
4100, 1566721914420, 8212, 1566721914622, 8414, 202, true
4101, 1566721914421, 8213, 1566721914625, 8417, 204, true
4102, 1566721914421, 8213, 1566721914628, 8420, 207, true
4103, 1566721914422, 8214, 1566721914634, 8426, 212, true
4104, 1566721914422, 8214, 1566721914631, 8423, 209, true
4105, 1566721914424, 8216, 1566721914634, 8426, 210, true
4106, 1566721914429, 8221, 1566721914634, 8426, 205, true
4107, 1566721914438, 8230, 1566721914641, 8433, 203, true
4108, 1566721914439, 8231, 1566721914646, 8438, 207, true
4109, 1566721914443, 8235, 1566721914646, 8438, 203, true
4110, 1566721914443, 8235, 1566721914651, 8443, 208, true
4111, 1566721914444, 8236, 1566721914650, 8442, 206, true
4112, 1566721914447, 8239, 1566721914651, 8443, 204, true
4113, 1566721914449, 8241, 1566721914657, 8449, 208, true
4114, 1566721914451, 8243, 1566721914659, 8451, 208, true
4115, 1566721914451, 8243, 1566721914660, 8452, 209, true
4116, 1566721914452, 8244, 1566721914659, 8451, 207, true
4117, 1566721914455, 8247, 1566721914660, 8452, 205, true
4118, 1566721914456, 8248, 1566721914661, 8453, 205, true
4119, 1566721914466, 8258, 1566721914670, 8462, 204, true
4120, 1566721914466, 8258, 1566721914670, 8462, 204, true
4121, 1566721914467, 8259, 1566721914671, 8463, 204, true
4122, 1566721914470, 8262, 1566721914675, 8467, 205, true
4123, 1566721914470, 8262, 1566721914675, 8467, 205, true
4124, 1566721914471, 8263, 1566721914675, 8467, 204, true
4125, 1566721914471, 8263, 1566721914675, 8467, 204, true
4126, 1566721914473, 8265, 1566721914676, 8468, 203, true
4127, 1566721914474, 8266, 1566721914677, 8469, 203, true
4128, 1566721914474, 8266, 1566721914680, 8472, 206, true
4129, 1566721914475, 8267, 1566721914681, 8473, 206, true
4130, 1566721914475, 8267, 1566721914679, 8471, 204, true
4131, 1566721914475, 8267, 1566721914680, 8472, 205, true
4132, 1566721914476, 8268, 1566721914681, 8473, 205, true
4133, 1566721914478, 8270, 1566721914694, 8486, 216, true
4134, 1566721914478, 8270, 1566721914692, 8484, 214, true
4135, 1566721914478, 8270, 1566721914686, 8478, 208, true
4136, 1566721914479, 8271, 1566721914686, 8478, 207, true
4137, 1566721914479, 8271, 1566721914689, 8481, 210, true
4138, 1566721914480, 8272, 1566721914692, 8484, 212, true
4139, 1566721914480, 8272, 1566721914704, 8496, 224, true
4140, 1566721914481, 8273, 1566721914698, 8490, 217, true
4141, 1566721914481, 8273, 1566721914694, 8486, 213, true
4142, 1566721914481, 8273, 1566721914695, 8487, 214, true
4143, 1566721914482, 8274, 1566721914697, 8489, 215, true
4144, 1566721914487, 8279, 1566721914697, 8489, 210, true
4145, 1566721914487, 8279, 1566721914702, 8494, 215, true
4146, 1566721914488, 8280, 1566721914698, 8490, 210, true
4147, 1566721914493, 8285, 1566721914709, 8501, 216, true
4148, 1566721914493, 8285, 1566721914709, 8501, 216, true
4149, 1566721914497, 8289, 1566721914708, 8500, 211, true
4150, 1566721914497, 8289, 1566721914708, 8500, 211, true
4151, 1566721914498, 8290, 1566721914708, 8500, 210, true
4152, 1566721914498, 8290, 1566721914708, 8500, 210, true
4153, 1566721914501, 8293, 1566721914710, 8502, 209, true
4154, 1566721914503, 8295, 1566721914709, 8501, 206, true
4155, 1566721914505, 8297, 1566721914713, 8505, 208, true
4156, 1566721914507, 8299, 1566721914714, 8506, 207, true
4157, 1566721914508, 8300, 1566721914714, 8506, 206, true
4158, 1566721914508, 8300, 1566721914713, 8505, 205, true
4159, 1566721914508, 8300, 1566721914714, 8506, 206, true
4160, 1566721914509, 8301, 1566721914716, 8508, 207, true
4161, 1566721914511, 8303, 1566721914716, 8508, 205, true
4162, 1566721914512, 8304, 1566721914717, 8509, 205, true
4163, 1566721914512, 8304, 1566721914724, 8516, 212, true
4164, 1566721914522, 8314, 1566721914728, 8520, 206, true
4165, 1566721914522, 8314, 1566721914726, 8518, 204, true
4166, 1566721914522, 8314, 1566721914733, 8525, 211, true
4167, 1566721914523, 8315, 1566721914730, 8522, 207, true
4168, 1566721914528, 8320, 1566721914733, 8525, 205, true
4169, 1566721914529, 8321, 1566721914733, 8525, 204, true
4170, 1566721914529, 8321, 1566721914734, 8526, 205, true
4171, 1566721914530, 8322, 1566721914739, 8531, 209, true
4172, 1566721914533, 8325, 1566721914739, 8531, 206, true
4173, 1566721914534, 8326, 1566721914740, 8532, 206, true
4174, 1566721914538, 8330, 1566721914746, 8538, 208, true
4175, 1566721914538, 8330, 1566721914746, 8538, 208, true
4176, 1566721914544, 8336, 1566721914758, 8550, 214, true
4177, 1566721914545, 8337, 1566721914759, 8551, 214, true
4178, 1566721914552, 8344, 1566721914766, 8558, 214, true
4179, 1566721914553, 8345, 1566721914766, 8558, 213, true
4180, 1566721914553, 8345, 1566721914761, 8553, 208, true
4181, 1566721914554, 8346, 1566721914766, 8558, 212, true
4182, 1566721914555, 8347, 1566721914766, 8558, 211, true
4183, 1566721914556, 8348, 1566721914771, 8563, 215, true
4184, 1566721914556, 8348, 1566721914771, 8563, 215, true
4185, 1566721914558, 8350, 1566721914771, 8563, 213, true
4186, 1566721914560, 8352, 1566721914771, 8563, 211, true
4187, 1566721914564, 8356, 1566721914768, 8560, 204, true
4188, 1566721914564, 8356, 1566721914770, 8562, 206, true
4189, 1566721914567, 8359, 1566721914772, 8564, 205, true
4190, 1566721914567, 8359, 1566721914771, 8563, 204, true
4191, 1566721914567, 8359, 1566721914772, 8564, 205, true
4192, 1566721914569, 8361, 1566721914772, 8564, 203, true
4193, 1566721914570, 8362, 1566721914775, 8567, 205, true
4194, 1566721914570, 8362, 1566721914775, 8567, 205, true
4195, 1566721914571, 8363, 1566721914775, 8567, 204, true
4196, 1566721914572, 8364, 1566721914775, 8567, 203, true
4197, 1566721914573, 8365, 1566721914785, 8577, 212, true
4198, 1566721914574, 8366, 1566721914785, 8577, 211, true
4199, 1566721914574, 8366, 1566721914777, 8569, 203, true
4200, 1566721914575, 8367, 1566721914785, 8577, 210, true
4201, 1566721914575, 8367, 1566721914785, 8577, 210, true
4202, 1566721914576, 8368, 1566721914785, 8577, 209, true
4203, 1566721914576, 8368, 1566721914785, 8577, 209, true
4204, 1566721914577, 8369, 1566721914783, 8575, 206, true
4205, 1566721914578, 8370, 1566721914783, 8575, 205, true
4206, 1566721914579, 8371, 1566721914787, 8579, 208, true
4207, 1566721914581, 8373, 1566721914787, 8579, 206, true
4208, 1566721914582, 8374, 1566721914787, 8579, 205, true
4209, 1566721914582, 8374, 1566721914787, 8579, 205, true
4210, 1566721914584, 8376, 1566721914800, 8592, 216, true
4211, 1566721914584, 8376, 1566721914791, 8583, 207, true
4212, 1566721914585, 8377, 1566721914788, 8580, 203, true
4213, 1566721914585, 8377, 1566721914800, 8592, 215, true
4214, 1566721914586, 8378, 1566721914800, 8592, 214, true
4215, 1566721914587, 8379, 1566721914800, 8592, 213, true
4216, 1566721914587, 8379, 1566721914797, 8589, 210, true
4217, 1566721914587, 8379, 1566721914800, 8592, 213, true
4218, 1566721914588, 8380, 1566721914800, 8592, 212, true
4219, 1566721914594, 8386, 1566721914801, 8593, 207, true
4220, 1566721914596, 8388, 1566721914801, 8593, 205, true
4221, 1566721914597, 8389, 1566721914802, 8594, 205, true
4222, 1566721914598, 8390, 1566721914802, 8594, 204, true
4223, 1566721914600, 8392, 1566721914804, 8596, 204, true
4224, 1566721914602, 8394, 1566721914809, 8601, 207, true
4225, 1566721914605, 8397, 1566721914809, 8601, 204, true
4226, 1566721914607, 8399, 1566721914814, 8606, 207, true
4227, 1566721914608, 8400, 1566721914811, 8603, 203, true
4228, 1566721914610, 8402, 1566721914816, 8608, 206, true
4229, 1566721914611, 8403, 1566721914816, 8608, 205, true
4230, 1566721914619, 8411, 1566721914859, 8651, 240, true
4231, 1566721914625, 8417, 1566721914859, 8651, 234, true
4232, 1566721914627, 8419, 1566721914859, 8651, 232, true
4233, 1566721914628, 8420, 1566721914859, 8651, 231, true
4234, 1566721914630, 8422, 1566721914859, 8651, 229, true
4235, 1566721914632, 8424, 1566721914859, 8651, 227, true
4236, 1566721914634, 8426, 1566721914859, 8651, 225, true
4237, 1566721914635, 8427, 1566721914859, 8651, 224, true
4238, 1566721914637, 8429, 1566721914859, 8651, 222, true
4239, 1566721914638, 8430, 1566721914858, 8650, 220, true
4240, 1566721914640, 8432, 1566721914857, 8649, 217, true
4241, 1566721914641, 8433, 1566721914857, 8649, 216, true
4242, 1566721914643, 8435, 1566721914856, 8648, 213, true
4243, 1566721914644, 8436, 1566721914856, 8648, 212, true
4244, 1566721914647, 8439, 1566721914861, 8653, 214, true
4245, 1566721914649, 8441, 1566721914856, 8648, 207, true
4246, 1566721914651, 8443, 1566721914862, 8654, 211, true
4247, 1566721914652, 8444, 1566721914861, 8653, 209, true
4248, 1566721914657, 8449, 1566721914862, 8654, 205, true
4249, 1566721914662, 8454, 1566721914866, 8658, 204, true
4250, 1566721914662, 8454, 1566721914866, 8658, 204, true
4251, 1566721914664, 8456, 1566721914870, 8662, 206, true
4252, 1566721914665, 8457, 1566721914871, 8663, 206, true
4253, 1566721914666, 8458, 1566721914871, 8663, 205, true
4254, 1566721914668, 8460, 1566721914874, 8666, 206, true
4255, 1566721914672, 8464, 1566721914875, 8667, 203, true
4256, 1566721914678, 8470, 1566721914884, 8676, 206, true
4257, 1566721914683, 8475, 1566721914886, 8678, 203, true
4258, 1566721914684, 8476, 1566721914887, 8679, 203, true
4259, 1566721914687, 8479, 1566721914890, 8682, 203, true
4260, 1566721914689, 8481, 1566721914892, 8684, 203, true
4261, 1566721914690, 8482, 1566721914894, 8686, 204, true
4262, 1566721914699, 8491, 1566721914901, 8693, 202, true
4263, 1566721914700, 8492, 1566721914906, 8698, 206, true
4264, 1566721914704, 8496, 1566721914907, 8699, 203, true
4265, 1566721914705, 8497, 1566721914951, 8743, 246, true
4266, 1566721914711, 8503, 1566721914950, 8742, 239, true
4267, 1566721914714, 8506, 1566721914951, 8743, 237, true
4268, 1566721914719, 8511, 1566721914951, 8743, 232, true
4269, 1566721914721, 8513, 1566721914952, 8744, 231, true
4270, 1566721914721, 8513, 1566721914952, 8744, 231, true
4271, 1566721914722, 8514, 1566721914951, 8743, 229, true
4272, 1566721914722, 8514, 1566721914951, 8743, 229, true
4273, 1566721914722, 8514, 1566721914952, 8744, 230, true
4274, 1566721914722, 8514, 1566721914951, 8743, 229, true
4275, 1566721914724, 8516, 1566721914951, 8743, 227, true
4276, 1566721914725, 8517, 1566721914951, 8743, 226, true
4277, 1566721914728, 8520, 1566721914951, 8743, 223, true
4278, 1566721914730, 8522, 1566721914952, 8744, 222, true
4279, 1566721914730, 8522, 1566721914952, 8744, 222, true
4280, 1566721914731, 8523, 1566721914952, 8744, 221, true
4281, 1566721914734, 8526, 1566721914952, 8744, 218, true
4282, 1566721914735, 8527, 1566721914952, 8744, 217, true
4283, 1566721914735, 8527, 1566721914952, 8744, 217, true
4284, 1566721914736, 8528, 1566721914952, 8744, 216, true
4285, 1566721914736, 8528, 1566721914952, 8744, 216, true
4286, 1566721914737, 8529, 1566721914952, 8744, 215, true
4287, 1566721914737, 8529, 1566721914952, 8744, 215, true
4288, 1566721914740, 8532, 1566721914952, 8744, 212, true
4289, 1566721914741, 8533, 1566721914952, 8744, 211, true
4290, 1566721914742, 8534, 1566721914952, 8744, 210, true
4291, 1566721914742, 8534, 1566721914952, 8744, 210, true
4292, 1566721914743, 8535, 1566721914953, 8745, 210, true
4293, 1566721914744, 8536, 1566721914955, 8747, 211, true
4294, 1566721914747, 8539, 1566721914954, 8746, 207, true
4295, 1566721914748, 8540, 1566721914954, 8746, 206, true
4296, 1566721914748, 8540, 1566721914954, 8746, 206, true
4297, 1566721914749, 8541, 1566721914955, 8747, 206, true
4298, 1566721914749, 8541, 1566721914973, 8765, 224, true
4299, 1566721914750, 8542, 1566721914973, 8765, 223, true
4300, 1566721914751, 8543, 1566721914970, 8762, 219, true
4301, 1566721914751, 8543, 1566721914973, 8765, 222, true
4302, 1566721914752, 8544, 1566721914973, 8765, 221, true
4303, 1566721914754, 8546, 1566721914970, 8762, 216, true
4304, 1566721914754, 8546, 1566721914973, 8765, 219, true
4305, 1566721914755, 8547, 1566721914970, 8762, 215, true
4306, 1566721914756, 8548, 1566721914970, 8762, 214, true
4307, 1566721914757, 8549, 1566721914970, 8762, 213, true
4308, 1566721914760, 8552, 1566721914973, 8765, 213, true
4309, 1566721914761, 8553, 1566721914969, 8761, 208, true
4310, 1566721914763, 8555, 1566721914967, 8759, 204, true
4311, 1566721914764, 8556, 1566721914967, 8759, 203, true
4312, 1566721914766, 8558, 1566721914973, 8765, 207, true
4313, 1566721914767, 8559, 1566721914973, 8765, 206, true
4314, 1566721914768, 8560, 1566721914973, 8765, 205, true
4315, 1566721914777, 8569, 1566721914979, 8771, 202, true
4316, 1566721914777, 8569, 1566721914980, 8772, 203, true
4317, 1566721914778, 8570, 1566721914985, 8777, 207, true
4318, 1566721914779, 8571, 1566721914985, 8777, 206, true
4319, 1566721914779, 8571, 1566721914985, 8777, 206, true
4320, 1566721914779, 8571, 1566721914985, 8777, 206, true
4321, 1566721914780, 8572, 1566721914985, 8777, 205, true
4322, 1566721914781, 8573, 1566721914985, 8777, 204, true
4323, 1566721914788, 8580, 1566721915002, 8794, 214, true
4324, 1566721914789, 8581, 1566721914999, 8791, 210, true
4325, 1566721914790, 8582, 1566721914999, 8791, 209, true
4326, 1566721914791, 8583, 1566721915003, 8795, 212, true
4327, 1566721914791, 8583, 1566721915003, 8795, 212, true
4328, 1566721914791, 8583, 1566721915003, 8795, 212, true
4329, 1566721914792, 8584, 1566721915003, 8795, 211, true
4330, 1566721914792, 8584, 1566721915003, 8795, 211, true
4331, 1566721914793, 8585, 1566721915003, 8795, 210, true
4332, 1566721914793, 8585, 1566721915003, 8795, 210, true
4333, 1566721914795, 8587, 1566721915003, 8795, 208, true
4334, 1566721914795, 8587, 1566721915003, 8795, 208, true
4335, 1566721914796, 8588, 1566721915005, 8797, 209, true
4336, 1566721914803, 8595, 1566721915006, 8798, 203, true
4337, 1566721914803, 8595, 1566721915006, 8798, 203, true
4338, 1566721914804, 8596, 1566721915011, 8803, 207, true
4339, 1566721914804, 8596, 1566721915007, 8799, 203, true
4340, 1566721914805, 8597, 1566721915008, 8800, 203, true
4341, 1566721914806, 8598, 1566721915008, 8800, 202, true
4342, 1566721914806, 8598, 1566721915014, 8806, 208, true
4343, 1566721914808, 8600, 1566721915014, 8806, 206, true
4344, 1566721914810, 8602, 1566721915014, 8806, 204, true
4345, 1566721914810, 8602, 1566721915015, 8807, 205, true
4346, 1566721914811, 8603, 1566721915015, 8807, 204, true
4347, 1566721914812, 8604, 1566721915015, 8807, 203, true
4348, 1566721914814, 8606, 1566721915018, 8810, 204, true
4349, 1566721914814, 8606, 1566721915025, 8817, 211, true
4350, 1566721914816, 8608, 1566721915025, 8817, 209, true
4351, 1566721914816, 8608, 1566721915025, 8817, 209, true
4352, 1566721914817, 8609, 1566721915025, 8817, 208, true
4353, 1566721914818, 8610, 1566721915025, 8817, 207, true
4354, 1566721914819, 8611, 1566721915025, 8817, 206, true
4355, 1566721914820, 8612, 1566721915065, 8857, 245, true
4356, 1566721914855, 8647, 1566721915065, 8857, 210, true
4357, 1566721914869, 8661, 1566721915073, 8865, 204, true
4358, 1566721914872, 8664, 1566721915076, 8868, 204, true
4359, 1566721914875, 8667, 1566721915080, 8872, 205, true
4360, 1566721914875, 8667, 1566721915080, 8872, 205, true
4361, 1566721914876, 8668, 1566721915079, 8871, 203, true
4362, 1566721914876, 8668, 1566721915080, 8872, 204, true
4363, 1566721914877, 8669, 1566721915084, 8876, 207, true
4364, 1566721914878, 8670, 1566721915084, 8876, 206, true
4365, 1566721914878, 8670, 1566721915081, 8873, 203, true
4366, 1566721914879, 8671, 1566721915084, 8876, 205, true
4367, 1566721914880, 8672, 1566721915084, 8876, 204, true
4368, 1566721914881, 8673, 1566721915086, 8878, 205, true
4369, 1566721914882, 8674, 1566721915086, 8878, 204, true
4370, 1566721914883, 8675, 1566721915087, 8879, 204, true
4371, 1566721914884, 8676, 1566721915087, 8879, 203, true
4372, 1566721914886, 8678, 1566721915091, 8883, 205, true
4373, 1566721914886, 8678, 1566721915090, 8882, 204, true
4374, 1566721914886, 8678, 1566721915091, 8883, 205, true
4375, 1566721914888, 8680, 1566721915094, 8886, 206, true
4376, 1566721914889, 8681, 1566721915098, 8890, 209, true
4377, 1566721914889, 8681, 1566721915101, 8893, 212, true
4378, 1566721914891, 8683, 1566721915101, 8893, 210, true
4379, 1566721914892, 8684, 1566721915095, 8887, 203, true
4380, 1566721914894, 8686, 1566721915101, 8893, 207, true
4381, 1566721914894, 8686, 1566721915101, 8893, 207, true
4382, 1566721914895, 8687, 1566721915101, 8893, 206, true
4383, 1566721914895, 8687, 1566721915101, 8893, 206, true
4384, 1566721914897, 8689, 1566721915103, 8895, 206, true
4385, 1566721914898, 8690, 1566721915103, 8895, 205, true
4386, 1566721914898, 8690, 1566721915103, 8895, 205, true
4387, 1566721914899, 8691, 1566721915103, 8895, 204, true
4388, 1566721914900, 8692, 1566721915106, 8898, 206, true
4389, 1566721914902, 8694, 1566721915107, 8899, 205, true
4390, 1566721914902, 8694, 1566721915108, 8900, 206, true
4391, 1566721914902, 8694, 1566721915107, 8899, 205, true
4392, 1566721914904, 8696, 1566721915212, 9004, 308, true
4393, 1566721914905, 8697, 1566721915178, 8970, 273, true
4394, 1566721914906, 8698, 1566721915164, 8956, 258, true
4395, 1566721914906, 8698, 1566721915195, 8987, 289, true
4396, 1566721914907, 8699, 1566721915204, 8996, 297, true
4397, 1566721914907, 8699, 1566721915196, 8988, 289, true
4398, 1566721914907, 8699, 1566721915165, 8957, 258, true
4399, 1566721914908, 8700, 1566721915216, 9008, 308, true
4400, 1566721914908, 8700, 1566721915181, 8973, 273, true
4401, 1566721914909, 8701, 1566721915178, 8970, 269, true
4402, 1566721914909, 8701, 1566721915166, 8958, 257, true
4403, 1566721914909, 8701, 1566721915216, 9008, 307, true
4404, 1566721914909, 8701, 1566721915200, 8992, 291, true
4405, 1566721914910, 8702, 1566721915212, 9004, 302, true
4406, 1566721914910, 8702, 1566721915196, 8988, 286, true
4407, 1566721914910, 8702, 1566721915185, 8977, 275, true
4408, 1566721914910, 8702, 1566721915215, 9007, 305, true
4409, 1566721914911, 8703, 1566721915170, 8962, 259, true
4410, 1566721914911, 8703, 1566721915211, 9003, 300, true
4411, 1566721914911, 8703, 1566721915174, 8966, 263, true
4412, 1566721914912, 8704, 1566721915165, 8957, 253, true
4413, 1566721914912, 8704, 1566721915216, 9008, 304, true
4414, 1566721914913, 8705, 1566721915174, 8966, 261, true
4415, 1566721914913, 8705, 1566721915196, 8988, 283, true
4416, 1566721914913, 8705, 1566721915208, 9000, 295, true
4417, 1566721914914, 8706, 1566721915195, 8987, 281, true
4418, 1566721914914, 8706, 1566721915174, 8966, 260, true
4419, 1566721914915, 8707, 1566721915170, 8962, 255, true
4420, 1566721914915, 8707, 1566721915174, 8966, 259, true
4421, 1566721914915, 8707, 1566721915196, 8988, 281, true
4422, 1566721914915, 8707, 1566721915164, 8956, 249, true
4423, 1566721914916, 8708, 1566721915197, 8989, 281, true
4424, 1566721914916, 8708, 1566721915181, 8973, 265, true
4425, 1566721914917, 8709, 1566721915212, 9004, 295, true
4426, 1566721914917, 8709, 1566721915181, 8973, 264, true
4427, 1566721914917, 8709, 1566721915197, 8989, 280, true
4428, 1566721914917, 8709, 1566721915196, 8988, 279, true
4429, 1566721914917, 8709, 1566721915196, 8988, 279, true
4430, 1566721914917, 8709, 1566721915167, 8959, 250, true
4431, 1566721914918, 8710, 1566721915197, 8989, 279, true
4432, 1566721914918, 8710, 1566721915216, 9008, 298, true
4433, 1566721914918, 8710, 1566721915208, 9000, 290, true
4434, 1566721914918, 8710, 1566721915197, 8989, 279, true
4435, 1566721914918, 8710, 1566721915187, 8979, 269, true
4436, 1566721914918, 8710, 1566721915196, 8988, 278, true
4437, 1566721914918, 8710, 1566721915167, 8959, 249, true
4438, 1566721914918, 8710, 1566721915196, 8988, 278, true
4439, 1566721914918, 8710, 1566721915182, 8974, 264, true
4440, 1566721914918, 8710, 1566721915212, 9004, 294, true
4441, 1566721914919, 8711, 1566721915200, 8992, 281, true
4442, 1566721914919, 8711, 1566721915196, 8988, 277, true
4443, 1566721914919, 8711, 1566721915196, 8988, 277, true
4444, 1566721914919, 8711, 1566721915211, 9003, 292, true
4445, 1566721914919, 8711, 1566721915216, 9008, 297, true
4446, 1566721914919, 8711, 1566721915164, 8956, 245, true
4447, 1566721914919, 8711, 1566721915200, 8992, 281, true
4448, 1566721914919, 8711, 1566721915181, 8973, 262, true
4449, 1566721914919, 8711, 1566721915187, 8979, 268, true
4450, 1566721914919, 8711, 1566721915197, 8989, 278, true
4451, 1566721914919, 8711, 1566721915200, 8992, 281, true
4452, 1566721914920, 8712, 1566721915187, 8979, 267, true
4453, 1566721914920, 8712, 1566721915212, 9004, 292, true
4454, 1566721914920, 8712, 1566721915170, 8962, 250, true
4455, 1566721914920, 8712, 1566721915212, 9004, 292, true
4456, 1566721914920, 8712, 1566721915212, 9004, 292, true
4457, 1566721914920, 8712, 1566721915170, 8962, 250, true
4458, 1566721914920, 8712, 1566721915170, 8962, 250, true
4459, 1566721914920, 8712, 1566721915185, 8977, 265, true
4460, 1566721914920, 8712, 1566721915170, 8962, 250, true
4461, 1566721914920, 8712, 1566721915187, 8979, 267, true
4462, 1566721914920, 8712, 1566721915212, 9004, 292, true
4463, 1566721914921, 8713, 1566721915195, 8987, 274, true
4464, 1566721914921, 8713, 1566721915187, 8979, 266, true
4465, 1566721914921, 8713, 1566721915170, 8962, 249, true
4466, 1566721914921, 8713, 1566721915212, 9004, 291, true
4467, 1566721914921, 8713, 1566721915170, 8962, 249, true
4468, 1566721914921, 8713, 1566721915199, 8991, 278, true
4469, 1566721914921, 8713, 1566721915195, 8987, 274, true
4470, 1566721914921, 8713, 1566721915216, 9008, 295, true
4471, 1566721914921, 8713, 1566721915200, 8992, 279, true
4472, 1566721914921, 8713, 1566721915185, 8977, 264, true
4473, 1566721914921, 8713, 1566721915163, 8955, 242, true
4474, 1566721914922, 8714, 1566721915181, 8973, 259, true
4475, 1566721914922, 8714, 1566721915181, 8973, 259, true
4476, 1566721914922, 8714, 1566721915200, 8992, 278, true
4477, 1566721914922, 8714, 1566721915200, 8992, 278, true
4478, 1566721914922, 8714, 1566721915163, 8955, 241, true
4479, 1566721914922, 8714, 1566721915187, 8979, 265, true
4480, 1566721914922, 8714, 1566721915196, 8988, 274, true
4481, 1566721914922, 8714, 1566721915178, 8970, 256, true
4482, 1566721914922, 8714, 1566721915185, 8977, 263, true
4483, 1566721914922, 8714, 1566721915181, 8973, 259, true
4484, 1566721914929, 8721, 1566721915196, 8988, 267, true
4485, 1566721914938, 8730, 1566721915188, 8980, 250, true
4486, 1566721914939, 8731, 1566721915201, 8993, 262, true
4487, 1566721914940, 8732, 1566721915170, 8962, 230, true
4488, 1566721914942, 8734, 1566721915216, 9008, 274, true
4489, 1566721914943, 8735, 1566721915172, 8964, 229, true
4490, 1566721914944, 8736, 1566721915206, 8998, 262, true
4491, 1566721914945, 8737, 1566721915212, 9004, 267, true
4492, 1566721914957, 8749, 1566721915208, 9000, 251, true
4493, 1566721914959, 8751, 1566721915200, 8992, 241, true
4494, 1566721914959, 8751, 1566721915203, 8995, 244, true
4495, 1566721914965, 8757, 1566721915204, 8996, 239, true
4496, 1566721914988, 8780, 1566721915206, 8998, 218, true
4497, 1566721915017, 8809, 1566721915219, 9011, 202, true
4498, 1566721915018, 8810, 1566721915221, 9013, 203, true
4499, 1566721915018, 8810, 1566721915221, 9013, 203, true
4500, 1566721915019, 8811, 1566721915224, 9016, 205, true
4501, 1566721915020, 8812, 1566721915224, 9016, 204, true
4502, 1566721915020, 8812, 1566721915224, 9016, 204, true
4503, 1566721915021, 8813, 1566721915224, 9016, 203, true
4504, 1566721915021, 8813, 1566721915224, 9016, 203, true
4505, 1566721915022, 8814, 1566721915228, 9020, 206, true
4506, 1566721915027, 8819, 1566721915230, 9022, 203, true
4507, 1566721915028, 8820, 1566721915235, 9027, 207, true
4508, 1566721915028, 8820, 1566721915235, 9027, 207, true
4509, 1566721915029, 8821, 1566721915235, 9027, 206, true
4510, 1566721915030, 8822, 1566721915239, 9031, 209, true
4511, 1566721915030, 8822, 1566721915236, 9028, 206, true
4512, 1566721915031, 8823, 1566721915239, 9031, 208, true
4513, 1566721915032, 8824, 1566721915239, 9031, 207, true
4514, 1566721915033, 8825, 1566721915239, 9031, 206, true
4515, 1566721915034, 8826, 1566721915239, 9031, 205, true
4516, 1566721915035, 8827, 1566721915239, 9031, 204, true
4517, 1566721915036, 8828, 1566721915239, 9031, 203, true
4518, 1566721915037, 8829, 1566721915243, 9035, 206, true
4519, 1566721915037, 8829, 1566721915243, 9035, 206, true
4520, 1566721915037, 8829, 1566721915245, 9037, 208, true
4521, 1566721915038, 8830, 1566721915243, 9035, 205, true
4522, 1566721915038, 8830, 1566721915246, 9038, 208, true
4523, 1566721915039, 8831, 1566721915246, 9038, 207, true
4524, 1566721915040, 8832, 1566721915246, 9038, 206, true
4525, 1566721915042, 8834, 1566721915246, 9038, 204, true
4526, 1566721915042, 8834, 1566721915248, 9040, 206, true
4527, 1566721915043, 8835, 1566721915248, 9040, 205, true
4528, 1566721915043, 8835, 1566721915248, 9040, 205, true
4529, 1566721915044, 8836, 1566721915249, 9041, 205, true
4530, 1566721915044, 8836, 1566721915251, 9043, 207, true
4531, 1566721915045, 8837, 1566721915259, 9051, 214, true
4532, 1566721915046, 8838, 1566721915254, 9046, 208, true
4533, 1566721915047, 8839, 1566721915259, 9051, 212, true
4534, 1566721915048, 8840, 1566721915255, 9047, 207, true
4535, 1566721915049, 8841, 1566721915254, 9046, 205, true
4536, 1566721915050, 8842, 1566721915259, 9051, 209, true
4537, 1566721915051, 8843, 1566721915258, 9050, 207, true
4538, 1566721915053, 8845, 1566721915257, 9049, 204, true
4539, 1566721915053, 8845, 1566721915262, 9054, 209, true
4540, 1566721915054, 8846, 1566721915262, 9054, 208, true
4541, 1566721915054, 8846, 1566721915262, 9054, 208, true
4542, 1566721915056, 8848, 1566721915265, 9057, 209, true
4543, 1566721915057, 8849, 1566721915265, 9057, 208, true
4544, 1566721915058, 8850, 1566721915265, 9057, 207, true
4545, 1566721915059, 8851, 1566721915265, 9057, 206, true
4546, 1566721915059, 8851, 1566721915265, 9057, 206, true
4547, 1566721915060, 8852, 1566721915266, 9058, 206, true
4548, 1566721915061, 8853, 1566721915276, 9068, 215, true
4549, 1566721915062, 8854, 1566721915277, 9069, 215, true
4550, 1566721915063, 8855, 1566721915277, 9069, 214, true
4551, 1566721915066, 8858, 1566721915277, 9069, 211, true
4552, 1566721915067, 8859, 1566721915277, 9069, 210, true
4553, 1566721915067, 8859, 1566721915280, 9072, 213, true
4554, 1566721915068, 8860, 1566721915280, 9072, 212, true
4555, 1566721915069, 8861, 1566721915277, 9069, 208, true
4556, 1566721915070, 8862, 1566721915280, 9072, 210, true
4557, 1566721915071, 8863, 1566721915280, 9072, 209, true
4558, 1566721915073, 8865, 1566721915280, 9072, 207, true
4559, 1566721915073, 8865, 1566721915277, 9069, 204, true
4560, 1566721915074, 8866, 1566721915282, 9074, 208, true
4561, 1566721915075, 8867, 1566721915282, 9074, 207, true
4562, 1566721915076, 8868, 1566721915280, 9072, 204, true
4563, 1566721915077, 8869, 1566721915284, 9076, 207, true
4564, 1566721915081, 8873, 1566721915284, 9076, 203, true
4565, 1566721915082, 8874, 1566721915289, 9081, 207, true
4566, 1566721915082, 8874, 1566721915288, 9080, 206, true
4567, 1566721915088, 8880, 1566721915294, 9086, 206, true
4568, 1566721915088, 8880, 1566721915292, 9084, 204, true
4569, 1566721915091, 8883, 1566721915300, 9092, 209, true
4570, 1566721915092, 8884, 1566721915300, 9092, 208, true
4571, 1566721915092, 8884, 1566721915300, 9092, 208, true
4572, 1566721915092, 8884, 1566721915300, 9092, 208, true
4573, 1566721915096, 8888, 1566721915301, 9093, 205, true
4574, 1566721915104, 8896, 1566721915310, 9102, 206, true
4575, 1566721915110, 8902, 1566721915349, 9141, 239, true
4576, 1566721915110, 8902, 1566721915349, 9141, 239, true
4577, 1566721915110, 8902, 1566721915349, 9141, 239, true
4578, 1566721915110, 8902, 1566721915349, 9141, 239, true
4579, 1566721915111, 8903, 1566721915349, 9141, 238, true
4580, 1566721915111, 8903, 1566721915349, 9141, 238, true
4581, 1566721915114, 8906, 1566721915349, 9141, 235, true
4582, 1566721915116, 8908, 1566721915349, 9141, 233, true
4583, 1566721915117, 8909, 1566721915349, 9141, 232, true
4584, 1566721915119, 8911, 1566721915349, 9141, 230, true
4585, 1566721915120, 8912, 1566721915350, 9142, 230, true
4586, 1566721915122, 8914, 1566721915350, 9142, 228, true
4587, 1566721915123, 8915, 1566721915350, 9142, 227, true
4588, 1566721915125, 8917, 1566721915350, 9142, 225, true
4589, 1566721915127, 8919, 1566721915350, 9142, 223, true
4590, 1566721915131, 8923, 1566721915350, 9142, 219, true
4591, 1566721915131, 8923, 1566721915350, 9142, 219, true
4592, 1566721915131, 8923, 1566721915350, 9142, 219, true
4593, 1566721915132, 8924, 1566721915350, 9142, 218, true
4594, 1566721915132, 8924, 1566721915350, 9142, 218, true
4595, 1566721915133, 8925, 1566721915350, 9142, 217, true
4596, 1566721915134, 8926, 1566721915350, 9142, 216, true
4597, 1566721915135, 8927, 1566721915350, 9142, 215, true
4598, 1566721915138, 8930, 1566721915351, 9143, 213, true
4599, 1566721915138, 8930, 1566721915350, 9142, 212, true
4600, 1566721915139, 8931, 1566721915350, 9142, 211, true
4601, 1566721915139, 8931, 1566721915352, 9144, 213, true
4602, 1566721915140, 8932, 1566721915351, 9143, 211, true
4603, 1566721915140, 8932, 1566721915351, 9143, 211, true
4604, 1566721915140, 8932, 1566721915351, 9143, 211, true
4605, 1566721915141, 8933, 1566721915351, 9143, 210, true
4606, 1566721915144, 8936, 1566721915352, 9144, 208, true
4607, 1566721915145, 8937, 1566721915351, 9143, 206, true
4608, 1566721915145, 8937, 1566721915352, 9144, 207, true
4609, 1566721915146, 8938, 1566721915352, 9144, 206, true
4610, 1566721915148, 8940, 1566721915353, 9145, 205, true
4611, 1566721915148, 8940, 1566721915358, 9150, 210, true
4612, 1566721915149, 8941, 1566721915355, 9147, 206, true
4613, 1566721915152, 8944, 1566721915358, 9150, 206, true
4614, 1566721915153, 8945, 1566721915358, 9150, 205, true
4615, 1566721915154, 8946, 1566721915359, 9151, 205, true
4616, 1566721915155, 8947, 1566721915362, 9154, 207, true
4617, 1566721915156, 8948, 1566721915362, 9154, 206, true
4618, 1566721915157, 8949, 1566721915367, 9159, 210, true
4619, 1566721915159, 8951, 1566721915366, 9158, 207, true
4620, 1566721915160, 8952, 1566721915367, 9159, 207, true
4621, 1566721915161, 8953, 1566721915372, 9164, 211, true
4622, 1566721915171, 8963, 1566721915384, 9176, 213, true
4623, 1566721915171, 8963, 1566721915384, 9176, 213, true
4624, 1566721915172, 8964, 1566721915381, 9173, 209, true
4625, 1566721915175, 8967, 1566721915386, 9178, 211, true
4626, 1566721915176, 8968, 1566721915400, 9192, 224, true
4627, 1566721915182, 8974, 1566721915422, 9214, 240, true
4628, 1566721915183, 8975, 1566721915427, 9219, 244, true
4629, 1566721915206, 8998, 1566721915460, 9252, 254, true
4630, 1566721915219, 9011, 1566721915468, 9260, 249, true
4631, 1566721915225, 9017, 1566721915454, 9246, 229, true
4632, 1566721915225, 9017, 1566721915438, 9230, 213, true
4633, 1566721915226, 9018, 1566721915444, 9236, 218, true
4634, 1566721915226, 9018, 1566721915451, 9243, 225, true
4635, 1566721915227, 9019, 1566721915451, 9243, 224, true
4636, 1566721915227, 9019, 1566721915475, 9267, 248, true
4637, 1566721915228, 9020, 1566721915476, 9268, 248, true
4638, 1566721915228, 9020, 1566721915481, 9273, 253, true
4639, 1566721915229, 9021, 1566721915477, 9269, 248, true
4640, 1566721915229, 9021, 1566721915474, 9266, 245, true
4641, 1566721915229, 9021, 1566721915481, 9273, 252, true
4642, 1566721915231, 9023, 1566721915475, 9267, 244, true
4643, 1566721915232, 9024, 1566721915485, 9277, 253, true
4644, 1566721915232, 9024, 1566721915485, 9277, 253, true
4645, 1566721915232, 9024, 1566721915476, 9268, 244, true
4646, 1566721915233, 9025, 1566721915481, 9273, 248, true
4647, 1566721915236, 9028, 1566721915473, 9265, 237, true
4648, 1566721915247, 9039, 1566721915481, 9273, 234, true
4649, 1566721915249, 9041, 1566721915473, 9265, 224, true
4650, 1566721915252, 9044, 1566721915476, 9268, 224, true
4651, 1566721915253, 9045, 1566721915485, 9277, 232, true
4652, 1566721915255, 9047, 1566721915481, 9273, 226, true
4653, 1566721915256, 9048, 1566721915480, 9272, 224, true
4654, 1566721915256, 9048, 1566721915477, 9269, 221, true
4655, 1566721915259, 9051, 1566721915473, 9265, 214, true
4656, 1566721915260, 9052, 1566721915485, 9277, 225, true
4657, 1566721915260, 9052, 1566721915480, 9272, 220, true
4658, 1566721915260, 9052, 1566721915480, 9272, 220, true
4659, 1566721915261, 9053, 1566721915480, 9272, 219, true
4660, 1566721915261, 9053, 1566721915481, 9273, 220, true
4661, 1566721915266, 9058, 1566721915480, 9272, 214, true
4662, 1566721915267, 9059, 1566721915490, 9282, 223, true
4663, 1566721915270, 9062, 1566721915487, 9279, 217, true
4664, 1566721915279, 9071, 1566721915653, 9445, 374, true
4665, 1566721915282, 9074, 1566721915653, 9445, 371, true
4666, 1566721915284, 9076, 1566721915654, 9446, 370, true
4667, 1566721915284, 9076, 1566721915654, 9446, 370, true
4668, 1566721915284, 9076, 1566721915653, 9445, 369, true
4669, 1566721915284, 9076, 1566721915653, 9445, 369, true
4670, 1566721915284, 9076, 1566721915654, 9446, 370, true
4671, 1566721915285, 9077, 1566721915654, 9446, 369, true
4672, 1566721915285, 9077, 1566721915654, 9446, 369, true
4673, 1566721915286, 9078, 1566721915653, 9445, 367, true
4674, 1566721915288, 9080, 1566721915655, 9447, 367, true
4675, 1566721915289, 9081, 1566721915655, 9447, 366, true
4676, 1566721915290, 9082, 1566721915655, 9447, 365, true
4677, 1566721915290, 9082, 1566721915654, 9446, 364, true
4678, 1566721915291, 9083, 1566721915655, 9447, 364, true
4679, 1566721915292, 9084, 1566721915655, 9447, 363, true
4680, 1566721915292, 9084, 1566721915655, 9447, 363, true
4681, 1566721915293, 9085, 1566721915655, 9447, 362, true
4682, 1566721915294, 9086, 1566721915655, 9447, 361, true
4683, 1566721915295, 9087, 1566721915655, 9447, 360, true
4684, 1566721915297, 9089, 1566721915655, 9447, 358, true
4685, 1566721915298, 9090, 1566721915655, 9447, 357, true
4686, 1566721915301, 9093, 1566721915655, 9447, 354, true
4687, 1566721915301, 9093, 1566721915655, 9447, 354, true
4688, 1566721915302, 9094, 1566721915654, 9446, 352, true
4689, 1566721915302, 9094, 1566721915654, 9446, 352, true
4690, 1566721915303, 9095, 1566721915654, 9446, 351, true
4691, 1566721915303, 9095, 1566721915656, 9448, 353, true
4692, 1566721915304, 9096, 1566721915658, 9450, 354, true
4693, 1566721915304, 9096, 1566721915658, 9450, 354, true
4694, 1566721915305, 9097, 1566721915660, 9452, 355, true
4695, 1566721915305, 9097, 1566721915656, 9448, 351, true
4696, 1566721915305, 9097, 1566721915657, 9449, 352, true
4697, 1566721915306, 9098, 1566721915658, 9450, 352, true
4698, 1566721915306, 9098, 1566721915660, 9452, 354, true
4699, 1566721915306, 9098, 1566721915658, 9450, 352, true
4700, 1566721915307, 9099, 1566721915659, 9451, 352, true
4701, 1566721915307, 9099, 1566721915658, 9450, 351, true
4702, 1566721915308, 9100, 1566721915656, 9448, 348, true
4703, 1566721915309, 9101, 1566721915656, 9448, 347, true
4704, 1566721915309, 9101, 1566721915656, 9448, 347, true
4705, 1566721915310, 9102, 1566721915660, 9452, 350, true
4706, 1566721915311, 9103, 1566721915656, 9448, 345, true
4707, 1566721915311, 9103, 1566721915656, 9448, 345, true
4708, 1566721915311, 9103, 1566721915660, 9452, 349, true
4709, 1566721915312, 9104, 1566721915658, 9450, 346, true
4710, 1566721915312, 9104, 1566721915659, 9451, 347, true
4711, 1566721915312, 9104, 1566721915657, 9449, 345, true
4712, 1566721915314, 9106, 1566721915659, 9451, 345, true
4713, 1566721915314, 9106, 1566721915656, 9448, 342, true
4714, 1566721915315, 9107, 1566721915658, 9450, 343, true
4715, 1566721915315, 9107, 1566721915656, 9448, 341, true
4716, 1566721915315, 9107, 1566721915656, 9448, 341, true
4717, 1566721915316, 9108, 1566721915658, 9450, 342, true
4718, 1566721915316, 9108, 1566721915660, 9452, 344, true
4719, 1566721915317, 9109, 1566721915661, 9453, 344, true
4720, 1566721915317, 9109, 1566721915657, 9449, 340, true
4721, 1566721915317, 9109, 1566721915658, 9450, 341, true
4722, 1566721915317, 9109, 1566721915657, 9449, 340, true
4723, 1566721915318, 9110, 1566721915660, 9452, 342, true
4724, 1566721915318, 9110, 1566721915658, 9450, 340, true
4725, 1566721915318, 9110, 1566721915659, 9451, 341, true
4726, 1566721915319, 9111, 1566721915660, 9452, 341, true
4727, 1566721915319, 9111, 1566721915658, 9450, 339, true
4728, 1566721915319, 9111, 1566721915657, 9449, 338, true
4729, 1566721915320, 9112, 1566721915657, 9449, 337, true
4730, 1566721915320, 9112, 1566721915659, 9451, 339, true
4731, 1566721915320, 9112, 1566721915656, 9448, 336, true
4732, 1566721915321, 9113, 1566721915656, 9448, 335, true
4733, 1566721915321, 9113, 1566721915660, 9452, 339, true
4734, 1566721915322, 9114, 1566721915657, 9449, 335, true
4735, 1566721915322, 9114, 1566721915657, 9449, 335, true
4736, 1566721915322, 9114, 1566721915661, 9453, 339, true
4737, 1566721915323, 9115, 1566721915659, 9451, 336, true
4738, 1566721915323, 9115, 1566721915661, 9453, 338, true
4739, 1566721915323, 9115, 1566721915657, 9449, 334, true
4740, 1566721915324, 9116, 1566721915658, 9450, 334, true
4741, 1566721915325, 9117, 1566721915659, 9451, 334, true
4742, 1566721915325, 9117, 1566721915657, 9449, 332, true
4743, 1566721915325, 9117, 1566721915659, 9451, 334, true
4744, 1566721915325, 9117, 1566721915656, 9448, 331, true
4745, 1566721915326, 9118, 1566721915658, 9450, 332, true
4746, 1566721915326, 9118, 1566721915661, 9453, 335, true
4747, 1566721915326, 9118, 1566721915657, 9449, 331, true
4748, 1566721915327, 9119, 1566721915660, 9452, 333, true
4749, 1566721915327, 9119, 1566721915656, 9448, 329, true
4750, 1566721915327, 9119, 1566721915659, 9451, 332, true
4751, 1566721915328, 9120, 1566721915657, 9449, 329, true
4752, 1566721915328, 9120, 1566721915659, 9451, 331, true
4753, 1566721915328, 9120, 1566721915660, 9452, 332, true
4754, 1566721915329, 9121, 1566721915659, 9451, 330, true
4755, 1566721915329, 9121, 1566721915657, 9449, 328, true
4756, 1566721915329, 9121, 1566721915656, 9448, 327, true
4757, 1566721915330, 9122, 1566721915658, 9450, 328, true
4758, 1566721915330, 9122, 1566721915658, 9450, 328, true
4759, 1566721915330, 9122, 1566721915662, 9454, 332, true
4760, 1566721915331, 9123, 1566721915657, 9449, 326, true
4761, 1566721915331, 9123, 1566721915657, 9449, 326, true
4762, 1566721915331, 9123, 1566721915660, 9452, 329, true
4763, 1566721915331, 9123, 1566721915658, 9450, 327, true
4764, 1566721915332, 9124, 1566721915660, 9452, 328, true
4765, 1566721915332, 9124, 1566721915659, 9451, 327, true
4766, 1566721915332, 9124, 1566721915656, 9448, 324, true
4767, 1566721915333, 9125, 1566721915659, 9451, 326, true
4768, 1566721915333, 9125, 1566721915659, 9451, 326, true
4769, 1566721915334, 9126, 1566721915656, 9448, 322, true
4770, 1566721915334, 9126, 1566721915659, 9451, 325, true
4771, 1566721915334, 9126, 1566721915660, 9452, 326, true
4772, 1566721915334, 9126, 1566721915657, 9449, 323, true
4773, 1566721915335, 9127, 1566721915658, 9450, 323, true
4774, 1566721915336, 9128, 1566721915659, 9451, 323, true
4775, 1566721915336, 9128, 1566721915659, 9451, 323, true
4776, 1566721915337, 9129, 1566721915657, 9449, 320, true
4777, 1566721915338, 9130, 1566721915659, 9451, 321, true
4778, 1566721915339, 9131, 1566721915661, 9453, 322, true
4779, 1566721915395, 9187, 1566721915661, 9453, 266, true
4780, 1566721915397, 9189, 1566721915661, 9453, 264, true
4781, 1566721915399, 9191, 1566721915660, 9452, 261, true
4782, 1566721915400, 9192, 1566721915660, 9452, 260, true
4783, 1566721915401, 9193, 1566721915660, 9452, 259, true
4784, 1566721915402, 9194, 1566721915661, 9453, 259, true
4785, 1566721915404, 9196, 1566721915660, 9452, 256, true
4786, 1566721915405, 9197, 1566721915660, 9452, 255, true
4787, 1566721915407, 9199, 1566721915665, 9457, 258, true
4788, 1566721915409, 9201, 1566721915661, 9453, 252, true
4789, 1566721915411, 9203, 1566721915661, 9453, 250, true
4790, 1566721915412, 9204, 1566721915661, 9453, 249, true
4791, 1566721915414, 9206, 1566721915662, 9454, 248, true
4792, 1566721915419, 9211, 1566721915661, 9453, 242, true
4793, 1566721915420, 9212, 1566721915661, 9453, 241, true
4794, 1566721915420, 9212, 1566721915663, 9455, 243, true
4795, 1566721915420, 9212, 1566721915661, 9453, 241, true
4796, 1566721915421, 9213, 1566721915661, 9453, 240, true
4797, 1566721915422, 9214, 1566721915663, 9455, 241, true
4798, 1566721915423, 9215, 1566721915663, 9455, 240, true
4799, 1566721915424, 9216, 1566721915665, 9457, 241, true
4800, 1566721915425, 9217, 1566721915663, 9455, 238, true
4801, 1566721915426, 9218, 1566721915661, 9453, 235, true
4802, 1566721915428, 9220, 1566721915665, 9457, 237, true
4803, 1566721915430, 9222, 1566721915666, 9458, 236, true
4804, 1566721915431, 9223, 1566721915666, 9458, 235, true
4805, 1566721915433, 9225, 1566721915666, 9458, 233, true
4806, 1566721915434, 9226, 1566721915670, 9462, 236, true
4807, 1566721915436, 9228, 1566721915670, 9462, 234, true
4808, 1566721915438, 9230, 1566721915667, 9459, 229, true
4809, 1566721915439, 9231, 1566721915667, 9459, 228, true
4810, 1566721915441, 9233, 1566721915671, 9463, 230, true
4811, 1566721915446, 9238, 1566721915669, 9461, 223, true
4812, 1566721915448, 9240, 1566721915670, 9462, 222, true
4813, 1566721915449, 9241, 1566721915670, 9462, 221, true
4814, 1566721915452, 9244, 1566721915670, 9462, 218, true
4815, 1566721915454, 9246, 1566721915670, 9462, 216, true
4816, 1566721915455, 9247, 1566721915670, 9462, 215, true
4817, 1566721915456, 9248, 1566721915670, 9462, 214, true
4818, 1566721915458, 9250, 1566721915670, 9462, 212, true
4819, 1566721915461, 9253, 1566721915670, 9462, 209, true
4820, 1566721915462, 9254, 1566721915670, 9462, 208, true
4821, 1566721915464, 9256, 1566721915674, 9466, 210, true
4822, 1566721915464, 9256, 1566721915673, 9465, 209, true
4823, 1566721915465, 9257, 1566721915675, 9467, 210, true
4824, 1566721915466, 9258, 1566721915675, 9467, 209, true
4825, 1566721915467, 9259, 1566721915679, 9471, 212, true
4826, 1566721915469, 9261, 1566721915726, 9518, 257, true
4827, 1566721915470, 9262, 1566721915715, 9507, 245, true
4828, 1566721915472, 9264, 1566721915709, 9501, 237, true
4829, 1566721915482, 9274, 1566721915710, 9502, 228, true
4830, 1566721915486, 9278, 1566721915717, 9509, 231, true
4831, 1566721915488, 9280, 1566721915717, 9509, 229, true
4832, 1566721915488, 9280, 1566721915712, 9504, 224, true
4833, 1566721915490, 9282, 1566721915712, 9504, 222, true
4834, 1566721915491, 9283, 1566721915711, 9503, 220, true
4835, 1566721915492, 9284, 1566721915764, 9556, 272, true
4836, 1566721915492, 9284, 1566721915730, 9522, 238, true
4837, 1566721915493, 9285, 1566721915884, 9676, 391, true
4838, 1566721915558, 9350, 1566721915882, 9674, 324, true
4839, 1566721915628, 9420, 1566721915884, 9676, 256, true
4840, 1566721915665, 9457, 1566721915877, 9669, 212, true
4841, 1566721915679, 9471, 1566721915995, 9787, 316, true
4842, 1566721915679, 9471, 1566721915957, 9749, 278, true
4843, 1566721915680, 9472, 1566721915959, 9751, 279, true
4844, 1566721915680, 9472, 1566721916004, 9796, 324, true
4845, 1566721915680, 9472, 1566721915994, 9786, 314, true
4846, 1566721915681, 9473, 1566721916001, 9793, 320, true
4847, 1566721915681, 9473, 1566721915964, 9756, 283, true
4848, 1566721915682, 9474, 1566721915970, 9762, 288, true
4849, 1566721915683, 9475, 1566721915993, 9785, 310, true
4850, 1566721915683, 9475, 1566721916001, 9793, 318, true
4851, 1566721915683, 9475, 1566721915997, 9789, 314, true
4852, 1566721915684, 9476, 1566721915996, 9788, 312, true
4853, 1566721915684, 9476, 1566721915969, 9761, 285, true
4854, 1566721915684, 9476, 1566721915995, 9787, 311, true
4855, 1566721915685, 9477, 1566721916000, 9792, 315, true
4856, 1566721915685, 9477, 1566721915975, 9767, 290, true
4857, 1566721915686, 9478, 1566721915975, 9767, 289, true
4858, 1566721915686, 9478, 1566721915974, 9766, 288, true
4859, 1566721915686, 9478, 1566721915960, 9752, 274, true
4860, 1566721915686, 9478, 1566721916004, 9796, 318, true
4861, 1566721915687, 9479, 1566721916000, 9792, 313, true
4862, 1566721915687, 9479, 1566721916000, 9792, 313, true
4863, 1566721915687, 9479, 1566721915993, 9785, 306, true
4864, 1566721915687, 9479, 1566721916000, 9792, 313, true
4865, 1566721915688, 9480, 1566721915980, 9772, 292, true
4866, 1566721915688, 9480, 1566721915975, 9767, 287, true
4867, 1566721915688, 9480, 1566721915969, 9761, 281, true
4868, 1566721915689, 9481, 1566721915996, 9788, 307, true
4869, 1566721915689, 9481, 1566721915995, 9787, 306, true
4870, 1566721915690, 9482, 1566721915994, 9786, 304, true
4871, 1566721915690, 9482, 1566721915957, 9749, 267, true
4872, 1566721915690, 9482, 1566721915993, 9785, 303, true
4873, 1566721915691, 9483, 1566721916004, 9796, 313, true
4874, 1566721915691, 9483, 1566721915996, 9788, 305, true
4875, 1566721915691, 9483, 1566721915975, 9767, 284, true
4876, 1566721915692, 9484, 1566721915995, 9787, 303, true
4877, 1566721915692, 9484, 1566721916012, 9804, 320, true
4878, 1566721915692, 9484, 1566721915995, 9787, 303, true
4879, 1566721915692, 9484, 1566721915970, 9762, 278, true
4880, 1566721915693, 9485, 1566721915995, 9787, 302, true
4881, 1566721915693, 9485, 1566721915996, 9788, 303, true
4882, 1566721915693, 9485, 1566721915993, 9785, 300, true
4883, 1566721915693, 9485, 1566721915975, 9767, 282, true
4884, 1566721915694, 9486, 1566721916000, 9792, 306, true
4885, 1566721915694, 9486, 1566721915976, 9768, 282, true
4886, 1566721915694, 9486, 1566721915964, 9756, 270, true
4887, 1566721915694, 9486, 1566721915996, 9788, 302, true
4888, 1566721915695, 9487, 1566721915996, 9788, 301, true
4889, 1566721915695, 9487, 1566721915974, 9766, 279, true
4890, 1566721915695, 9487, 1566721915956, 9748, 261, true
4891, 1566721915696, 9488, 1566721915998, 9790, 302, true
4892, 1566721915696, 9488, 1566721915974, 9766, 278, true
4893, 1566721915696, 9488, 1566721915993, 9785, 297, true
4894, 1566721915696, 9488, 1566721916001, 9793, 305, true
4895, 1566721915697, 9489, 1566721915979, 9771, 282, true
4896, 1566721915697, 9489, 1566721915961, 9753, 264, true
4897, 1566721915697, 9489, 1566721915970, 9762, 273, true
4898, 1566721915697, 9489, 1566721915959, 9751, 262, true
4899, 1566721915698, 9490, 1566721916001, 9793, 303, true
4900, 1566721915698, 9490, 1566721915996, 9788, 298, true
4901, 1566721915698, 9490, 1566721915964, 9756, 266, true
4902, 1566721915698, 9490, 1566721915974, 9766, 276, true
4903, 1566721915699, 9491, 1566721915994, 9786, 295, true
4904, 1566721915699, 9491, 1566721915995, 9787, 296, true
4905, 1566721915699, 9491, 1566721915966, 9758, 267, true
4906, 1566721915699, 9491, 1566721916001, 9793, 302, true
4907, 1566721915700, 9492, 1566721915994, 9786, 294, true
4908, 1566721915700, 9492, 1566721915992, 9784, 292, true
4909, 1566721915701, 9493, 1566721915964, 9756, 263, true
4910, 1566721915701, 9493, 1566721915993, 9785, 292, true
4911, 1566721915701, 9493, 1566721915976, 9768, 275, true
4912, 1566721915701, 9493, 1566721915959, 9751, 258, true
4913, 1566721915702, 9494, 1566721915959, 9751, 257, true
4914, 1566721915702, 9494, 1566721915993, 9785, 291, true
4915, 1566721915702, 9494, 1566721915974, 9766, 272, true
4916, 1566721915702, 9494, 1566721915959, 9751, 257, true
4917, 1566721915703, 9495, 1566721916001, 9793, 298, true
4918, 1566721915703, 9495, 1566721915959, 9751, 256, true
4919, 1566721915703, 9495, 1566721915964, 9756, 261, true
4920, 1566721915703, 9495, 1566721916004, 9796, 301, true
4921, 1566721915704, 9496, 1566721915995, 9787, 291, true
4922, 1566721915704, 9496, 1566721915974, 9766, 270, true
4923, 1566721915704, 9496, 1566721915975, 9767, 271, true
4924, 1566721915705, 9497, 1566721915960, 9752, 255, true
4925, 1566721915705, 9497, 1566721915975, 9767, 270, true
4926, 1566721915705, 9497, 1566721915959, 9751, 254, true
4927, 1566721915705, 9497, 1566721915995, 9787, 290, true
4928, 1566721915706, 9498, 1566721916001, 9793, 295, true
4929, 1566721915706, 9498, 1566721916001, 9793, 295, true
4930, 1566721915706, 9498, 1566721915999, 9791, 293, true
4931, 1566721915706, 9498, 1566721915976, 9768, 270, true
4932, 1566721915707, 9499, 1566721916000, 9792, 293, true
4933, 1566721915707, 9499, 1566721915975, 9767, 268, true
4934, 1566721915707, 9499, 1566721915993, 9785, 286, true
4935, 1566721915707, 9499, 1566721915996, 9788, 289, true
4936, 1566721915708, 9500, 1566721915973, 9765, 265, true
4937, 1566721915709, 9501, 1566721915963, 9755, 254, true
4938, 1566721915710, 9502, 1566721916004, 9796, 294, true
4939, 1566721915710, 9502, 1566721915974, 9766, 264, true
4940, 1566721915711, 9503, 1566721915974, 9766, 263, true
4941, 1566721915712, 9504, 1566721915976, 9768, 264, true
4942, 1566721915712, 9504, 1566721915979, 9771, 267, true
4943, 1566721915712, 9504, 1566721915994, 9786, 282, true
4944, 1566721915713, 9505, 1566721915954, 9746, 241, true
4945, 1566721915713, 9505, 1566721915957, 9749, 244, true
4946, 1566721915713, 9505, 1566721916000, 9792, 287, true
4947, 1566721915714, 9506, 1566721916000, 9792, 286, true
4948, 1566721915714, 9506, 1566721915975, 9767, 261, true
4949, 1566721915719, 9511, 1566721915996, 9788, 277, true
4950, 1566721915719, 9511, 1566721915992, 9784, 273, true
4951, 1566721915719, 9511, 1566721916000, 9792, 281, true
4952, 1566721915720, 9512, 1566721915974, 9766, 254, true
4953, 1566721915720, 9512, 1566721915999, 9791, 279, true
4954, 1566721915721, 9513, 1566721915964, 9756, 243, true
4955, 1566721915721, 9513, 1566721915997, 9789, 276, true
4956, 1566721915721, 9513, 1566721915999, 9791, 278, true
4957, 1566721915722, 9514, 1566721915999, 9791, 277, true
4958, 1566721915722, 9514, 1566721915967, 9759, 245, true
4959, 1566721915722, 9514, 1566721915964, 9756, 242, true
4960, 1566721915723, 9515, 1566721915998, 9790, 275, true
4961, 1566721915723, 9515, 1566721915998, 9790, 275, true
4962, 1566721915723, 9515, 1566721915998, 9790, 275, true
4963, 1566721915724, 9516, 1566721915997, 9789, 273, true
4964, 1566721915724, 9516, 1566721915969, 9761, 245, true
4965, 1566721915725, 9517, 1566721915998, 9790, 273, true
4966, 1566721915725, 9517, 1566721915997, 9789, 272, true
4967, 1566721915726, 9518, 1566721915999, 9791, 273, true
4968, 1566721915727, 9519, 1566721915997, 9789, 270, true
4969, 1566721915727, 9519, 1566721915997, 9789, 270, true
4970, 1566721915729, 9521, 1566721915967, 9759, 238, true
4971, 1566721915737, 9529, 1566721915966, 9758, 229, true
4972, 1566721915738, 9530, 1566721915999, 9791, 261, true
4973, 1566721915738, 9530, 1566721915998, 9790, 260, true
4974, 1566721915739, 9531, 1566721915998, 9790, 259, true
4975, 1566721915739, 9531, 1566721915999, 9791, 260, true
4976, 1566721915740, 9532, 1566721915999, 9791, 259, true
4977, 1566721915740, 9532, 1566721915999, 9791, 259, true
4978, 1566721915740, 9532, 1566721915964, 9756, 224, true
4979, 1566721915741, 9533, 1566721915964, 9756, 223, true
4980, 1566721915741, 9533, 1566721916004, 9796, 263, true
4981, 1566721915741, 9533, 1566721915998, 9790, 257, true
4982, 1566721915742, 9534, 1566721915969, 9761, 227, true
4983, 1566721915742, 9534, 1566721916024, 9816, 282, true
4984, 1566721915743, 9535, 1566721915997, 9789, 254, true
4985, 1566721915743, 9535, 1566721915998, 9790, 255, true
4986, 1566721915743, 9535, 1566721915983, 9775, 240, true
4987, 1566721915744, 9536, 1566721915997, 9789, 253, true
4988, 1566721915744, 9536, 1566721915997, 9789, 253, true
4989, 1566721915776, 9568, 1566721916001, 9793, 225, true
4990, 1566721915777, 9569, 1566721916001, 9793, 224, true
4991, 1566721915777, 9569, 1566721916005, 9797, 228, true
4992, 1566721915778, 9570, 1566721916005, 9797, 227, true
4993, 1566721915779, 9571, 1566721916005, 9797, 226, true
4994, 1566721915780, 9572, 1566721916005, 9797, 225, true
4995, 1566721915780, 9572, 1566721916005, 9797, 225, true
4996, 1566721915781, 9573, 1566721916005, 9797, 224, true
4997, 1566721915782, 9574, 1566721916005, 9797, 223, true
4998, 1566721915783, 9575, 1566721916005, 9797, 222, true
4999, 1566721915784, 9576, 1566721916005, 9797, 221, true
5000, 1566721915785, 9577, 1566721916005, 9797, 220, true
5001, 1566721915785, 9577, 1566721916006, 9798, 221, true
5002, 1566721915786, 9578, 1566721916006, 9798, 220, true
5003, 1566721915787, 9579, 1566721916008, 9800, 221, true
5004, 1566721915788, 9580, 1566721916011, 9803, 223, true
5005, 1566721915789, 9581, 1566721916011, 9803, 222, true
5006, 1566721915789, 9581, 1566721916007, 9799, 218, true
5007, 1566721915789, 9581, 1566721916008, 9800, 219, true
5008, 1566721915790, 9582, 1566721916011, 9803, 221, true
5009, 1566721915791, 9583, 1566721916011, 9803, 220, true
5010, 1566721915792, 9584, 1566721916011, 9803, 219, true
5011, 1566721915793, 9585, 1566721916011, 9803, 218, true
5012, 1566721915794, 9586, 1566721916011, 9803, 217, true
5013, 1566721915795, 9587, 1566721916011, 9803, 216, true
5014, 1566721915796, 9588, 1566721916011, 9803, 215, true
5015, 1566721915797, 9589, 1566721916011, 9803, 214, true
5016, 1566721915798, 9590, 1566721916011, 9803, 213, true
5017, 1566721915798, 9590, 1566721916015, 9807, 217, true
5018, 1566721915799, 9591, 1566721916011, 9803, 212, true
5019, 1566721915800, 9592, 1566721916011, 9803, 211, true
5020, 1566721915801, 9593, 1566721916012, 9804, 211, true
5021, 1566721915802, 9594, 1566721916014, 9806, 212, true
5022, 1566721915803, 9595, 1566721916013, 9805, 210, true
5023, 1566721915804, 9596, 1566721916013, 9805, 209, true
5024, 1566721915804, 9596, 1566721916014, 9806, 210, true
5025, 1566721915805, 9597, 1566721916014, 9806, 209, true
5026, 1566721915806, 9598, 1566721916014, 9806, 208, true
5027, 1566721915807, 9599, 1566721916015, 9807, 208, true
5028, 1566721915807, 9599, 1566721916014, 9806, 207, true
5029, 1566721915808, 9600, 1566721916015, 9807, 207, true
5030, 1566721915809, 9601, 1566721916015, 9807, 206, true
5031, 1566721915810, 9602, 1566721916017, 9809, 207, true
5032, 1566721915811, 9603, 1566721916018, 9810, 207, true
5033, 1566721915811, 9603, 1566721916017, 9809, 206, true
5034, 1566721915812, 9604, 1566721916018, 9810, 206, true
5035, 1566721915813, 9605, 1566721916018, 9810, 205, true
5036, 1566721915814, 9606, 1566721916021, 9813, 207, true
5037, 1566721915815, 9607, 1566721916021, 9813, 206, true
5038, 1566721915815, 9607, 1566721916019, 9811, 204, true
5039, 1566721915816, 9608, 1566721916021, 9813, 205, true
5040, 1566721915817, 9609, 1566721916021, 9813, 204, true
5041, 1566721915819, 9611, 1566721916024, 9816, 205, true
5042, 1566721915819, 9611, 1566721916024, 9816, 205, true
5043, 1566721915820, 9612, 1566721916026, 9818, 206, true
5044, 1566721915820, 9612, 1566721916027, 9819, 207, true
5045, 1566721915821, 9613, 1566721916028, 9820, 207, true
5046, 1566721915821, 9613, 1566721916032, 9824, 211, true
5047, 1566721915822, 9614, 1566721916032, 9824, 210, true
5048, 1566721915823, 9615, 1566721916041, 9833, 218, true
5049, 1566721915823, 9615, 1566721916059, 9851, 236, true
5050, 1566721915824, 9616, 1566721916050, 9842, 226, true
5051, 1566721915825, 9617, 1566721916051, 9843, 226, true
5052, 1566721915826, 9618, 1566721916068, 9860, 242, true
5053, 1566721915826, 9618, 1566721916070, 9862, 244, true
5054, 1566721915827, 9619, 1566721916067, 9859, 240, true
5055, 1566721915827, 9619, 1566721916056, 9848, 229, true
5056, 1566721915827, 9619, 1566721916058, 9850, 231, true
5057, 1566721915828, 9620, 1566721916051, 9843, 223, true
5058, 1566721915828, 9620, 1566721916070, 9862, 242, true
5059, 1566721915829, 9621, 1566721916063, 9855, 234, true
5060, 1566721915829, 9621, 1566721916067, 9859, 238, true
5061, 1566721915830, 9622, 1566721916054, 9846, 224, true
5062, 1566721915830, 9622, 1566721916070, 9862, 240, true
5063, 1566721915830, 9622, 1566721916050, 9842, 220, true
5064, 1566721915831, 9623, 1566721916056, 9848, 225, true
5065, 1566721915831, 9623, 1566721916061, 9853, 230, true
5066, 1566721915831, 9623, 1566721916053, 9845, 222, true
5067, 1566721915831, 9623, 1566721916055, 9847, 224, true
5068, 1566721915832, 9624, 1566721916062, 9854, 230, true
5069, 1566721915832, 9624, 1566721916056, 9848, 224, true
5070, 1566721915832, 9624, 1566721916067, 9859, 235, true
5071, 1566721915833, 9625, 1566721916053, 9845, 220, true
5072, 1566721915834, 9626, 1566721916066, 9858, 232, true
5073, 1566721915834, 9626, 1566721916054, 9846, 220, true
5074, 1566721915834, 9626, 1566721916068, 9860, 234, true
5075, 1566721915835, 9627, 1566721916050, 9842, 215, true
5076, 1566721915835, 9627, 1566721916067, 9859, 232, true
5077, 1566721915835, 9627, 1566721916061, 9853, 226, true
5078, 1566721915836, 9628, 1566721916066, 9858, 230, true
5079, 1566721915836, 9628, 1566721916064, 9856, 228, true
5080, 1566721915836, 9628, 1566721916056, 9848, 220, true
5081, 1566721915837, 9629, 1566721916069, 9861, 232, true
5082, 1566721915837, 9629, 1566721916063, 9855, 226, true
5083, 1566721915837, 9629, 1566721916055, 9847, 218, true
5084, 1566721915837, 9629, 1566721916070, 9862, 233, true
5085, 1566721915838, 9630, 1566721916060, 9852, 222, true
5086, 1566721915838, 9630, 1566721916068, 9860, 230, true
5087, 1566721915838, 9630, 1566721916053, 9845, 215, true
5088, 1566721915839, 9631, 1566721916068, 9860, 229, true
5089, 1566721915839, 9631, 1566721916052, 9844, 213, true
5090, 1566721915860, 9652, 1566721916071, 9863, 211, true
5091, 1566721915863, 9655, 1566721916072, 9864, 209, true
5092, 1566721915865, 9657, 1566721916078, 9870, 213, true
5093, 1566721915867, 9659, 1566721916080, 9872, 213, true
5094, 1566721915869, 9661, 1566721916081, 9873, 212, true
5095, 1566721915871, 9663, 1566721916083, 9875, 212, true
5096, 1566721915872, 9664, 1566721916083, 9875, 211, true
5097, 1566721915875, 9667, 1566721916083, 9875, 208, true
5098, 1566721915878, 9670, 1566721916083, 9875, 205, true
5099, 1566721915879, 9671, 1566721916095, 9887, 216, true
5100, 1566721915881, 9673, 1566721916095, 9887, 214, true
5101, 1566721915884, 9676, 1566721916095, 9887, 211, true
5102, 1566721915885, 9677, 1566721916095, 9887, 210, true
5103, 1566721915887, 9679, 1566721916104, 9896, 217, true
5104, 1566721915888, 9680, 1566721916110, 9902, 222, true
5105, 1566721915889, 9681, 1566721916110, 9902, 221, true
5106, 1566721915890, 9682, 1566721916110, 9902, 220, true
5107, 1566721915891, 9683, 1566721916110, 9902, 219, true
5108, 1566721915891, 9683, 1566721916110, 9902, 219, true
5109, 1566721915894, 9686, 1566721916110, 9902, 216, true
5110, 1566721915896, 9688, 1566721916110, 9902, 214, true
5111, 1566721915898, 9690, 1566721916110, 9902, 212, true
5112, 1566721915900, 9692, 1566721916110, 9902, 210, true
5113, 1566721915902, 9694, 1566721916112, 9904, 210, true
5114, 1566721915904, 9696, 1566721916112, 9904, 208, true
5115, 1566721915905, 9697, 1566721916112, 9904, 207, true
5116, 1566721915908, 9700, 1566721916113, 9905, 205, true
5117, 1566721915910, 9702, 1566721916119, 9911, 209, true
5118, 1566721915912, 9704, 1566721916119, 9911, 207, true
5119, 1566721915913, 9705, 1566721916119, 9911, 206, true
5120, 1566721915915, 9707, 1566721916119, 9911, 204, true
5121, 1566721915916, 9708, 1566721916120, 9912, 204, true
5122, 1566721915917, 9709, 1566721916121, 9913, 204, true
5123, 1566721915917, 9709, 1566721916122, 9914, 205, true
5124, 1566721915918, 9710, 1566721916122, 9914, 204, true
5125, 1566721915920, 9712, 1566721916123, 9915, 203, true
5126, 1566721915921, 9713, 1566721916124, 9916, 203, true
5127, 1566721915922, 9714, 1566721916125, 9917, 203, true
5128, 1566721915923, 9715, 1566721916126, 9918, 203, true
5129, 1566721915924, 9716, 1566721916128, 9920, 204, true
5130, 1566721915925, 9717, 1566721916128, 9920, 203, true
5131, 1566721915926, 9718, 1566721916134, 9926, 208, true
5132, 1566721915928, 9720, 1566721916134, 9926, 206, true
5133, 1566721915928, 9720, 1566721916134, 9926, 206, true
5134, 1566721915929, 9721, 1566721916140, 9932, 211, true
5135, 1566721915930, 9722, 1566721916140, 9932, 210, true
5136, 1566721915931, 9723, 1566721916140, 9932, 209, true
5137, 1566721915932, 9724, 1566721916142, 9934, 210, true
5138, 1566721915933, 9725, 1566721916140, 9932, 207, true
5139, 1566721915933, 9725, 1566721916140, 9932, 207, true
5140, 1566721915934, 9726, 1566721916140, 9932, 206, true
5141, 1566721915936, 9728, 1566721916143, 9935, 207, true
5142, 1566721915937, 9729, 1566721916145, 9937, 208, true
5143, 1566721915937, 9729, 1566721916143, 9935, 206, true
5144, 1566721915937, 9729, 1566721916142, 9934, 205, true
5145, 1566721915938, 9730, 1566721916145, 9937, 207, true
5146, 1566721915938, 9730, 1566721916147, 9939, 209, true
5147, 1566721915939, 9731, 1566721916157, 9949, 218, true
5148, 1566721915939, 9731, 1566721916157, 9949, 218, true
5149, 1566721915940, 9732, 1566721916149, 9941, 209, true
5150, 1566721915941, 9733, 1566721916149, 9941, 208, true
5151, 1566721915942, 9734, 1566721916157, 9949, 215, true
5152, 1566721915944, 9736, 1566721916157, 9949, 213, true
5153, 1566721915949, 9741, 1566721916157, 9949, 208, true
5154, 1566721915950, 9742, 1566721916157, 9949, 207, true
5155, 1566721915950, 9742, 1566721916159, 9951, 209, true
5156, 1566721915952, 9744, 1566721916222, 10014, 270, true
5157, 1566721915953, 9745, 1566721916226, 10018, 273, true
5158, 1566721916089, 9881, 1566721916297, 10089, 208, true
5159, 1566721916090, 9882, 1566721916297, 10089, 207, true
5160, 1566721916090, 9882, 1566721916297, 10089, 207, true
5161, 1566721916091, 9883, 1566721916293, 10085, 202, true
5162, 1566721916091, 9883, 1566721916297, 10089, 206, true
5163, 1566721916092, 9884, 1566721916297, 10089, 205, true
5164, 1566721916092, 9884, 1566721916297, 10089, 205, true
5165, 1566721916093, 9885, 1566721916297, 10089, 204, true
5166, 1566721916096, 9888, 1566721916300, 10092, 204, true
5167, 1566721916096, 9888, 1566721916299, 10091, 203, true
5168, 1566721916096, 9888, 1566721916300, 10092, 204, true
5169, 1566721916097, 9889, 1566721916300, 10092, 203, true
5170, 1566721916097, 9889, 1566721916302, 10094, 205, true
5171, 1566721916098, 9890, 1566721916302, 10094, 204, true
5172, 1566721916099, 9891, 1566721916302, 10094, 203, true
5173, 1566721916100, 9892, 1566721916303, 10095, 203, true
5174, 1566721916100, 9892, 1566721916304, 10096, 204, true
5175, 1566721916101, 9893, 1566721916306, 10098, 205, true
5176, 1566721916102, 9894, 1566721916306, 10098, 204, true
5177, 1566721916104, 9896, 1566721916307, 10099, 203, true
5178, 1566721916104, 9896, 1566721916310, 10102, 206, true
5179, 1566721916105, 9897, 1566721916309, 10101, 204, true
5180, 1566721916105, 9897, 1566721916314, 10106, 209, true
5181, 1566721916106, 9898, 1566721916314, 10106, 208, true
5182, 1566721916113, 9905, 1566721916318, 10110, 205, true
5183, 1566721916114, 9906, 1566721916319, 10111, 205, true
5184, 1566721916114, 9906, 1566721916318, 10110, 204, true
5185, 1566721916114, 9906, 1566721916318, 10110, 204, true
5186, 1566721916115, 9907, 1566721916320, 10112, 205, true
5187, 1566721916115, 9907, 1566721916320, 10112, 205, true
5188, 1566721916116, 9908, 1566721916320, 10112, 204, true
5189, 1566721916116, 9908, 1566721916324, 10116, 208, true
5190, 1566721916119, 9911, 1566721916322, 10114, 203, true
5191, 1566721916120, 9912, 1566721916324, 10116, 204, true
5192, 1566721916122, 9914, 1566721916325, 10117, 203, true
5193, 1566721916123, 9915, 1566721916325, 10117, 202, true
5194, 1566721916124, 9916, 1566721916327, 10119, 203, true
5195, 1566721916125, 9917, 1566721916328, 10120, 203, true
5196, 1566721916126, 9918, 1566721916330, 10122, 204, true
5197, 1566721916128, 9920, 1566721916331, 10123, 203, true
5198, 1566721916128, 9920, 1566721916330, 10122, 202, true
5199, 1566721916129, 9921, 1566721916333, 10125, 204, true
5200, 1566721916129, 9921, 1566721916332, 10124, 203, true
5201, 1566721916130, 9922, 1566721916333, 10125, 203, true
5202, 1566721916130, 9922, 1566721916333, 10125, 203, true
5203, 1566721916131, 9923, 1566721916339, 10131, 208, true
5204, 1566721916131, 9923, 1566721916335, 10127, 204, true
5205, 1566721916132, 9924, 1566721916339, 10131, 207, true
5206, 1566721916135, 9927, 1566721916339, 10131, 204, true
5207, 1566721916135, 9927, 1566721916338, 10130, 203, true
5208, 1566721916135, 9927, 1566721916338, 10130, 203, true
5209, 1566721916136, 9928, 1566721916344, 10136, 208, true
5210, 1566721916136, 9928, 1566721916341, 10133, 205, true
5211, 1566721916137, 9929, 1566721916341, 10133, 204, true
5212, 1566721916141, 9933, 1566721916343, 10135, 202, true
5213, 1566721916142, 9934, 1566721916345, 10137, 203, true
5214, 1566721916145, 9937, 1566721916348, 10140, 203, true
5215, 1566721916145, 9937, 1566721916348, 10140, 203, true
5216, 1566721916146, 9938, 1566721916348, 10140, 202, true
5217, 1566721916147, 9939, 1566721916354, 10146, 207, true
5218, 1566721916147, 9939, 1566721916354, 10146, 207, true
5219, 1566721916148, 9940, 1566721916351, 10143, 203, true
5220, 1566721916149, 9941, 1566721916352, 10144, 203, true
5221, 1566721916150, 9942, 1566721916354, 10146, 204, true
5222, 1566721916150, 9942, 1566721916353, 10145, 203, true
5223, 1566721916151, 9943, 1566721916359, 10151, 208, true
5224, 1566721916151, 9943, 1566721916359, 10151, 208, true
5225, 1566721916159, 9951, 1566721916366, 10158, 207, true
5226, 1566721916160, 9952, 1566721916362, 10154, 202, true
5227, 1566721916160, 9952, 1566721916364, 10156, 204, true
5228, 1566721916160, 9952, 1566721916366, 10158, 206, true
5229, 1566721916161, 9953, 1566721916364, 10156, 203, true
5230, 1566721916162, 9954, 1566721916366, 10158, 204, true
5231, 1566721916162, 9954, 1566721916366, 10158, 204, true
5232, 1566721916163, 9955, 1566721916366, 10158, 203, true
5233, 1566721916164, 9956, 1566721916367, 10159, 203, true
5234, 1566721916164, 9956, 1566721916367, 10159, 203, true
5235, 1566721916165, 9957, 1566721916368, 10160, 203, true
5236, 1566721916166, 9958, 1566721916369, 10161, 203, true
5237, 1566721916167, 9959, 1566721916370, 10162, 203, true
5238, 1566721916167, 9959, 1566721916375, 10167, 208, true
5239, 1566721916168, 9960, 1566721916375, 10167, 207, true
5240, 1566721916169, 9961, 1566721916372, 10164, 203, true
5241, 1566721916170, 9962, 1566721916373, 10165, 203, true
5242, 1566721916170, 9962, 1566721916376, 10168, 206, true
5243, 1566721916171, 9963, 1566721916376, 10168, 205, true
5244, 1566721916172, 9964, 1566721916377, 10169, 205, true
5245, 1566721916173, 9965, 1566721916377, 10169, 204, true
5246, 1566721916173, 9965, 1566721916381, 10173, 208, true
5247, 1566721916174, 9966, 1566721916381, 10173, 207, true
5248, 1566721916175, 9967, 1566721916382, 10174, 207, true
5249, 1566721916176, 9968, 1566721916382, 10174, 206, true
5250, 1566721916176, 9968, 1566721916382, 10174, 206, true
5251, 1566721916177, 9969, 1566721916382, 10174, 205, true
5252, 1566721916178, 9970, 1566721916382, 10174, 204, true
5253, 1566721916178, 9970, 1566721916386, 10178, 208, true
5254, 1566721916179, 9971, 1566721916386, 10178, 207, true
5255, 1566721916180, 9972, 1566721916383, 10175, 203, true
5256, 1566721916180, 9972, 1566721916386, 10178, 206, true
5257, 1566721916180, 9972, 1566721916383, 10175, 203, true
5258, 1566721916181, 9973, 1566721916386, 10178, 205, true
5259, 1566721916182, 9974, 1566721916386, 10178, 204, true
5260, 1566721916183, 9975, 1566721916386, 10178, 203, true
5261, 1566721916184, 9976, 1566721916387, 10179, 203, true
5262, 1566721916184, 9976, 1566721916387, 10179, 203, true
5263, 1566721916185, 9977, 1566721916389, 10181, 204, true
5264, 1566721916186, 9978, 1566721916390, 10182, 204, true
5265, 1566721916187, 9979, 1566721916390, 10182, 203, true
5266, 1566721916187, 9979, 1566721916393, 10185, 206, true
5267, 1566721916189, 9981, 1566721916393, 10185, 204, true
5268, 1566721916191, 9983, 1566721916397, 10189, 206, true
5269, 1566721916191, 9983, 1566721916396, 10188, 205, true
5270, 1566721916192, 9984, 1566721916396, 10188, 204, true
5271, 1566721916193, 9985, 1566721916398, 10190, 205, true
5272, 1566721916194, 9986, 1566721916398, 10190, 204, true
5273, 1566721916194, 9986, 1566721916398, 10190, 204, true
5274, 1566721916195, 9987, 1566721916398, 10190, 203, true
5275, 1566721916196, 9988, 1566721916405, 10197, 209, true
5276, 1566721916196, 9988, 1566721916406, 10198, 210, true
5277, 1566721916197, 9989, 1566721916401, 10193, 204, true
5278, 1566721916198, 9990, 1566721916406, 10198, 208, true
5279, 1566721916198, 9990, 1566721916406, 10198, 208, true
5280, 1566721916199, 9991, 1566721916406, 10198, 207, true
5281, 1566721916200, 9992, 1566721916408, 10200, 208, true
5282, 1566721916201, 9993, 1566721916408, 10200, 207, true
5283, 1566721916202, 9994, 1566721916409, 10201, 207, true
5284, 1566721916203, 9995, 1566721916409, 10201, 206, true
5285, 1566721916204, 9996, 1566721916409, 10201, 205, true
5286, 1566721916204, 9996, 1566721916409, 10201, 205, true
5287, 1566721916205, 9997, 1566721916409, 10201, 204, true
5288, 1566721916206, 9998, 1566721916410, 10202, 204, true
5289, 1566721916207, 9999, 1566721916411, 10203, 204, true
5290, 1566721916207, 9999, 1566721916414, 10206, 207, true
5291, 1566721916208, 10000, 1566721916411, 10203, 203, true
5292, 1566721916209, 10001, 1566721916412, 10204, 203, true
5293, 1566721916210, 10002, 1566721916414, 10206, 204, true
5294, 1566721916211, 10003, 1566721916419, 10211, 208, true
5295, 1566721916211, 10003, 1566721916415, 10207, 204, true
5296, 1566721916212, 10004, 1566721916419, 10211, 207, true
5297, 1566721916213, 10005, 1566721916419, 10211, 206, true
5298, 1566721916214, 10006, 1566721916419, 10211, 205, true
5299, 1566721916215, 10007, 1566721916419, 10211, 204, true
5300, 1566721916217, 10009, 1566721916420, 10212, 203, true
5301, 1566721916218, 10010, 1566721916421, 10213, 203, true
5302, 1566721916219, 10011, 1566721916422, 10214, 203, true
5303, 1566721916220, 10012, 1566721916426, 10218, 206, true
5304, 1566721916221, 10013, 1566721916426, 10218, 205, true
5305, 1566721916221, 10013, 1566721916425, 10217, 204, true
5306, 1566721916223, 10015, 1566721916426, 10218, 203, true
5307, 1566721916224, 10016, 1566721916428, 10220, 204, true
5308, 1566721916226, 10018, 1566721916431, 10223, 205, true
5309, 1566721916227, 10019, 1566721916434, 10226, 207, true
5310, 1566721916229, 10021, 1566721916432, 10224, 203, true
5311, 1566721916230, 10022, 1566721916434, 10226, 204, true
5312, 1566721916231, 10023, 1566721916434, 10226, 203, true
5313, 1566721916231, 10023, 1566721916439, 10231, 208, true
5314, 1566721916232, 10024, 1566721916439, 10231, 207, true
5315, 1566721916233, 10025, 1566721916439, 10231, 206, true
5316, 1566721916235, 10027, 1566721916439, 10231, 204, true
5317, 1566721916236, 10028, 1566721916444, 10236, 208, true
5318, 1566721916238, 10030, 1566721916442, 10234, 204, true
5319, 1566721916240, 10032, 1566721916448, 10240, 208, true
5320, 1566721916240, 10032, 1566721916448, 10240, 208, true
5321, 1566721916241, 10033, 1566721916447, 10239, 206, true
5322, 1566721916241, 10033, 1566721916448, 10240, 207, true
5323, 1566721916241, 10033, 1566721916448, 10240, 207, true
5324, 1566721916242, 10034, 1566721916448, 10240, 206, true
5325, 1566721916242, 10034, 1566721916448, 10240, 206, true
5326, 1566721916244, 10036, 1566721916451, 10243, 207, true
5327, 1566721916245, 10037, 1566721916450, 10242, 205, true
5328, 1566721916246, 10038, 1566721916449, 10241, 203, true
5329, 1566721916247, 10039, 1566721916452, 10244, 205, true
5330, 1566721916247, 10039, 1566721916452, 10244, 205, true
5331, 1566721916248, 10040, 1566721916452, 10244, 204, true
5332, 1566721916249, 10041, 1566721916452, 10244, 203, true
5333, 1566721916250, 10042, 1566721916454, 10246, 204, true
5334, 1566721916251, 10043, 1566721916455, 10247, 204, true
5335, 1566721916252, 10044, 1566721916455, 10247, 203, true
5336, 1566721916253, 10045, 1566721916460, 10252, 207, true
5337, 1566721916254, 10046, 1566721916460, 10252, 206, true
5338, 1566721916255, 10047, 1566721916459, 10251, 204, true
5339, 1566721916256, 10048, 1566721916460, 10252, 204, true
5340, 1566721916258, 10050, 1566721916466, 10258, 208, true
5341, 1566721916258, 10050, 1566721916462, 10254, 204, true
5342, 1566721916258, 10050, 1566721916466, 10258, 208, true
5343, 1566721916259, 10051, 1566721916466, 10258, 207, true
5344, 1566721916259, 10051, 1566721916466, 10258, 207, true
5345, 1566721916260, 10052, 1566721916466, 10258, 206, true
5346, 1566721916261, 10053, 1566721916466, 10258, 205, true
5347, 1566721916263, 10055, 1566721916467, 10259, 204, true
5348, 1566721916263, 10055, 1566721916467, 10259, 204, true
5349, 1566721916264, 10056, 1566721916468, 10260, 204, true
5350, 1566721916265, 10057, 1566721916469, 10261, 204, true
5351, 1566721916267, 10059, 1566721916470, 10262, 203, true
5352, 1566721916267, 10059, 1566721916474, 10266, 207, true
5353, 1566721916268, 10060, 1566721916471, 10263, 203, true
5354, 1566721916270, 10062, 1566721916473, 10265, 203, true
5355, 1566721916271, 10063, 1566721916475, 10267, 204, true
5356, 1566721916273, 10065, 1566721916476, 10268, 203, true
5357, 1566721916275, 10067, 1566721916480, 10272, 205, true
5358, 1566721916276, 10068, 1566721916480, 10272, 204, true
5359, 1566721916278, 10070, 1566721916482, 10274, 204, true
5360, 1566721916281, 10073, 1566721916487, 10279, 206, true
5361, 1566721916281, 10073, 1566721916487, 10279, 206, true
5362, 1566721916282, 10074, 1566721916486, 10278, 204, true
5363, 1566721916282, 10074, 1566721916489, 10281, 207, true
5364, 1566721916284, 10076, 1566721916488, 10280, 204, true
5365, 1566721916285, 10077, 1566721916489, 10281, 204, true
5366, 1566721916286, 10078, 1566721916490, 10282, 204, true
5367, 1566721916287, 10079, 1566721916493, 10285, 206, true
5368, 1566721916288, 10080, 1566721916493, 10285, 205, true
5369, 1566721916289, 10081, 1566721916496, 10288, 207, true
5370, 1566721916293, 10085, 1566721916501, 10293, 208, true
5371, 1566721916303, 10095, 1566721916511, 10303, 208, true
5372, 1566721916305, 10097, 1566721916511, 10303, 206, true
5373, 1566721916306, 10098, 1566721916512, 10304, 206, true
5374, 1566721916307, 10099, 1566721916512, 10304, 205, true
5375, 1566721916310, 10102, 1566721916514, 10306, 204, true
5376, 1566721916311, 10103, 1566721916514, 10306, 203, true
5377, 1566721916311, 10103, 1566721916514, 10306, 203, true
5378, 1566721916312, 10104, 1566721916519, 10311, 207, true
5379, 1566721916312, 10104, 1566721916517, 10309, 205, true
5380, 1566721916314, 10106, 1566721916519, 10311, 205, true
5381, 1566721916315, 10107, 1566721916519, 10311, 204, true
5382, 1566721916316, 10108, 1566721916523, 10315, 207, true
5383, 1566721916326, 10118, 1566721916529, 10321, 203, true
5384, 1566721916326, 10118, 1566721916529, 10321, 203, true
5385, 1566721916327, 10119, 1566721916531, 10323, 204, true
5386, 1566721916328, 10120, 1566721916534, 10326, 206, true
5387, 1566721916329, 10121, 1566721916534, 10326, 205, true
5388, 1566721916333, 10125, 1566721916539, 10331, 206, true
5389, 1566721916335, 10127, 1566721916539, 10331, 204, true
5390, 1566721916335, 10127, 1566721916539, 10331, 204, true
5391, 1566721916336, 10128, 1566721916539, 10331, 203, true
5392, 1566721916336, 10128, 1566721916542, 10334, 206, true
5393, 1566721916336, 10128, 1566721916543, 10335, 207, true
5394, 1566721916339, 10131, 1566721916543, 10335, 204, true
5395, 1566721916340, 10132, 1566721916543, 10335, 203, true
5396, 1566721916342, 10134, 1566721916548, 10340, 206, true
5397, 1566721916342, 10134, 1566721916548, 10340, 206, true
5398, 1566721916345, 10137, 1566721916549, 10341, 204, true
5399, 1566721916346, 10138, 1566721916549, 10341, 203, true
5400, 1566721916346, 10138, 1566721916555, 10347, 209, true
5401, 1566721916347, 10139, 1566721916555, 10347, 208, true
5402, 1566721916349, 10141, 1566721916555, 10347, 206, true
5403, 1566721916349, 10141, 1566721916553, 10345, 204, true
5404, 1566721916352, 10144, 1566721916556, 10348, 204, true
5405, 1566721916355, 10147, 1566721916558, 10350, 203, true
5406, 1566721916355, 10147, 1566721916562, 10354, 207, true
5407, 1566721916356, 10148, 1566721916566, 10358, 210, true
5408, 1566721916357, 10149, 1566721916562, 10354, 205, true
5409, 1566721916357, 10149, 1566721916562, 10354, 205, true
5410, 1566721916357, 10149, 1566721916566, 10358, 209, true
5411, 1566721916359, 10151, 1566721916566, 10358, 207, true
5412, 1566721916361, 10153, 1566721916566, 10358, 205, true
5413, 1566721916361, 10153, 1566721916581, 10373, 220, true
5414, 1566721916361, 10153, 1566721916581, 10373, 220, true
5415, 1566721916363, 10155, 1566721916574, 10366, 211, true
5416, 1566721916367, 10159, 1566721916574, 10366, 207, true
5417, 1566721916370, 10162, 1566721916580, 10372, 210, true
5418, 1566721916376, 10168, 1566721916582, 10374, 206, true
5419, 1566721916378, 10170, 1566721916590, 10382, 212, true
5420, 1566721916388, 10180, 1566721916595, 10387, 207, true
5421, 1566721916389, 10181, 1566721916595, 10387, 206, true
5422, 1566721916391, 10183, 1566721916597, 10389, 206, true
5423, 1566721916394, 10186, 1566721916597, 10389, 203, true
5424, 1566721916402, 10194, 1566721916614, 10406, 212, true
5425, 1566721916415, 10207, 1566721916626, 10418, 211, true
5426, 1566721916416, 10208, 1566721916626, 10418, 210, true
5427, 1566721916417, 10209, 1566721916627, 10419, 210, true
5428, 1566721916422, 10214, 1566721916628, 10420, 206, true
5429, 1566721916423, 10215, 1566721916628, 10420, 205, true
5430, 1566721916423, 10215, 1566721916629, 10421, 206, true
5431, 1566721916424, 10216, 1566721916629, 10421, 205, true
5432, 1566721916424, 10216, 1566721916628, 10420, 204, true
5433, 1566721916428, 10220, 1566721916631, 10423, 203, true
5434, 1566721916428, 10220, 1566721916633, 10425, 205, true
5435, 1566721916429, 10221, 1566721916635, 10427, 206, true
5436, 1566721916429, 10221, 1566721916633, 10425, 204, true
5437, 1566721916430, 10222, 1566721916632, 10424, 202, true
5438, 1566721916431, 10223, 1566721916640, 10432, 209, true
5439, 1566721916432, 10224, 1566721916640, 10432, 208, true
5440, 1566721916433, 10225, 1566721916640, 10432, 207, true
5441, 1566721916435, 10227, 1566721916640, 10432, 205, true
5442, 1566721916436, 10228, 1566721916640, 10432, 204, true
5443, 1566721916436, 10228, 1566721916640, 10432, 204, true
5444, 1566721916437, 10229, 1566721916642, 10434, 205, true
5445, 1566721916439, 10231, 1566721916642, 10434, 203, true
5446, 1566721916440, 10232, 1566721916643, 10435, 203, true
5447, 1566721916441, 10233, 1566721916644, 10436, 203, true
5448, 1566721916442, 10234, 1566721916644, 10436, 202, true
5449, 1566721916443, 10235, 1566721916646, 10438, 203, true
5450, 1566721916444, 10236, 1566721916649, 10441, 205, true
5451, 1566721916444, 10236, 1566721916684, 10476, 240, true
5452, 1566721916445, 10237, 1566721916684, 10476, 239, true
5453, 1566721916450, 10242, 1566721916684, 10476, 234, true
5454, 1566721916454, 10246, 1566721916684, 10476, 230, true
5455, 1566721916458, 10250, 1566721916684, 10476, 226, true
5456, 1566721916458, 10250, 1566721916684, 10476, 226, true
5457, 1566721916461, 10253, 1566721916684, 10476, 223, true
5458, 1566721916462, 10254, 1566721916684, 10476, 222, true
5459, 1566721916470, 10262, 1566721916685, 10477, 215, true
5460, 1566721916473, 10265, 1566721916685, 10477, 212, true
5461, 1566721916475, 10267, 1566721916685, 10477, 210, true
5462, 1566721916475, 10267, 1566721916685, 10477, 210, true
5463, 1566721916477, 10269, 1566721916690, 10482, 213, true
5464, 1566721916477, 10269, 1566721916689, 10481, 212, true
5465, 1566721916477, 10269, 1566721916690, 10482, 213, true
5466, 1566721916477, 10269, 1566721916685, 10477, 208, true
5467, 1566721916478, 10270, 1566721916690, 10482, 212, true
5468, 1566721916478, 10270, 1566721916690, 10482, 212, true
5469, 1566721916479, 10271, 1566721916690, 10482, 211, true
5470, 1566721916483, 10275, 1566721916692, 10484, 209, true
5471, 1566721916483, 10275, 1566721916692, 10484, 209, true
5472, 1566721916484, 10276, 1566721916690, 10482, 206, true
5473, 1566721916484, 10276, 1566721916695, 10487, 211, true
5474, 1566721916485, 10277, 1566721916692, 10484, 207, true
5475, 1566721916490, 10282, 1566721916695, 10487, 205, true
5476, 1566721916490, 10282, 1566721916693, 10485, 203, true
5477, 1566721916491, 10283, 1566721916695, 10487, 204, true
5478, 1566721916492, 10284, 1566721916695, 10487, 203, true
5479, 1566721916492, 10284, 1566721916697, 10489, 205, true
5480, 1566721916494, 10286, 1566721916697, 10489, 203, true
5481, 1566721916496, 10288, 1566721916705, 10497, 209, true
5482, 1566721916496, 10288, 1566721916699, 10491, 203, true
5483, 1566721916496, 10288, 1566721916705, 10497, 209, true
5484, 1566721916497, 10289, 1566721916705, 10497, 208, true
5485, 1566721916498, 10290, 1566721916705, 10497, 207, true
5486, 1566721916498, 10290, 1566721916709, 10501, 211, true
5487, 1566721916498, 10290, 1566721916707, 10499, 209, true
5488, 1566721916499, 10291, 1566721916709, 10501, 210, true
5489, 1566721916499, 10291, 1566721916708, 10500, 209, true
5490, 1566721916499, 10291, 1566721916707, 10499, 208, true
5491, 1566721916500, 10292, 1566721916707, 10499, 207, true
5492, 1566721916502, 10294, 1566721916707, 10499, 205, true
5493, 1566721916505, 10297, 1566721916709, 10501, 204, true
5494, 1566721916507, 10299, 1566721916715, 10507, 208, true
5495, 1566721916507, 10299, 1566721916715, 10507, 208, true
5496, 1566721916508, 10300, 1566721916716, 10508, 208, true
5497, 1566721916509, 10301, 1566721916716, 10508, 207, true
5498, 1566721916509, 10301, 1566721916717, 10509, 208, true
5499, 1566721916512, 10304, 1566721916717, 10509, 205, true
5500, 1566721916514, 10306, 1566721916729, 10521, 215, true
5501, 1566721916515, 10307, 1566721916727, 10519, 212, true
5502, 1566721916515, 10307, 1566721916727, 10519, 212, true
5503, 1566721916516, 10308, 1566721916727, 10519, 211, true
5504, 1566721916516, 10308, 1566721916728, 10520, 212, true
5505, 1566721916516, 10308, 1566721916729, 10521, 213, true
5506, 1566721916517, 10309, 1566721916730, 10522, 213, true
5507, 1566721916519, 10311, 1566721916729, 10521, 210, true
5508, 1566721916521, 10313, 1566721916727, 10519, 206, true
5509, 1566721916521, 10313, 1566721916729, 10521, 208, true
5510, 1566721916522, 10314, 1566721916729, 10521, 207, true
5511, 1566721916524, 10316, 1566721916729, 10521, 205, true
5512, 1566721916524, 10316, 1566721916733, 10525, 209, true
5513, 1566721916525, 10317, 1566721916730, 10522, 205, true
5514, 1566721916525, 10317, 1566721916730, 10522, 205, true
5515, 1566721916525, 10317, 1566721916733, 10525, 208, true
5516, 1566721916526, 10318, 1566721916736, 10528, 210, true
5517, 1566721916527, 10319, 1566721916736, 10528, 209, true
5518, 1566721916530, 10322, 1566721916733, 10525, 203, true
5519, 1566721916531, 10323, 1566721916735, 10527, 204, true
5520, 1566721916532, 10324, 1566721916735, 10527, 203, true
5521, 1566721916532, 10324, 1566721916743, 10535, 211, true
5522, 1566721916534, 10326, 1566721916743, 10535, 209, true
5523, 1566721916535, 10327, 1566721916743, 10535, 208, true
5524, 1566721916535, 10327, 1566721916739, 10531, 204, true
5525, 1566721916536, 10328, 1566721916743, 10535, 207, true
5526, 1566721916537, 10329, 1566721916745, 10537, 208, true
5527, 1566721916540, 10332, 1566721916745, 10537, 205, true
5528, 1566721916541, 10333, 1566721916747, 10539, 206, true
5529, 1566721916544, 10336, 1566721916748, 10540, 204, true
5530, 1566721916544, 10336, 1566721916748, 10540, 204, true
5531, 1566721916545, 10337, 1566721916748, 10540, 203, true
5532, 1566721916545, 10337, 1566721916748, 10540, 203, true
5533, 1566721916545, 10337, 1566721916749, 10541, 204, true
5534, 1566721916546, 10338, 1566721916755, 10547, 209, true
5535, 1566721916549, 10341, 1566721916755, 10547, 206, true
5536, 1566721916550, 10342, 1566721916755, 10547, 205, true
5537, 1566721916550, 10342, 1566721916755, 10547, 205, true
5538, 1566721916551, 10343, 1566721916758, 10550, 207, true
5539, 1566721916551, 10343, 1566721916765, 10557, 214, true
5540, 1566721916552, 10344, 1566721916764, 10556, 212, true
5541, 1566721916552, 10344, 1566721916770, 10562, 218, true
5542, 1566721916556, 10348, 1566721916765, 10557, 209, true
5543, 1566721916558, 10350, 1566721916770, 10562, 212, true
5544, 1566721916558, 10350, 1566721916771, 10563, 213, true
5545, 1566721916559, 10351, 1566721916771, 10563, 212, true
5546, 1566721916559, 10351, 1566721916771, 10563, 212, true
5547, 1566721916560, 10352, 1566721916771, 10563, 211, true
5548, 1566721916560, 10352, 1566721916771, 10563, 211, true
5549, 1566721916563, 10355, 1566721916771, 10563, 208, true
5550, 1566721916563, 10355, 1566721916771, 10563, 208, true
5551, 1566721916564, 10356, 1566721916771, 10563, 207, true
5552, 1566721916566, 10358, 1566721916771, 10563, 205, true
5553, 1566721916567, 10359, 1566721916774, 10566, 207, true
5554, 1566721916567, 10359, 1566721916771, 10563, 204, true
5555, 1566721916568, 10360, 1566721916778, 10570, 210, true
5556, 1566721916568, 10360, 1566721916784, 10576, 216, true
5557, 1566721916569, 10361, 1566721916781, 10573, 212, true
5558, 1566721916569, 10361, 1566721916784, 10576, 215, true
5559, 1566721916570, 10362, 1566721916784, 10576, 214, true
5560, 1566721916570, 10362, 1566721916786, 10578, 216, true
5561, 1566721916570, 10362, 1566721916790, 10582, 220, true
5562, 1566721916570, 10362, 1566721916784, 10576, 214, true
5563, 1566721916571, 10363, 1566721916784, 10576, 213, true
5564, 1566721916571, 10363, 1566721916780, 10572, 209, true
5565, 1566721916572, 10364, 1566721916784, 10576, 212, true
5566, 1566721916572, 10364, 1566721916784, 10576, 212, true
5567, 1566721916574, 10366, 1566721916784, 10576, 210, true
5568, 1566721916574, 10366, 1566721916784, 10576, 210, true
5569, 1566721916575, 10367, 1566721916780, 10572, 205, true
5570, 1566721916576, 10368, 1566721916790, 10582, 214, true
5571, 1566721916580, 10372, 1566721916790, 10582, 210, true
5572, 1566721916583, 10375, 1566721916790, 10582, 207, true
5573, 1566721916584, 10376, 1566721916790, 10582, 206, true
5574, 1566721916584, 10376, 1566721916790, 10582, 206, true
5575, 1566721916585, 10377, 1566721916790, 10582, 205, true
5576, 1566721916585, 10377, 1566721916796, 10588, 211, true
5577, 1566721916587, 10379, 1566721916796, 10588, 209, true
5578, 1566721916587, 10379, 1566721916796, 10588, 209, true
5579, 1566721916587, 10379, 1566721916796, 10588, 209, true
5580, 1566721916588, 10380, 1566721916796, 10588, 208, true
5581, 1566721916589, 10381, 1566721916796, 10588, 207, true
5582, 1566721916592, 10384, 1566721916796, 10588, 204, true
5583, 1566721916595, 10387, 1566721916802, 10594, 207, true
5584, 1566721916597, 10389, 1566721916800, 10592, 203, true
5585, 1566721916599, 10391, 1566721916804, 10596, 205, true
5586, 1566721916600, 10392, 1566721916804, 10596, 204, true
5587, 1566721916601, 10393, 1566721916805, 10597, 204, true
5588, 1566721916603, 10395, 1566721916809, 10601, 206, true
5589, 1566721916604, 10396, 1566721916811, 10603, 207, true
5590, 1566721916608, 10400, 1566721916813, 10605, 205, true
5591, 1566721916610, 10402, 1566721916813, 10605, 203, true
5592, 1566721916612, 10404, 1566721916815, 10607, 203, true
5593, 1566721916614, 10406, 1566721916817, 10609, 203, true
5594, 1566721916615, 10407, 1566721916825, 10617, 210, true
5595, 1566721916617, 10409, 1566721916835, 10627, 218, true
5596, 1566721916637, 10429, 1566721916841, 10633, 204, true
5597, 1566721916647, 10439, 1566721916854, 10646, 207, true
5598, 1566721916648, 10440, 1566721916852, 10644, 204, true
5599, 1566721916650, 10442, 1566721916854, 10646, 204, true
5600, 1566721916651, 10443, 1566721916854, 10646, 203, true
5601, 1566721916652, 10444, 1566721916899, 10691, 247, true
5602, 1566721916685, 10477, 1566721916901, 10693, 216, true
5603, 1566721916702, 10494, 1566721916912, 10704, 210, true
5604, 1566721916713, 10505, 1566721916918, 10710, 205, true
5605, 1566721916718, 10510, 1566721916926, 10718, 208, true
5606, 1566721916718, 10510, 1566721916925, 10717, 207, true
5607, 1566721916719, 10511, 1566721916927, 10719, 208, true
5608, 1566721916719, 10511, 1566721916925, 10717, 206, true
5609, 1566721916719, 10511, 1566721916926, 10718, 207, true
5610, 1566721916719, 10511, 1566721916934, 10726, 215, true
5611, 1566721916720, 10512, 1566721916927, 10719, 207, true
5612, 1566721916720, 10512, 1566721916941, 10733, 221, true
5613, 1566721916721, 10513, 1566721916935, 10727, 214, true
5614, 1566721916721, 10513, 1566721916934, 10726, 213, true
5615, 1566721916722, 10514, 1566721916937, 10729, 215, true
5616, 1566721916723, 10515, 1566721916931, 10723, 208, true
5617, 1566721916723, 10515, 1566721916935, 10727, 212, true
5618, 1566721916725, 10517, 1566721916946, 10738, 221, true
5619, 1566721916736, 10528, 1566721916946, 10738, 210, true
5620, 1566721916737, 10529, 1566721916945, 10737, 208, true
5621, 1566721916737, 10529, 1566721916946, 10738, 209, true
5622, 1566721916737, 10529, 1566721916947, 10739, 210, true
5623, 1566721916737, 10529, 1566721916945, 10737, 208, true
5624, 1566721916738, 10530, 1566721916954, 10746, 216, true
5625, 1566721916738, 10530, 1566721916951, 10743, 213, true
5626, 1566721916739, 10531, 1566721916947, 10739, 208, true
5627, 1566721916745, 10537, 1566721916953, 10745, 208, true
5628, 1566721916746, 10538, 1566721916954, 10746, 208, true
5629, 1566721916750, 10542, 1566721916954, 10746, 204, true
5630, 1566721916750, 10542, 1566721916954, 10746, 204, true
5631, 1566721916752, 10544, 1566721916957, 10749, 205, true
5632, 1566721916752, 10544, 1566721916961, 10753, 209, true
5633, 1566721916752, 10544, 1566721916957, 10749, 205, true
5634, 1566721916753, 10545, 1566721916965, 10757, 212, true
5635, 1566721916756, 10548, 1566721916966, 10758, 210, true
5636, 1566721916756, 10548, 1566721916966, 10758, 210, true
5637, 1566721916756, 10548, 1566721916965, 10757, 209, true
5638, 1566721916757, 10549, 1566721916965, 10757, 208, true
5639, 1566721916757, 10549, 1566721916966, 10758, 209, true
5640, 1566721916757, 10549, 1566721916966, 10758, 209, true
5641, 1566721916757, 10549, 1566721916966, 10758, 209, true
5642, 1566721916759, 10551, 1566721916965, 10757, 206, true
5643, 1566721916759, 10551, 1566721916971, 10763, 212, true
5644, 1566721916762, 10554, 1566721916975, 10767, 213, true
5645, 1566721916762, 10554, 1566721916971, 10763, 209, true
5646, 1566721916763, 10555, 1566721916975, 10767, 212, true
5647, 1566721916765, 10557, 1566721916975, 10767, 210, true
5648, 1566721916766, 10558, 1566721916981, 10773, 215, true
5649, 1566721916766, 10558, 1566721916981, 10773, 215, true
5650, 1566721916772, 10564, 1566721916977, 10769, 205, true
5651, 1566721916772, 10564, 1566721916977, 10769, 205, true
5652, 1566721916773, 10565, 1566721916977, 10769, 204, true
5653, 1566721916773, 10565, 1566721916981, 10773, 208, true
5654, 1566721916773, 10565, 1566721916981, 10773, 208, true
5655, 1566721916776, 10568, 1566721916984, 10776, 208, true
5656, 1566721916776, 10568, 1566721916981, 10773, 205, true
5657, 1566721916777, 10569, 1566721916983, 10775, 206, true
5658, 1566721916778, 10570, 1566721916989, 10781, 211, true
5659, 1566721916779, 10571, 1566721916991, 10783, 212, true
5660, 1566721916785, 10577, 1566721916994, 10786, 209, true
5661, 1566721916790, 10582, 1566721916998, 10790, 208, true
5662, 1566721916791, 10583, 1566721916994, 10786, 203, true
5663, 1566721916792, 10584, 1566721917008, 10800, 216, true
5664, 1566721916792, 10584, 1566721917008, 10800, 216, true
5665, 1566721916792, 10584, 1566721917004, 10796, 212, true
5666, 1566721916793, 10585, 1566721917005, 10797, 212, true
5667, 1566721916796, 10588, 1566721917008, 10800, 212, true
5668, 1566721916796, 10588, 1566721917008, 10800, 212, true
5669, 1566721916797, 10589, 1566721917008, 10800, 211, true
5670, 1566721916797, 10589, 1566721917004, 10796, 207, true
5671, 1566721916798, 10590, 1566721917008, 10800, 210, true
5672, 1566721916798, 10590, 1566721917008, 10800, 210, true
5673, 1566721916799, 10591, 1566721917008, 10800, 209, true
5674, 1566721916800, 10592, 1566721917008, 10800, 208, true
5675, 1566721916802, 10594, 1566721917009, 10801, 207, true
5676, 1566721916806, 10598, 1566721917014, 10806, 208, true
5677, 1566721916806, 10598, 1566721917010, 10802, 204, true
5678, 1566721916806, 10598, 1566721917016, 10808, 210, true
5679, 1566721916806, 10598, 1566721917016, 10808, 210, true
5680, 1566721916806, 10598, 1566721917015, 10807, 209, true
5681, 1566721916807, 10599, 1566721917016, 10808, 209, true
5682, 1566721916808, 10600, 1566721917021, 10813, 213, true
5683, 1566721916808, 10600, 1566721917016, 10808, 208, true
5684, 1566721916811, 10603, 1566721917021, 10813, 210, true
5685, 1566721916815, 10607, 1566721917021, 10813, 206, true
5686, 1566721916815, 10607, 1566721917022, 10814, 207, true
5687, 1566721916816, 10608, 1566721917024, 10816, 208, true
5688, 1566721916818, 10610, 1566721917029, 10821, 211, true
5689, 1566721916820, 10612, 1566721917030, 10822, 210, true
5690, 1566721916822, 10614, 1566721917030, 10822, 208, true
5691, 1566721916827, 10619, 1566721917033, 10825, 206, true
5692, 1566721916828, 10620, 1566721917033, 10825, 205, true
5693, 1566721916829, 10621, 1566721917035, 10827, 206, true
5694, 1566721916831, 10623, 1566721917040, 10832, 209, true
5695, 1566721916834, 10626, 1566721917040, 10832, 206, true
5696, 1566721916837, 10629, 1566721917041, 10833, 204, true
5697, 1566721916839, 10631, 1566721917045, 10837, 206, true
5698, 1566721916840, 10632, 1566721917045, 10837, 205, true
5699, 1566721916842, 10634, 1566721917049, 10841, 207, true
5700, 1566721916843, 10635, 1566721917051, 10843, 208, true
5701, 1566721916844, 10636, 1566721917052, 10844, 208, true
5702, 1566721916844, 10636, 1566721917049, 10841, 205, true
5703, 1566721916845, 10637, 1566721917050, 10842, 205, true
5704, 1566721916845, 10637, 1566721917049, 10841, 204, true
5705, 1566721916845, 10637, 1566721917053, 10845, 208, true
5706, 1566721916846, 10638, 1566721917052, 10844, 206, true
5707, 1566721916847, 10639, 1566721917052, 10844, 205, true
5708, 1566721916848, 10640, 1566721917052, 10844, 204, true
5709, 1566721916850, 10642, 1566721917055, 10847, 205, true
5710, 1566721916851, 10643, 1566721917057, 10849, 206, true
5711, 1566721916851, 10643, 1566721917058, 10850, 207, true
5712, 1566721916855, 10647, 1566721917065, 10857, 210, true
5713, 1566721916855, 10647, 1566721917060, 10852, 205, true
5714, 1566721916856, 10648, 1566721917060, 10852, 204, true
5715, 1566721916856, 10648, 1566721917064, 10856, 208, true
5716, 1566721916856, 10648, 1566721917060, 10852, 204, true
5717, 1566721916859, 10651, 1566721917068, 10860, 209, true
5718, 1566721916860, 10652, 1566721917064, 10856, 204, true
5719, 1566721916860, 10652, 1566721917065, 10857, 205, true
5720, 1566721916860, 10652, 1566721917068, 10860, 208, true
5721, 1566721916862, 10654, 1566721917068, 10860, 206, true
5722, 1566721916863, 10655, 1566721917068, 10860, 205, true
5723, 1566721916864, 10656, 1566721917068, 10860, 204, true
5724, 1566721916865, 10657, 1566721917072, 10864, 207, true
5725, 1566721916866, 10658, 1566721917072, 10864, 206, true
5726, 1566721916866, 10658, 1566721917072, 10864, 206, true
5727, 1566721916867, 10659, 1566721917072, 10864, 205, true
5728, 1566721916868, 10660, 1566721917072, 10864, 204, true
5729, 1566721916870, 10662, 1566721917075, 10867, 205, true
5730, 1566721916870, 10662, 1566721917075, 10867, 205, true
5731, 1566721916871, 10663, 1566721917076, 10868, 205, true
5732, 1566721916871, 10663, 1566721917081, 10873, 210, true
5733, 1566721916872, 10664, 1566721917082, 10874, 210, true
5734, 1566721916873, 10665, 1566721917082, 10874, 209, true
5735, 1566721916875, 10667, 1566721917082, 10874, 207, true
5736, 1566721916877, 10669, 1566721917082, 10874, 205, true
5737, 1566721916879, 10671, 1566721917083, 10875, 204, true
5738, 1566721916879, 10671, 1566721917083, 10875, 204, true
5739, 1566721916880, 10672, 1566721917083, 10875, 203, true
5740, 1566721916881, 10673, 1566721917086, 10878, 205, true
5741, 1566721916882, 10674, 1566721917086, 10878, 204, true
5742, 1566721916884, 10676, 1566721917090, 10882, 206, true
5743, 1566721916885, 10677, 1566721917091, 10883, 206, true
5744, 1566721916885, 10677, 1566721917090, 10882, 205, true
5745, 1566721916885, 10677, 1566721917091, 10883, 206, true
5746, 1566721916885, 10677, 1566721917091, 10883, 206, true
5747, 1566721916886, 10678, 1566721917096, 10888, 210, true
5748, 1566721916888, 10680, 1566721917097, 10889, 209, true
5749, 1566721916889, 10681, 1566721917096, 10888, 207, true
5750, 1566721916891, 10683, 1566721917098, 10890, 207, true
5751, 1566721916892, 10684, 1566721917103, 10895, 211, true
5752, 1566721916893, 10685, 1566721917108, 10900, 215, true
5753, 1566721916893, 10685, 1566721917098, 10890, 205, true
5754, 1566721916893, 10685, 1566721917100, 10892, 207, true
5755, 1566721916894, 10686, 1566721917100, 10892, 206, true
5756, 1566721916895, 10687, 1566721917103, 10895, 208, true
5757, 1566721916895, 10687, 1566721917105, 10897, 210, true
5758, 1566721916896, 10688, 1566721917108, 10900, 212, true
5759, 1566721916897, 10689, 1566721917105, 10897, 208, true
5760, 1566721916898, 10690, 1566721917106, 10898, 208, true
5761, 1566721916900, 10692, 1566721917107, 10899, 207, true
5762, 1566721916902, 10694, 1566721917109, 10901, 207, true
5763, 1566721916902, 10694, 1566721917108, 10900, 206, true
5764, 1566721916903, 10695, 1566721917110, 10902, 207, true
5765, 1566721916906, 10698, 1566721917113, 10905, 207, true
5766, 1566721916906, 10698, 1566721917111, 10903, 205, true
5767, 1566721916907, 10699, 1566721917110, 10902, 203, true
5768, 1566721916907, 10699, 1566721917114, 10906, 207, true
5769, 1566721916913, 10705, 1566721917118, 10910, 205, true
5770, 1566721916914, 10706, 1566721917125, 10917, 211, true
5771, 1566721916915, 10707, 1566721917124, 10916, 209, true
5772, 1566721916915, 10707, 1566721917125, 10917, 210, true
5773, 1566721916916, 10708, 1566721917126, 10918, 210, true
5774, 1566721916918, 10710, 1566721917126, 10918, 208, true
5775, 1566721916919, 10711, 1566721917131, 10923, 212, true
5776, 1566721916919, 10711, 1566721917131, 10923, 212, true
5777, 1566721916920, 10712, 1566721917132, 10924, 212, true
5778, 1566721916921, 10713, 1566721917130, 10922, 209, true
5779, 1566721916922, 10714, 1566721917133, 10925, 211, true
5780, 1566721916922, 10714, 1566721917136, 10928, 214, true
5781, 1566721916922, 10714, 1566721917135, 10927, 213, true
5782, 1566721916923, 10715, 1566721917134, 10926, 211, true
5783, 1566721916923, 10715, 1566721917144, 10936, 221, true
5784, 1566721916923, 10715, 1566721917136, 10928, 213, true
5785, 1566721916927, 10719, 1566721917144, 10936, 217, true
5786, 1566721916931, 10723, 1566721917144, 10936, 213, true
5787, 1566721916935, 10727, 1566721917144, 10936, 209, true
5788, 1566721916936, 10728, 1566721917144, 10936, 208, true
5789, 1566721916936, 10728, 1566721917144, 10936, 208, true
5790, 1566721916938, 10730, 1566721917144, 10936, 206, true
5791, 1566721916940, 10732, 1566721917143, 10935, 203, true
5792, 1566721916941, 10733, 1566721917150, 10942, 209, true
5793, 1566721916941, 10733, 1566721917150, 10942, 209, true
5794, 1566721916942, 10734, 1566721917160, 10952, 218, true
5795, 1566721916942, 10734, 1566721917160, 10952, 218, true
5796, 1566721916942, 10734, 1566721917152, 10944, 210, true
5797, 1566721916943, 10735, 1566721917160, 10952, 217, true
5798, 1566721916947, 10739, 1566721917152, 10944, 205, true
5799, 1566721916948, 10740, 1566721917160, 10952, 212, true
5800, 1566721916948, 10740, 1566721917162, 10954, 214, true
5801, 1566721916949, 10741, 1566721917162, 10954, 213, true
5802, 1566721916949, 10741, 1566721917162, 10954, 213, true
5803, 1566721916951, 10743, 1566721917160, 10952, 209, true
5804, 1566721916957, 10749, 1566721917162, 10954, 205, true
5805, 1566721916958, 10750, 1566721917162, 10954, 204, true
5806, 1566721916958, 10750, 1566721917168, 10960, 210, true
5807, 1566721916959, 10751, 1566721917168, 10960, 209, true
5808, 1566721916959, 10751, 1566721917168, 10960, 209, true
5809, 1566721916960, 10752, 1566721917168, 10960, 208, true
5810, 1566721916962, 10754, 1566721917168, 10960, 206, true
5811, 1566721916962, 10754, 1566721917169, 10961, 207, true
5812, 1566721916989, 10781, 1566721917195, 10987, 206, true
5813, 1566721916991, 10783, 1566721917195, 10987, 204, true
5814, 1566721916993, 10785, 1566721917197, 10989, 204, true
5815, 1566721916995, 10787, 1566721917199, 10991, 204, true
5816, 1566721916996, 10788, 1566721917201, 10993, 205, true
5817, 1566721916997, 10789, 1566721917201, 10993, 204, true
5818, 1566721916999, 10791, 1566721917202, 10994, 203, true
5819, 1566721917000, 10792, 1566721917202, 10994, 202, true
5820, 1566721917001, 10793, 1566721917205, 10997, 204, true
5821, 1566721917002, 10794, 1566721917208, 11000, 206, true
5822, 1566721917011, 10803, 1566721917214, 11006, 203, true
5823, 1566721917013, 10805, 1566721917217, 11009, 204, true
5824, 1566721917017, 10809, 1566721917221, 11013, 204, true
5825, 1566721917018, 10810, 1566721917225, 11017, 207, true
5826, 1566721917019, 10811, 1566721917225, 11017, 206, true
5827, 1566721917030, 10822, 1566721917235, 11027, 205, true
5828, 1566721917032, 10824, 1566721917235, 11027, 203, true
5829, 1566721917034, 10826, 1566721917241, 11033, 207, true
5830, 1566721917036, 10828, 1566721917245, 11037, 209, true
5831, 1566721917037, 10829, 1566721917245, 11037, 208, true
5832, 1566721917038, 10830, 1566721917245, 11037, 207, true
5833, 1566721917038, 10830, 1566721917244, 11036, 206, true
5834, 1566721917042, 10834, 1566721917244, 11036, 202, true
5835, 1566721917043, 10835, 1566721917247, 11039, 204, true
5836, 1566721917044, 10836, 1566721917248, 11040, 204, true
5837, 1566721917046, 10838, 1566721917250, 11042, 204, true
5838, 1566721917047, 10839, 1566721917251, 11043, 204, true
5839, 1566721917055, 10847, 1566721917261, 11053, 206, true
5840, 1566721917057, 10849, 1566721917262, 11054, 205, true
5841, 1566721917061, 10853, 1566721917265, 11057, 204, true
5842, 1566721917062, 10854, 1566721917267, 11059, 205, true
5843, 1566721917069, 10861, 1566721917273, 11065, 204, true
5844, 1566721917073, 10865, 1566721917277, 11069, 204, true
5845, 1566721917077, 10869, 1566721917279, 11071, 202, true
5846, 1566721917078, 10870, 1566721917286, 11078, 208, true
5847, 1566721917079, 10871, 1566721917286, 11078, 207, true
5848, 1566721917084, 10876, 1566721917290, 11082, 206, true
5849, 1566721917087, 10879, 1566721917290, 11082, 203, true
5850, 1566721917088, 10880, 1566721917292, 11084, 204, true
5851, 1566721917091, 10883, 1566721917295, 11087, 204, true
5852, 1566721917092, 10884, 1566721917371, 11163, 279, true
5853, 1566721917093, 10885, 1566721917304, 11096, 211, true
5854, 1566721917093, 10885, 1566721917492, 11284, 399, true
5855, 1566721917093, 10885, 1566721917494, 11286, 401, true
5856, 1566721917094, 10886, 1566721917486, 11278, 392, true
5857, 1566721917094, 10886, 1566721917485, 11277, 391, true
5858, 1566721917094, 10886, 1566721917478, 11270, 384, true
5859, 1566721917095, 10887, 1566721917488, 11280, 393, true
5860, 1566721917096, 10888, 1566721917400, 11192, 304, true
5861, 1566721917097, 10889, 1566721917387, 11179, 290, true
5862, 1566721917097, 10889, 1566721917479, 11271, 382, true
5863, 1566721917097, 10889, 1566721917512, 11304, 415, true
5864, 1566721917099, 10891, 1566721917402, 11194, 303, true
5865, 1566721917099, 10891, 1566721917390, 11182, 291, true
5866, 1566721917099, 10891, 1566721917400, 11192, 301, true
5867, 1566721917100, 10892, 1566721917403, 11195, 303, true
5868, 1566721917101, 10893, 1566721917400, 11192, 299, true
5869, 1566721917101, 10893, 1566721917400, 11192, 299, true
5870, 1566721917101, 10893, 1566721917483, 11275, 382, true
5871, 1566721917101, 10893, 1566721917400, 11192, 299, true
5872, 1566721917102, 10894, 1566721917483, 11275, 381, true
5873, 1566721917103, 10895, 1566721917479, 11271, 376, true
5874, 1566721917104, 10896, 1566721917403, 11195, 299, true
5875, 1566721917104, 10896, 1566721917484, 11276, 380, true
5876, 1566721917105, 10897, 1566721917485, 11277, 380, true
5877, 1566721917106, 10898, 1566721917488, 11280, 382, true
5878, 1566721917106, 10898, 1566721917482, 11274, 376, true
5879, 1566721917106, 10898, 1566721917395, 11187, 289, true
5880, 1566721917107, 10899, 1566721917487, 11279, 380, true
5881, 1566721917108, 10900, 1566721917489, 11281, 381, true
5882, 1566721917108, 10900, 1566721917490, 11282, 382, true
5883, 1566721917110, 10902, 1566721917482, 11274, 372, true
5884, 1566721917110, 10902, 1566721917483, 11275, 373, true
5885, 1566721917110, 10902, 1566721917488, 11280, 378, true
5886, 1566721917111, 10903, 1566721917390, 11182, 279, true
5887, 1566721917111, 10903, 1566721917402, 11194, 291, true
5888, 1566721917112, 10904, 1566721917477, 11269, 365, true
5889, 1566721917112, 10904, 1566721917498, 11290, 386, true
5890, 1566721917113, 10905, 1566721917486, 11278, 373, true
5891, 1566721917114, 10906, 1566721917487, 11279, 373, true
5892, 1566721917114, 10906, 1566721917482, 11274, 368, true
5893, 1566721917114, 10906, 1566721917483, 11275, 369, true
5894, 1566721917115, 10907, 1566721917477, 11269, 362, true
5895, 1566721917115, 10907, 1566721917402, 11194, 287, true
5896, 1566721917115, 10907, 1566721917483, 11275, 368, true
5897, 1566721917115, 10907, 1566721917496, 11288, 381, true
5898, 1566721917116, 10908, 1566721917403, 11195, 287, true
5899, 1566721917116, 10908, 1566721917477, 11269, 361, true
5900, 1566721917116, 10908, 1566721917400, 11192, 284, true
5901, 1566721917116, 10908, 1566721917495, 11287, 379, true
5902, 1566721917117, 10909, 1566721917400, 11192, 283, true
5903, 1566721917118, 10910, 1566721917394, 11186, 276, true
5904, 1566721917118, 10910, 1566721917479, 11271, 361, true
5905, 1566721917118, 10910, 1566721917395, 11187, 277, true
5906, 1566721917119, 10911, 1566721917480, 11272, 361, true
5907, 1566721917119, 10911, 1566721917403, 11195, 284, true
5908, 1566721917119, 10911, 1566721917402, 11194, 283, true
5909, 1566721917119, 10911, 1566721917479, 11271, 360, true
5910, 1566721917120, 10912, 1566721917487, 11279, 367, true
5911, 1566721917120, 10912, 1566721917396, 11188, 276, true
5912, 1566721917120, 10912, 1566721917476, 11268, 356, true
5913, 1566721917120, 10912, 1566721917478, 11270, 358, true
5914, 1566721917121, 10913, 1566721917403, 11195, 282, true
5915, 1566721917121, 10913, 1566721917477, 11269, 356, true
5916, 1566721917121, 10913, 1566721917480, 11272, 359, true
5917, 1566721917122, 10914, 1566721917403, 11195, 281, true
5918, 1566721917122, 10914, 1566721917484, 11276, 362, true
5919, 1566721917122, 10914, 1566721917403, 11195, 281, true
5920, 1566721917123, 10915, 1566721917494, 11286, 371, true
5921, 1566721917124, 10916, 1566721917477, 11269, 353, true
5922, 1566721917125, 10917, 1566721917481, 11273, 356, true
5923, 1566721917125, 10917, 1566721917400, 11192, 275, true
5924, 1566721917126, 10918, 1566721917477, 11269, 351, true
5925, 1566721917126, 10918, 1566721917491, 11283, 365, true
5926, 1566721917127, 10919, 1566721917511, 11303, 384, true
5927, 1566721917127, 10919, 1566721917489, 11281, 362, true
5928, 1566721917127, 10919, 1566721917497, 11289, 370, true
5929, 1566721917127, 10919, 1566721917477, 11269, 350, true
5930, 1566721917128, 10920, 1566721917479, 11271, 351, true
5931, 1566721917128, 10920, 1566721917480, 11272, 352, true
5932, 1566721917128, 10920, 1566721917477, 11269, 349, true
5933, 1566721917128, 10920, 1566721917483, 11275, 355, true
5934, 1566721917129, 10921, 1566721917486, 11278, 357, true
5935, 1566721917130, 10922, 1566721917403, 11195, 273, true
5936, 1566721917131, 10923, 1566721917502, 11294, 371, true
5937, 1566721917131, 10923, 1566721917492, 11284, 361, true
5938, 1566721917132, 10924, 1566721917497, 11289, 365, true
5939, 1566721917132, 10924, 1566721917477, 11269, 345, true
5940, 1566721917133, 10925, 1566721917480, 11272, 347, true
5941, 1566721917134, 10926, 1566721917477, 11269, 343, true
5942, 1566721917134, 10926, 1566721917495, 11287, 361, true
5943, 1566721917134, 10926, 1566721917479, 11271, 345, true
5944, 1566721917135, 10927, 1566721917489, 11281, 354, true
5945, 1566721917136, 10928, 1566721917479, 11271, 343, true
5946, 1566721917136, 10928, 1566721917478, 11270, 342, true
5947, 1566721917137, 10929, 1566721917476, 11268, 339, true
5948, 1566721917137, 10929, 1566721917497, 11289, 360, true
5949, 1566721917137, 10929, 1566721917471, 11263, 334, true
5950, 1566721917137, 10929, 1566721917476, 11268, 339, true
5951, 1566721917138, 10930, 1566721917467, 11259, 329, true
5952, 1566721917138, 10930, 1566721917474, 11266, 336, true
5953, 1566721917138, 10930, 1566721917474, 11266, 336, true
5954, 1566721917138, 10930, 1566721917473, 11265, 335, true
5955, 1566721917138, 10930, 1566721917472, 11264, 334, true
5956, 1566721917138, 10930, 1566721917479, 11271, 341, true
5957, 1566721917138, 10930, 1566721917482, 11274, 344, true
5958, 1566721917139, 10931, 1566721917482, 11274, 343, true
5959, 1566721917139, 10931, 1566721917482, 11274, 343, true
5960, 1566721917139, 10931, 1566721917494, 11286, 355, true
5961, 1566721917139, 10931, 1566721917400, 11192, 261, true
5962, 1566721917139, 10931, 1566721917486, 11278, 347, true
5963, 1566721917139, 10931, 1566721917478, 11270, 339, true
5964, 1566721917139, 10931, 1566721917502, 11294, 363, true
5965, 1566721917139, 10931, 1566721917489, 11281, 350, true
5966, 1566721917139, 10931, 1566721917477, 11269, 338, true
5967, 1566721917139, 10931, 1566721917477, 11269, 338, true
5968, 1566721917144, 10936, 1566721917481, 11273, 337, true
5969, 1566721917144, 10936, 1566721917476, 11268, 332, true
5970, 1566721917144, 10936, 1566721917476, 11268, 332, true
5971, 1566721917144, 10936, 1566721917483, 11275, 339, true
5972, 1566721917145, 10937, 1566721917477, 11269, 332, true
5973, 1566721917145, 10937, 1566721917472, 11264, 327, true
5974, 1566721917146, 10938, 1566721917476, 11268, 330, true
5975, 1566721917146, 10938, 1566721917402, 11194, 256, true
5976, 1566721917147, 10939, 1566721917482, 11274, 335, true
5977, 1566721917148, 10940, 1566721917472, 11264, 324, true
5978, 1566721917149, 10941, 1566721917475, 11267, 326, true
5979, 1566721917151, 10943, 1566721917479, 11271, 328, true
5980, 1566721917152, 10944, 1566721917487, 11279, 335, true
5981, 1566721917153, 10945, 1566721917482, 11274, 329, true
5982, 1566721917154, 10946, 1566721917469, 11261, 315, true
5983, 1566721917154, 10946, 1566721917481, 11273, 327, true
5984, 1566721917154, 10946, 1566721917506, 11298, 352, true
5985, 1566721917154, 10946, 1566721917470, 11262, 316, true
5986, 1566721917155, 10947, 1566721917476, 11268, 321, true
5987, 1566721917155, 10947, 1566721917473, 11265, 318, true
5988, 1566721917155, 10947, 1566721917475, 11267, 320, true
5989, 1566721917163, 10955, 1566721917477, 11269, 314, true
5990, 1566721917164, 10956, 1566721917498, 11290, 334, true
5991, 1566721917164, 10956, 1566721917488, 11280, 324, true
5992, 1566721917164, 10956, 1566721917477, 11269, 313, true
5993, 1566721917169, 10961, 1566721917476, 11268, 307, true
5994, 1566721917170, 10962, 1566721917472, 11264, 302, true
5995, 1566721917170, 10962, 1566721917482, 11274, 312, true
5996, 1566721917171, 10963, 1566721917473, 11265, 302, true
5997, 1566721917171, 10963, 1566721917475, 11267, 304, true
5998, 1566721917171, 10963, 1566721917470, 11262, 299, true
5999, 1566721917172, 10964, 1566721917476, 11268, 304, true
6000, 1566721917172, 10964, 1566721917469, 11261, 297, true
6001, 1566721917173, 10965, 1566721917475, 11267, 302, true
6002, 1566721917173, 10965, 1566721917474, 11266, 301, true
6003, 1566721917173, 10965, 1566721917473, 11265, 300, true
6004, 1566721917174, 10966, 1566721917474, 11266, 300, true
6005, 1566721917174, 10966, 1566721917470, 11262, 296, true
6006, 1566721917174, 10966, 1566721917480, 11272, 306, true
6007, 1566721917175, 10967, 1566721917473, 11265, 298, true
6008, 1566721917176, 10968, 1566721917476, 11268, 300, true
6009, 1566721917176, 10968, 1566721917475, 11267, 299, true
6010, 1566721917176, 10968, 1566721917475, 11267, 299, true
6011, 1566721917177, 10969, 1566721917476, 11268, 299, true
6012, 1566721917177, 10969, 1566721917476, 11268, 299, true
6013, 1566721917177, 10969, 1566721917470, 11262, 293, true
6014, 1566721917178, 10970, 1566721917481, 11273, 303, true
6015, 1566721917179, 10971, 1566721917473, 11265, 294, true
6016, 1566721917179, 10971, 1566721917470, 11262, 291, true
6017, 1566721917180, 10972, 1566721917468, 11260, 288, true
6018, 1566721917181, 10973, 1566721917470, 11262, 289, true
6019, 1566721917181, 10973, 1566721917505, 11297, 324, true
6020, 1566721917182, 10974, 1566721917475, 11267, 293, true
6021, 1566721917185, 10977, 1566721917471, 11263, 286, true
6022, 1566721917187, 10979, 1566721917478, 11270, 291, true
6023, 1566721917188, 10980, 1566721917472, 11264, 284, true
6024, 1566721917199, 10991, 1566721917478, 11270, 279, true
6025, 1566721917205, 10997, 1566721917479, 11271, 274, true
6026, 1566721917211, 11003, 1566721917471, 11263, 260, true
6027, 1566721917221, 11013, 1566721917482, 11274, 261, true
6028, 1566721917225, 11017, 1566721917471, 11263, 246, true
6029, 1566721917226, 11018, 1566721917471, 11263, 245, true
6030, 1566721917228, 11020, 1566721917479, 11271, 251, true
6031, 1566721917228, 11020, 1566721917477, 11269, 249, true
6032, 1566721917229, 11021, 1566721917471, 11263, 242, true
6033, 1566721917229, 11021, 1566721917472, 11264, 243, true
6034, 1566721917231, 11023, 1566721917490, 11282, 259, true
6035, 1566721917232, 11024, 1566721917488, 11280, 256, true
6036, 1566721917232, 11024, 1566721917492, 11284, 260, true
6037, 1566721917233, 11025, 1566721917486, 11278, 253, true
6038, 1566721917233, 11025, 1566721917491, 11283, 258, true
6039, 1566721917233, 11025, 1566721917491, 11283, 258, true
6040, 1566721917234, 11026, 1566721917490, 11282, 256, true
6041, 1566721917235, 11027, 1566721917484, 11276, 249, true
6042, 1566721917236, 11028, 1566721917489, 11281, 253, true
6043, 1566721917236, 11028, 1566721917481, 11273, 245, true
6044, 1566721917245, 11037, 1566721917483, 11275, 238, true
6045, 1566721917247, 11039, 1566721917486, 11278, 239, true
6046, 1566721917253, 11045, 1566721917485, 11277, 232, true
6047, 1566721917254, 11046, 1566721917484, 11276, 230, true
6048, 1566721917254, 11046, 1566721917489, 11281, 235, true
6049, 1566721917255, 11047, 1566721917483, 11275, 228, true
6050, 1566721917256, 11048, 1566721917481, 11273, 225, true
6051, 1566721917256, 11048, 1566721917486, 11278, 230, true
6052, 1566721917267, 11059, 1566721917488, 11280, 221, true
6053, 1566721917268, 11060, 1566721917492, 11284, 224, true
6054, 1566721917269, 11061, 1566721917494, 11286, 225, true
6055, 1566721917269, 11061, 1566721917494, 11286, 225, true
6056, 1566721917270, 11062, 1566721917493, 11285, 223, true
6057, 1566721917271, 11063, 1566721917494, 11286, 223, true
6058, 1566721917272, 11064, 1566721917495, 11287, 223, true
6059, 1566721917272, 11064, 1566721917494, 11286, 222, true
6060, 1566721917274, 11066, 1566721917495, 11287, 221, true
6061, 1566721917275, 11067, 1566721917496, 11288, 221, true
6062, 1566721917275, 11067, 1566721917496, 11288, 221, true
6063, 1566721917278, 11070, 1566721917497, 11289, 219, true
6064, 1566721917279, 11071, 1566721917500, 11292, 221, true
6065, 1566721917281, 11073, 1566721917498, 11290, 217, true
6066, 1566721917282, 11074, 1566721917498, 11290, 216, true
6067, 1566721917282, 11074, 1566721917497, 11289, 215, true
6068, 1566721917282, 11074, 1566721917500, 11292, 218, true
6069, 1566721917284, 11076, 1566721917501, 11293, 217, true
6070, 1566721917286, 11078, 1566721917501, 11293, 215, true
6071, 1566721917287, 11079, 1566721917505, 11297, 218, true
6072, 1566721917287, 11079, 1566721917502, 11294, 215, true
6073, 1566721917290, 11082, 1566721917505, 11297, 215, true
6074, 1566721917290, 11082, 1566721917505, 11297, 215, true
6075, 1566721917291, 11083, 1566721917505, 11297, 214, true
6076, 1566721917292, 11084, 1566721917505, 11297, 213, true
6077, 1566721917293, 11085, 1566721917505, 11297, 212, true
6078, 1566721917294, 11086, 1566721917505, 11297, 211, true
6079, 1566721917295, 11087, 1566721917505, 11297, 210, true
6080, 1566721917296, 11088, 1566721917505, 11297, 209, true
6081, 1566721917297, 11089, 1566721917508, 11300, 211, true
6082, 1566721917297, 11089, 1566721917505, 11297, 208, true
6083, 1566721917297, 11089, 1566721917508, 11300, 211, true
6084, 1566721917298, 11090, 1566721917509, 11301, 211, true
6085, 1566721917298, 11090, 1566721917508, 11300, 210, true
6086, 1566721917298, 11090, 1566721917505, 11297, 207, true
6087, 1566721917299, 11091, 1566721917509, 11301, 210, true
6088, 1566721917300, 11092, 1566721917509, 11301, 209, true
6089, 1566721917302, 11094, 1566721917510, 11302, 208, true
6090, 1566721917305, 11097, 1566721917515, 11307, 210, true
6091, 1566721917305, 11097, 1566721917514, 11306, 209, true
6092, 1566721917305, 11097, 1566721917514, 11306, 209, true
6093, 1566721917306, 11098, 1566721917519, 11311, 213, true
6094, 1566721917306, 11098, 1566721917534, 11326, 228, true
6095, 1566721917306, 11098, 1566721917515, 11307, 209, true
6096, 1566721917307, 11099, 1566721917513, 11305, 206, true
6097, 1566721917308, 11100, 1566721917521, 11313, 213, true
6098, 1566721917309, 11101, 1566721917529, 11321, 220, true
6099, 1566721917310, 11102, 1566721917521, 11313, 211, true
6100, 1566721917311, 11103, 1566721917530, 11322, 219, true
6101, 1566721917312, 11104, 1566721917521, 11313, 209, true
6102, 1566721917314, 11106, 1566721917530, 11322, 216, true
6103, 1566721917315, 11107, 1566721917535, 11327, 220, true
6104, 1566721917316, 11108, 1566721917536, 11328, 220, true
6105, 1566721917317, 11109, 1566721917534, 11326, 217, true
6106, 1566721917318, 11110, 1566721917536, 11328, 218, true
6107, 1566721917319, 11111, 1566721917536, 11328, 217, true
6108, 1566721917321, 11113, 1566721917551, 11343, 230, true
6109, 1566721917322, 11114, 1566721917551, 11343, 229, true
6110, 1566721917323, 11115, 1566721917551, 11343, 228, true
6111, 1566721917324, 11116, 1566721917551, 11343, 227, true
6112, 1566721917325, 11117, 1566721917551, 11343, 226, true
6113, 1566721917326, 11118, 1566721917551, 11343, 225, true
6114, 1566721917327, 11119, 1566721917551, 11343, 224, true
6115, 1566721917329, 11121, 1566721917552, 11344, 223, true
6116, 1566721917330, 11122, 1566721917586, 11378, 256, true
6117, 1566721917331, 11123, 1566721917552, 11344, 221, true
6118, 1566721917332, 11124, 1566721917552, 11344, 220, true
6119, 1566721917333, 11125, 1566721917557, 11349, 224, true
6120, 1566721917334, 11126, 1566721917560, 11352, 226, true
6121, 1566721917334, 11126, 1566721917557, 11349, 223, true
6122, 1566721917334, 11126, 1566721917554, 11346, 220, true
6123, 1566721917335, 11127, 1566721917556, 11348, 221, true
6124, 1566721917335, 11127, 1566721917555, 11347, 220, true
6125, 1566721917335, 11127, 1566721917554, 11346, 219, true
6126, 1566721917335, 11127, 1566721917555, 11347, 220, true
6127, 1566721917336, 11128, 1566721917556, 11348, 220, true
6128, 1566721917336, 11128, 1566721917557, 11349, 221, true
6129, 1566721917336, 11128, 1566721917558, 11350, 222, true
6130, 1566721917336, 11128, 1566721917559, 11351, 223, true
6131, 1566721917337, 11129, 1566721917558, 11350, 221, true
6132, 1566721917337, 11129, 1566721917555, 11347, 218, true
6133, 1566721917338, 11130, 1566721917557, 11349, 219, true
6134, 1566721917338, 11130, 1566721917558, 11350, 220, true
6135, 1566721917338, 11130, 1566721917558, 11350, 220, true
6136, 1566721917339, 11131, 1566721917556, 11348, 217, true
6137, 1566721917339, 11131, 1566721917559, 11351, 220, true
6138, 1566721917339, 11131, 1566721917555, 11347, 216, true
6139, 1566721917340, 11132, 1566721917557, 11349, 217, true
6140, 1566721917347, 11139, 1566721917578, 11370, 231, true
6141, 1566721917348, 11140, 1566721917578, 11370, 230, true
6142, 1566721917348, 11140, 1566721917578, 11370, 230, true
6143, 1566721917349, 11141, 1566721917578, 11370, 229, true
6144, 1566721917349, 11141, 1566721917590, 11382, 241, true
6145, 1566721917351, 11143, 1566721917579, 11371, 228, true
6146, 1566721917357, 11149, 1566721917578, 11370, 221, true
6147, 1566721917361, 11153, 1566721917578, 11370, 217, true
6148, 1566721917361, 11153, 1566721917578, 11370, 217, true
6149, 1566721917362, 11154, 1566721917578, 11370, 216, true
6150, 1566721917363, 11155, 1566721917578, 11370, 215, true
6151, 1566721917364, 11156, 1566721917578, 11370, 214, true
6152, 1566721917365, 11157, 1566721917578, 11370, 213, true
6153, 1566721917367, 11159, 1566721917578, 11370, 211, true
6154, 1566721917367, 11159, 1566721917578, 11370, 211, true
6155, 1566721917368, 11160, 1566721917581, 11373, 213, true
6156, 1566721917372, 11164, 1566721917582, 11374, 210, true
6157, 1566721917373, 11165, 1566721917582, 11374, 209, true
6158, 1566721917375, 11167, 1566721917582, 11374, 207, true
6159, 1566721917376, 11168, 1566721917583, 11375, 207, true
6160, 1566721917378, 11170, 1566721917590, 11382, 212, true
6161, 1566721917380, 11172, 1566721917590, 11382, 210, true
6162, 1566721917384, 11176, 1566721917595, 11387, 211, true
6163, 1566721917385, 11177, 1566721917738, 11530, 353, true
6164, 1566721917385, 11177, 1566721917764, 11556, 379, true
6165, 1566721917385, 11177, 1566721917764, 11556, 379, true
6166, 1566721917386, 11178, 1566721917766, 11558, 380, true
6167, 1566721917387, 11179, 1566721917726, 11518, 339, true
6168, 1566721917388, 11180, 1566721917765, 11557, 377, true
6169, 1566721917388, 11180, 1566721917738, 11530, 350, true
6170, 1566721917389, 11181, 1566721917791, 11583, 402, true
6171, 1566721917390, 11182, 1566721917743, 11535, 353, true
6172, 1566721917390, 11182, 1566721917737, 11529, 347, true
6173, 1566721917391, 11183, 1566721917786, 11578, 395, true
6174, 1566721917391, 11183, 1566721917786, 11578, 395, true
6175, 1566721917391, 11183, 1566721917784, 11576, 393, true
6176, 1566721917391, 11183, 1566721917791, 11583, 400, true
6177, 1566721917392, 11184, 1566721917784, 11576, 392, true
6178, 1566721917392, 11184, 1566721917791, 11583, 399, true
6179, 1566721917393, 11185, 1566721917776, 11568, 383, true
6180, 1566721917393, 11185, 1566721917795, 11587, 402, true
6181, 1566721917395, 11187, 1566721917726, 11518, 331, true
6182, 1566721917395, 11187, 1566721917727, 11519, 332, true
6183, 1566721917396, 11188, 1566721917726, 11518, 330, true
6184, 1566721917403, 11195, 1566721917737, 11529, 334, true
6185, 1566721917403, 11195, 1566721917738, 11530, 335, true
6186, 1566721917405, 11197, 1566721917737, 11529, 332, true
6187, 1566721917405, 11197, 1566721917783, 11575, 378, true
6188, 1566721917405, 11197, 1566721917791, 11583, 386, true
6189, 1566721917406, 11198, 1566721917793, 11585, 387, true
6190, 1566721917406, 11198, 1566721917736, 11528, 330, true
6191, 1566721917406, 11198, 1566721917765, 11557, 359, true
6192, 1566721917406, 11198, 1566721917766, 11558, 360, true
6193, 1566721917406, 11198, 1566721917783, 11575, 377, true
6194, 1566721917406, 11198, 1566721917771, 11563, 365, true
6195, 1566721917406, 11198, 1566721917766, 11558, 360, true
6196, 1566721917406, 11198, 1566721917765, 11557, 359, true
6197, 1566721917406, 11198, 1566721917766, 11558, 360, true
6198, 1566721917406, 11198, 1566721917770, 11562, 364, true
6199, 1566721917407, 11199, 1566721917743, 11535, 336, true
6200, 1566721917407, 11199, 1566721917764, 11556, 357, true
6201, 1566721917407, 11199, 1566721917767, 11559, 360, true
6202, 1566721917407, 11199, 1566721917766, 11558, 359, true
6203, 1566721917407, 11199, 1566721917765, 11557, 358, true
6204, 1566721917407, 11199, 1566721917764, 11556, 357, true
6205, 1566721917407, 11199, 1566721917766, 11558, 359, true
6206, 1566721917408, 11200, 1566721917770, 11562, 362, true
6207, 1566721917408, 11200, 1566721917765, 11557, 357, true
6208, 1566721917408, 11200, 1566721917765, 11557, 357, true
6209, 1566721917408, 11200, 1566721917774, 11566, 366, true
6210, 1566721917408, 11200, 1566721917743, 11535, 335, true
6211, 1566721917409, 11201, 1566721917746, 11538, 337, true
6212, 1566721917409, 11201, 1566721917743, 11535, 334, true
6213, 1566721917409, 11201, 1566721917787, 11579, 378, true
6214, 1566721917410, 11202, 1566721917746, 11538, 336, true
6215, 1566721917410, 11202, 1566721917744, 11536, 334, true
6216, 1566721917410, 11202, 1566721917747, 11539, 337, true
6217, 1566721917411, 11203, 1566721917774, 11566, 363, true
6218, 1566721917411, 11203, 1566721917763, 11555, 352, true
6219, 1566721917411, 11203, 1566721917765, 11557, 354, true
6220, 1566721917411, 11203, 1566721917765, 11557, 354, true
6221, 1566721917412, 11204, 1566721917743, 11535, 331, true
6222, 1566721917412, 11204, 1566721917747, 11539, 335, true
6223, 1566721917412, 11204, 1566721917793, 11585, 381, true
6224, 1566721917412, 11204, 1566721917773, 11565, 361, true
6225, 1566721917413, 11205, 1566721917767, 11559, 354, true
6226, 1566721917413, 11205, 1566721917772, 11564, 359, true
6227, 1566721917413, 11205, 1566721917763, 11555, 350, true
6228, 1566721917413, 11205, 1566721917765, 11557, 352, true
6229, 1566721917414, 11206, 1566721917763, 11555, 349, true
6230, 1566721917414, 11206, 1566721917769, 11561, 355, true
6231, 1566721917414, 11206, 1566721917783, 11575, 369, true
6232, 1566721917415, 11207, 1566721917793, 11585, 378, true
6233, 1566721917415, 11207, 1566721917765, 11557, 350, true
6234, 1566721917415, 11207, 1566721917769, 11561, 354, true
6235, 1566721917415, 11207, 1566721917769, 11561, 354, true
6236, 1566721917416, 11208, 1566721917746, 11538, 330, true
6237, 1566721917416, 11208, 1566721917783, 11575, 367, true
6238, 1566721917416, 11208, 1566721917769, 11561, 353, true
6239, 1566721917416, 11208, 1566721917764, 11556, 348, true
6240, 1566721917417, 11209, 1566721917764, 11556, 347, true
6241, 1566721917417, 11209, 1566721917765, 11557, 348, true
6242, 1566721917417, 11209, 1566721917764, 11556, 347, true
6243, 1566721917417, 11209, 1566721917766, 11558, 349, true
6244, 1566721917418, 11210, 1566721917772, 11564, 354, true
6245, 1566721917418, 11210, 1566721917766, 11558, 348, true
6246, 1566721917418, 11210, 1566721917753, 11545, 335, true
6247, 1566721917418, 11210, 1566721917764, 11556, 346, true
6248, 1566721917419, 11211, 1566721917764, 11556, 345, true
6249, 1566721917419, 11211, 1566721917767, 11559, 348, true
6250, 1566721917419, 11211, 1566721917753, 11545, 334, true
6251, 1566721917419, 11211, 1566721917753, 11545, 334, true
6252, 1566721917419, 11211, 1566721917772, 11564, 353, true
6253, 1566721917420, 11212, 1566721917743, 11535, 323, true
6254, 1566721917420, 11212, 1566721917764, 11556, 344, true
6255, 1566721917420, 11212, 1566721917784, 11576, 364, true
6256, 1566721917421, 11213, 1566721917784, 11576, 363, true
6257, 1566721917421, 11213, 1566721917773, 11565, 352, true
6258, 1566721917421, 11213, 1566721917764, 11556, 343, true
6259, 1566721917422, 11214, 1566721917793, 11585, 371, true
6260, 1566721917422, 11214, 1566721917767, 11559, 345, true
6261, 1566721917422, 11214, 1566721917747, 11539, 325, true
6262, 1566721917423, 11215, 1566721917767, 11559, 344, true
6263, 1566721917423, 11215, 1566721917744, 11536, 321, true
6264, 1566721917423, 11215, 1566721917763, 11555, 340, true
6265, 1566721917424, 11216, 1566721917769, 11561, 345, true
6266, 1566721917424, 11216, 1566721917763, 11555, 339, true
6267, 1566721917424, 11216, 1566721917764, 11556, 340, true
6268, 1566721917425, 11217, 1566721917764, 11556, 339, true
6269, 1566721917425, 11217, 1566721917767, 11559, 342, true
6270, 1566721917425, 11217, 1566721917769, 11561, 344, true
6271, 1566721917426, 11218, 1566721917766, 11558, 340, true
6272, 1566721917426, 11218, 1566721917764, 11556, 338, true
6273, 1566721917426, 11218, 1566721917766, 11558, 340, true
6274, 1566721917427, 11219, 1566721917783, 11575, 356, true
6275, 1566721917427, 11219, 1566721917765, 11557, 338, true
6276, 1566721917427, 11219, 1566721917766, 11558, 339, true
6277, 1566721917428, 11220, 1566721917765, 11557, 337, true
6278, 1566721917428, 11220, 1566721917790, 11582, 362, true
6279, 1566721917428, 11220, 1566721917765, 11557, 337, true
6280, 1566721917428, 11220, 1566721917783, 11575, 355, true
6281, 1566721917429, 11221, 1566721917783, 11575, 354, true
6282, 1566721917429, 11221, 1566721917785, 11577, 356, true
6283, 1566721917429, 11221, 1566721917783, 11575, 354, true
6284, 1566721917429, 11221, 1566721917792, 11584, 363, true
6285, 1566721917430, 11222, 1566721917791, 11583, 361, true
6286, 1566721917430, 11222, 1566721917766, 11558, 336, true
6287, 1566721917430, 11222, 1566721917764, 11556, 334, true
6288, 1566721917431, 11223, 1566721917766, 11558, 335, true
6289, 1566721917431, 11223, 1566721917783, 11575, 352, true
6290, 1566721917432, 11224, 1566721917766, 11558, 334, true
6291, 1566721917433, 11225, 1566721917794, 11586, 361, true
6292, 1566721917433, 11225, 1566721917793, 11585, 360, true
6293, 1566721917438, 11230, 1566721917794, 11586, 356, true
6294, 1566721917440, 11232, 1566721917771, 11563, 331, true
6295, 1566721917440, 11232, 1566721917770, 11562, 330, true
6296, 1566721917441, 11233, 1566721917791, 11583, 350, true
6297, 1566721917441, 11233, 1566721917767, 11559, 326, true
6298, 1566721917441, 11233, 1566721917770, 11562, 329, true
6299, 1566721917442, 11234, 1566721917798, 11590, 356, true
6300, 1566721917442, 11234, 1566721917742, 11534, 300, true
6301, 1566721917448, 11240, 1566721917769, 11561, 321, true
6302, 1566721917449, 11241, 1566721917791, 11583, 342, true
6303, 1566721917450, 11242, 1566721917737, 11529, 287, true
6304, 1566721917450, 11242, 1566721917786, 11578, 336, true
6305, 1566721917451, 11243, 1566721917792, 11584, 341, true
6306, 1566721917451, 11243, 1566721917785, 11577, 334, true
6307, 1566721917451, 11243, 1566721917790, 11582, 339, true
6308, 1566721917451, 11243, 1566721917787, 11579, 336, true
6309, 1566721917452, 11244, 1566721917743, 11535, 291, true
6310, 1566721917453, 11245, 1566721917791, 11583, 338, true
6311, 1566721917453, 11245, 1566721917791, 11583, 338, true
6312, 1566721917453, 11245, 1566721917790, 11582, 337, true
6313, 1566721917454, 11246, 1566721917784, 11576, 330, true
6314, 1566721917454, 11246, 1566721917791, 11583, 337, true
6315, 1566721917454, 11246, 1566721917784, 11576, 330, true
6316, 1566721917455, 11247, 1566721917742, 11534, 287, true
6317, 1566721917455, 11247, 1566721917777, 11569, 322, true
6318, 1566721917455, 11247, 1566721917737, 11529, 282, true
6319, 1566721917456, 11248, 1566721917786, 11578, 330, true
6320, 1566721917456, 11248, 1566721917738, 11530, 282, true
6321, 1566721917457, 11249, 1566721917742, 11534, 285, true
6322, 1566721917457, 11249, 1566721917787, 11579, 330, true
6323, 1566721917457, 11249, 1566721917784, 11576, 327, true
6324, 1566721917458, 11250, 1566721917786, 11578, 328, true
6325, 1566721917458, 11250, 1566721917784, 11576, 326, true
6326, 1566721917458, 11250, 1566721917784, 11576, 326, true
6327, 1566721917459, 11251, 1566721917746, 11538, 287, true
6328, 1566721917459, 11251, 1566721917742, 11534, 283, true
6329, 1566721917460, 11252, 1566721917743, 11535, 283, true
6330, 1566721917461, 11253, 1566721917738, 11530, 277, true
6331, 1566721917462, 11254, 1566721917737, 11529, 275, true
6332, 1566721917462, 11254, 1566721917742, 11534, 280, true
6333, 1566721917462, 11254, 1566721917738, 11530, 276, true
6334, 1566721917463, 11255, 1566721917743, 11535, 280, true
6335, 1566721917463, 11255, 1566721917738, 11530, 275, true
6336, 1566721917463, 11255, 1566721917738, 11530, 275, true
6337, 1566721917463, 11255, 1566721917737, 11529, 274, true
6338, 1566721917464, 11256, 1566721917737, 11529, 273, true
6339, 1566721917464, 11256, 1566721917742, 11534, 278, true
6340, 1566721917464, 11256, 1566721917739, 11531, 275, true
6341, 1566721917465, 11257, 1566721917737, 11529, 272, true
6342, 1566721917465, 11257, 1566721917739, 11531, 274, true
6343, 1566721917605, 11397, 1566721917826, 11618, 221, true
6344, 1566721917607, 11399, 1566721917826, 11618, 219, true
6345, 1566721917608, 11400, 1566721917826, 11618, 218, true
6346, 1566721917609, 11401, 1566721917826, 11618, 217, true
6347, 1566721917610, 11402, 1566721917826, 11618, 216, true
6348, 1566721917611, 11403, 1566721917826, 11618, 215, true
6349, 1566721917613, 11405, 1566721917826, 11618, 213, true
6350, 1566721917614, 11406, 1566721917826, 11618, 212, true
6351, 1566721917616, 11408, 1566721917826, 11618, 210, true
6352, 1566721917617, 11409, 1566721917827, 11619, 210, true
6353, 1566721917619, 11411, 1566721917829, 11621, 210, true
6354, 1566721917620, 11412, 1566721917827, 11619, 207, true
6355, 1566721917622, 11414, 1566721917827, 11619, 205, true
6356, 1566721917626, 11418, 1566721917829, 11621, 203, true
6357, 1566721917628, 11420, 1566721917832, 11624, 204, true
6358, 1566721917629, 11421, 1566721917833, 11625, 204, true
6359, 1566721917631, 11423, 1566721917836, 11628, 205, true
6360, 1566721917633, 11425, 1566721917843, 11635, 210, true
6361, 1566721917635, 11427, 1566721917842, 11634, 207, true
6362, 1566721917637, 11429, 1566721917849, 11641, 212, true
6363, 1566721917638, 11430, 1566721917850, 11642, 212, true
6364, 1566721917640, 11432, 1566721917849, 11641, 209, true
6365, 1566721917642, 11434, 1566721917854, 11646, 212, true
6366, 1566721917644, 11436, 1566721917853, 11645, 209, true
6367, 1566721917645, 11437, 1566721917854, 11646, 209, true
6368, 1566721917647, 11439, 1566721917868, 11660, 221, true
6369, 1566721917649, 11441, 1566721917855, 11647, 206, true
6370, 1566721917651, 11443, 1566721917878, 11670, 227, true
6371, 1566721917652, 11444, 1566721917878, 11670, 226, true
6372, 1566721917653, 11445, 1566721917878, 11670, 225, true
6373, 1566721917653, 11445, 1566721917878, 11670, 225, true
6374, 1566721917655, 11447, 1566721917878, 11670, 223, true
6375, 1566721917657, 11449, 1566721917878, 11670, 221, true
6376, 1566721917658, 11450, 1566721917878, 11670, 220, true
6377, 1566721917660, 11452, 1566721917879, 11671, 219, true
6378, 1566721917662, 11454, 1566721917879, 11671, 217, true
6379, 1566721917664, 11456, 1566721917879, 11671, 215, true
6380, 1566721917665, 11457, 1566721917879, 11671, 214, true
6381, 1566721917667, 11459, 1566721917880, 11672, 213, true
6382, 1566721917668, 11460, 1566721917880, 11672, 212, true
6383, 1566721917670, 11462, 1566721917881, 11673, 211, true
6384, 1566721917672, 11464, 1566721917881, 11673, 209, true
6385, 1566721917673, 11465, 1566721917894, 11686, 221, true
6386, 1566721917675, 11467, 1566721917882, 11674, 207, true
6387, 1566721917677, 11469, 1566721917894, 11686, 217, true
6388, 1566721917678, 11470, 1566721917894, 11686, 216, true
6389, 1566721917680, 11472, 1566721917894, 11686, 214, true
6390, 1566721917681, 11473, 1566721917894, 11686, 213, true
6391, 1566721917683, 11475, 1566721917894, 11686, 211, true
6392, 1566721917711, 11503, 1566721917916, 11708, 205, true
6393, 1566721917712, 11504, 1566721917917, 11709, 205, true
6394, 1566721917714, 11506, 1566721917923, 11715, 209, true
6395, 1566721917715, 11507, 1566721917921, 11713, 206, true
6396, 1566721917716, 11508, 1566721917924, 11716, 208, true
6397, 1566721917716, 11508, 1566721917921, 11713, 205, true
6398, 1566721917717, 11509, 1566721917924, 11716, 207, true
6399, 1566721917717, 11509, 1566721917922, 11714, 205, true
6400, 1566721917718, 11510, 1566721917924, 11716, 206, true
6401, 1566721917719, 11511, 1566721917925, 11717, 206, true
6402, 1566721917720, 11512, 1566721917927, 11719, 207, true
6403, 1566721917721, 11513, 1566721917927, 11719, 206, true
6404, 1566721917722, 11514, 1566721917927, 11719, 205, true
6405, 1566721917723, 11515, 1566721918007, 11799, 284, true
6406, 1566721917724, 11516, 1566721918026, 11818, 302, true
6407, 1566721917750, 11542, 1566721918012, 11804, 262, true
6408, 1566721917794, 11586, 1566721918028, 11820, 234, true
6409, 1566721917803, 11595, 1566721918028, 11820, 225, true
6410, 1566721917803, 11595, 1566721918028, 11820, 225, true
6411, 1566721917803, 11595, 1566721918026, 11818, 223, true
6412, 1566721917804, 11596, 1566721918043, 11835, 239, true
6413, 1566721917804, 11596, 1566721918043, 11835, 239, true
6414, 1566721917806, 11598, 1566721918043, 11835, 237, true
6415, 1566721917806, 11598, 1566721918023, 11815, 217, true
6416, 1566721917806, 11598, 1566721918043, 11835, 237, true
6417, 1566721917807, 11599, 1566721918026, 11818, 219, true
6418, 1566721917808, 11600, 1566721918043, 11835, 235, true
6419, 1566721917808, 11600, 1566721918043, 11835, 235, true
6420, 1566721917808, 11600, 1566721918043, 11835, 235, true
6421, 1566721917809, 11601, 1566721918025, 11817, 216, true
6422, 1566721917809, 11601, 1566721918029, 11821, 220, true
6423, 1566721917810, 11602, 1566721918043, 11835, 233, true
6424, 1566721917810, 11602, 1566721918026, 11818, 216, true
6425, 1566721917810, 11602, 1566721918030, 11822, 220, true
6426, 1566721917811, 11603, 1566721918043, 11835, 232, true
6427, 1566721917811, 11603, 1566721918025, 11817, 214, true
6428, 1566721917811, 11603, 1566721918029, 11821, 218, true
6429, 1566721917812, 11604, 1566721918028, 11820, 216, true
6430, 1566721917813, 11605, 1566721918028, 11820, 215, true
6431, 1566721917813, 11605, 1566721918026, 11818, 213, true
6432, 1566721917813, 11605, 1566721918028, 11820, 215, true
6433, 1566721917833, 11625, 1566721918043, 11835, 210, true
6434, 1566721917836, 11628, 1566721918043, 11835, 207, true
6435, 1566721917836, 11628, 1566721918043, 11835, 207, true
6436, 1566721917837, 11629, 1566721918044, 11836, 207, true
6437, 1566721917837, 11629, 1566721918044, 11836, 207, true
6438, 1566721917837, 11629, 1566721918044, 11836, 207, true
6439, 1566721917838, 11630, 1566721918044, 11836, 206, true
6440, 1566721917839, 11631, 1566721918049, 11841, 210, true
6441, 1566721917839, 11631, 1566721918050, 11842, 211, true
6442, 1566721917840, 11632, 1566721918045, 11837, 205, true
6443, 1566721917840, 11632, 1566721918083, 11875, 243, true
6444, 1566721917841, 11633, 1566721918083, 11875, 242, true
6445, 1566721917843, 11635, 1566721918084, 11876, 241, true
6446, 1566721917843, 11635, 1566721918084, 11876, 241, true
6447, 1566721917844, 11636, 1566721918084, 11876, 240, true
6448, 1566721917844, 11636, 1566721918084, 11876, 240, true
6449, 1566721917845, 11637, 1566721918083, 11875, 238, true
6450, 1566721917845, 11637, 1566721918083, 11875, 238, true
6451, 1566721917846, 11638, 1566721918084, 11876, 238, true
6452, 1566721917846, 11638, 1566721918084, 11876, 238, true
6453, 1566721917847, 11639, 1566721918083, 11875, 236, true
6454, 1566721917848, 11640, 1566721918085, 11877, 237, true
6455, 1566721917850, 11642, 1566721918084, 11876, 234, true
6456, 1566721917850, 11642, 1566721918085, 11877, 235, true
6457, 1566721917851, 11643, 1566721918084, 11876, 233, true
6458, 1566721917851, 11643, 1566721918084, 11876, 233, true
6459, 1566721917852, 11644, 1566721918085, 11877, 233, true
6460, 1566721917857, 11649, 1566721918088, 11880, 231, true
6461, 1566721917857, 11649, 1566721918085, 11877, 228, true
6462, 1566721917858, 11650, 1566721918085, 11877, 227, true
6463, 1566721917859, 11651, 1566721918085, 11877, 226, true
6464, 1566721917859, 11651, 1566721918088, 11880, 229, true
6465, 1566721917860, 11652, 1566721918085, 11877, 225, true
6466, 1566721917860, 11652, 1566721918089, 11881, 229, true
6467, 1566721917861, 11653, 1566721918089, 11881, 228, true
6468, 1566721917862, 11654, 1566721918089, 11881, 227, true
6469, 1566721917863, 11655, 1566721918088, 11880, 225, true
6470, 1566721917863, 11655, 1566721918089, 11881, 226, true
6471, 1566721917864, 11656, 1566721918088, 11880, 224, true
6472, 1566721917865, 11657, 1566721918088, 11880, 223, true
6473, 1566721917866, 11658, 1566721918090, 11882, 224, true
6474, 1566721917866, 11658, 1566721918090, 11882, 224, true
6475, 1566721917867, 11659, 1566721918090, 11882, 223, true
6476, 1566721917868, 11660, 1566721918094, 11886, 226, true
6477, 1566721917869, 11661, 1566721918094, 11886, 225, true
6478, 1566721917870, 11662, 1566721918094, 11886, 224, true
6479, 1566721917870, 11662, 1566721918094, 11886, 224, true
6480, 1566721917871, 11663, 1566721918090, 11882, 219, true
6481, 1566721917873, 11665, 1566721918094, 11886, 221, true
6482, 1566721917874, 11666, 1566721918094, 11886, 220, true
6483, 1566721917881, 11673, 1566721918094, 11886, 213, true
6484, 1566721917882, 11674, 1566721918094, 11886, 212, true
6485, 1566721917883, 11675, 1566721918094, 11886, 211, true
6486, 1566721917883, 11675, 1566721918094, 11886, 211, true
6487, 1566721917884, 11676, 1566721918097, 11889, 213, true
6488, 1566721917884, 11676, 1566721918094, 11886, 210, true
6489, 1566721917885, 11677, 1566721918095, 11887, 210, true
6490, 1566721917886, 11678, 1566721918102, 11894, 216, true
6491, 1566721917888, 11680, 1566721918103, 11895, 215, true
6492, 1566721917888, 11680, 1566721918103, 11895, 215, true
6493, 1566721917888, 11680, 1566721918105, 11897, 217, true
6494, 1566721917889, 11681, 1566721918103, 11895, 214, true
6495, 1566721917889, 11681, 1566721918103, 11895, 214, true
6496, 1566721917890, 11682, 1566721918102, 11894, 212, true
6497, 1566721917890, 11682, 1566721918105, 11897, 215, true
6498, 1566721917891, 11683, 1566721918103, 11895, 212, true
6499, 1566721917891, 11683, 1566721918103, 11895, 212, true
6500, 1566721917895, 11687, 1566721918103, 11895, 208, true
6501, 1566721917895, 11687, 1566721918103, 11895, 208, true
6502, 1566721917895, 11687, 1566721918103, 11895, 208, true
6503, 1566721917896, 11688, 1566721918102, 11894, 206, true
6504, 1566721917896, 11688, 1566721918104, 11896, 208, true
6505, 1566721917896, 11688, 1566721918106, 11898, 210, true
6506, 1566721917899, 11691, 1566721918105, 11897, 206, true
6507, 1566721917900, 11692, 1566721918107, 11899, 207, true
6508, 1566721917901, 11693, 1566721918107, 11899, 206, true
6509, 1566721917901, 11693, 1566721918107, 11899, 206, true
6510, 1566721917901, 11693, 1566721918106, 11898, 205, true
6511, 1566721917904, 11696, 1566721918108, 11900, 204, true
6512, 1566721917905, 11697, 1566721918109, 11901, 204, true
6513, 1566721917905, 11697, 1566721918115, 11907, 210, true
6514, 1566721917906, 11698, 1566721918115, 11907, 209, true
6515, 1566721917907, 11699, 1566721918115, 11907, 208, true
6516, 1566721917909, 11701, 1566721918116, 11908, 207, true
6517, 1566721917911, 11703, 1566721918119, 11911, 208, true
6518, 1566721917911, 11703, 1566721918119, 11911, 208, true
6519, 1566721917912, 11704, 1566721918119, 11911, 207, true
6520, 1566721917912, 11704, 1566721918119, 11911, 207, true
6521, 1566721917913, 11705, 1566721918119, 11911, 206, true
6522, 1566721917914, 11706, 1566721918122, 11914, 208, true
6523, 1566721917914, 11706, 1566721918122, 11914, 208, true
6524, 1566721917917, 11709, 1566721918122, 11914, 205, true
6525, 1566721917918, 11710, 1566721918123, 11915, 205, true
6526, 1566721917918, 11710, 1566721918124, 11916, 206, true
6527, 1566721917919, 11711, 1566721918127, 11919, 208, true
6528, 1566721917919, 11711, 1566721918129, 11921, 210, true
6529, 1566721917920, 11712, 1566721918131, 11923, 211, true
6530, 1566721917921, 11713, 1566721918124, 11916, 203, true
6531, 1566721917928, 11720, 1566721918131, 11923, 203, true
6532, 1566721917929, 11721, 1566721918135, 11927, 206, true
6533, 1566721917929, 11721, 1566721918132, 11924, 203, true
6534, 1566721917930, 11722, 1566721918135, 11927, 205, true
6535, 1566721917930, 11722, 1566721918135, 11927, 205, true
6536, 1566721917931, 11723, 1566721918135, 11927, 204, true
6537, 1566721917932, 11724, 1566721918135, 11927, 203, true
6538, 1566721917933, 11725, 1566721918136, 11928, 203, true
6539, 1566721917933, 11725, 1566721918137, 11929, 204, true
6540, 1566721917934, 11726, 1566721918137, 11929, 203, true
6541, 1566721917935, 11727, 1566721918138, 11930, 203, true
6542, 1566721917936, 11728, 1566721918139, 11931, 203, true
6543, 1566721917937, 11729, 1566721918144, 11936, 207, true
6544, 1566721917938, 11730, 1566721918141, 11933, 203, true
6545, 1566721917938, 11730, 1566721918147, 11939, 209, true
6546, 1566721917939, 11731, 1566721918144, 11936, 205, true
6547, 1566721917940, 11732, 1566721918147, 11939, 207, true
6548, 1566721917941, 11733, 1566721918147, 11939, 206, true
6549, 1566721917941, 11733, 1566721918147, 11939, 206, true
6550, 1566721917942, 11734, 1566721918147, 11939, 205, true
6551, 1566721917943, 11735, 1566721918147, 11939, 204, true
6552, 1566721917944, 11736, 1566721918147, 11939, 203, true
6553, 1566721917945, 11737, 1566721918151, 11943, 206, true
6554, 1566721917945, 11737, 1566721918150, 11942, 205, true
6555, 1566721917946, 11738, 1566721918154, 11946, 208, true
6556, 1566721917946, 11738, 1566721918154, 11946, 208, true
6557, 1566721917947, 11739, 1566721918155, 11947, 208, true
6558, 1566721917948, 11740, 1566721918154, 11946, 206, true
6559, 1566721917950, 11742, 1566721918154, 11946, 204, true
6560, 1566721917951, 11743, 1566721918155, 11947, 204, true
6561, 1566721917951, 11743, 1566721918156, 11948, 205, true
6562, 1566721917952, 11744, 1566721918165, 11957, 213, true
6563, 1566721917953, 11745, 1566721918165, 11957, 212, true
6564, 1566721917953, 11745, 1566721918158, 11950, 205, true
6565, 1566721917953, 11745, 1566721918165, 11957, 212, true
6566, 1566721917954, 11746, 1566721918165, 11957, 211, true
6567, 1566721917954, 11746, 1566721918165, 11957, 211, true
6568, 1566721917955, 11747, 1566721918165, 11957, 210, true
6569, 1566721917956, 11748, 1566721918165, 11957, 209, true
6570, 1566721917957, 11749, 1566721918165, 11957, 208, true
6571, 1566721917958, 11750, 1566721918165, 11957, 207, true
6572, 1566721917960, 11752, 1566721918165, 11957, 205, true
6573, 1566721917960, 11752, 1566721918165, 11957, 205, true
6574, 1566721917961, 11753, 1566721918166, 11958, 205, true
6575, 1566721917962, 11754, 1566721918166, 11958, 204, true
6576, 1566721917963, 11755, 1566721918169, 11961, 206, true
6577, 1566721917964, 11756, 1566721918168, 11960, 204, true
6578, 1566721917965, 11757, 1566721918168, 11960, 203, true
6579, 1566721917966, 11758, 1566721918169, 11961, 203, true
6580, 1566721917967, 11759, 1566721918169, 11961, 202, true
6581, 1566721917968, 11760, 1566721918174, 11966, 206, true
6582, 1566721917969, 11761, 1566721918174, 11966, 205, true
6583, 1566721917970, 11762, 1566721918176, 11968, 206, true
6584, 1566721917970, 11762, 1566721918245, 12037, 275, true
6585, 1566721917971, 11763, 1566721918379, 12171, 408, true
6586, 1566721917971, 11763, 1566721918385, 12177, 414, true
6587, 1566721917972, 11764, 1566721918267, 12059, 295, true
6588, 1566721917973, 11765, 1566721918378, 12170, 405, true
6589, 1566721917973, 11765, 1566721918261, 12053, 288, true
6590, 1566721917973, 11765, 1566721918380, 12172, 407, true
6591, 1566721917974, 11766, 1566721918378, 12170, 404, true
6592, 1566721917974, 11766, 1566721918381, 12173, 407, true
6593, 1566721917974, 11766, 1566721918383, 12175, 409, true
6594, 1566721917975, 11767, 1566721918276, 12068, 301, true
6595, 1566721917975, 11767, 1566721918378, 12170, 403, true
6596, 1566721917975, 11767, 1566721918253, 12045, 278, true
6597, 1566721917975, 11767, 1566721918276, 12068, 301, true
6598, 1566721917976, 11768, 1566721918276, 12068, 300, true
6599, 1566721917976, 11768, 1566721918277, 12069, 301, true
6600, 1566721917976, 11768, 1566721918383, 12175, 407, true
6601, 1566721917976, 11768, 1566721918379, 12171, 403, true
6602, 1566721917977, 11769, 1566721918357, 12149, 380, true
6603, 1566721917977, 11769, 1566721918277, 12069, 300, true
6604, 1566721917977, 11769, 1566721918259, 12051, 282, true
6605, 1566721917977, 11769, 1566721918267, 12059, 290, true
6606, 1566721917978, 11770, 1566721918357, 12149, 379, true
6607, 1566721917978, 11770, 1566721918357, 12149, 379, true
6608, 1566721917978, 11770, 1566721918383, 12175, 405, true
6609, 1566721917979, 11771, 1566721918275, 12067, 296, true
6610, 1566721917979, 11771, 1566721918379, 12171, 400, true
6611, 1566721917979, 11771, 1566721918380, 12172, 401, true
6612, 1566721917980, 11772, 1566721918257, 12049, 277, true
6613, 1566721917980, 11772, 1566721918378, 12170, 398, true
6614, 1566721917980, 11772, 1566721918365, 12157, 385, true
6615, 1566721917980, 11772, 1566721918362, 12154, 382, true
6616, 1566721917981, 11773, 1566721918383, 12175, 402, true
6617, 1566721917981, 11773, 1566721918383, 12175, 402, true
6618, 1566721917981, 11773, 1566721918387, 12179, 406, true
6619, 1566721917981, 11773, 1566721918274, 12066, 293, true
6620, 1566721917982, 11774, 1566721918276, 12068, 294, true
6621, 1566721917982, 11774, 1566721918275, 12067, 293, true
6622, 1566721917982, 11774, 1566721918276, 12068, 294, true
6623, 1566721917983, 11775, 1566721918277, 12069, 294, true
6624, 1566721917983, 11775, 1566721918257, 12049, 274, true
6625, 1566721917983, 11775, 1566721918380, 12172, 397, true
6626, 1566721917983, 11775, 1566721918380, 12172, 397, true
6627, 1566721917984, 11776, 1566721918380, 12172, 396, true
6628, 1566721917984, 11776, 1566721918381, 12173, 397, true
6629, 1566721917984, 11776, 1566721918266, 12058, 282, true
6630, 1566721917984, 11776, 1566721918268, 12060, 284, true
6631, 1566721917985, 11777, 1566721918266, 12058, 281, true
6632, 1566721917985, 11777, 1566721918381, 12173, 396, true
6633, 1566721917985, 11777, 1566721918259, 12051, 274, true
6634, 1566721917986, 11778, 1566721918275, 12067, 289, true
6635, 1566721917986, 11778, 1566721918378, 12170, 392, true
6636, 1566721917986, 11778, 1566721918257, 12049, 271, true
6637, 1566721917987, 11779, 1566721918276, 12068, 289, true
6638, 1566721917987, 11779, 1566721918378, 12170, 391, true
6639, 1566721917987, 11779, 1566721918259, 12051, 272, true
6640, 1566721917988, 11780, 1566721918267, 12059, 279, true
6641, 1566721917988, 11780, 1566721918380, 12172, 392, true
6642, 1566721917988, 11780, 1566721918276, 12068, 288, true
6643, 1566721917988, 11780, 1566721918257, 12049, 269, true
6644, 1566721917989, 11781, 1566721918379, 12171, 390, true
6645, 1566721917989, 11781, 1566721918262, 12054, 273, true
6646, 1566721917989, 11781, 1566721918274, 12066, 285, true
6647, 1566721917990, 11782, 1566721918275, 12067, 285, true
6648, 1566721917990, 11782, 1566721918378, 12170, 388, true
6649, 1566721917990, 11782, 1566721918379, 12171, 389, true
6650, 1566721917990, 11782, 1566721918378, 12170, 388, true
6651, 1566721917991, 11783, 1566721918267, 12059, 276, true
6652, 1566721917991, 11783, 1566721918384, 12176, 393, true
6653, 1566721917991, 11783, 1566721918277, 12069, 286, true
6654, 1566721917991, 11783, 1566721918379, 12171, 388, true
6655, 1566721917992, 11784, 1566721918268, 12060, 276, true
6656, 1566721917992, 11784, 1566721918267, 12059, 275, true
6657, 1566721917993, 11785, 1566721918259, 12051, 266, true
6658, 1566721917993, 11785, 1566721918383, 12175, 390, true
6659, 1566721917993, 11785, 1566721918381, 12173, 388, true
6660, 1566721917994, 11786, 1566721918380, 12172, 386, true
6661, 1566721917994, 11786, 1566721918267, 12059, 273, true
6662, 1566721917995, 11787, 1566721918381, 12173, 386, true
6663, 1566721917995, 11787, 1566721918380, 12172, 385, true
6664, 1566721917995, 11787, 1566721918347, 12139, 352, true
6665, 1566721917995, 11787, 1566721918268, 12060, 273, true
6666, 1566721917996, 11788, 1566721918356, 12148, 360, true
6667, 1566721917996, 11788, 1566721918267, 12059, 271, true
6668, 1566721917996, 11788, 1566721918383, 12175, 387, true
6669, 1566721917996, 11788, 1566721918381, 12173, 385, true
6670, 1566721917997, 11789, 1566721918379, 12171, 382, true
6671, 1566721917997, 11789, 1566721918346, 12138, 349, true
6672, 1566721917998, 11790, 1566721918379, 12171, 381, true
6673, 1566721917998, 11790, 1566721918380, 12172, 382, true
6674, 1566721917998, 11790, 1566721918275, 12067, 277, true
6675, 1566721917999, 11791, 1566721918379, 12171, 380, true
6676, 1566721917999, 11791, 1566721918380, 12172, 381, true
6677, 1566721917999, 11791, 1566721918357, 12149, 358, true
6678, 1566721918000, 11792, 1566721918276, 12068, 276, true
6679, 1566721918000, 11792, 1566721918276, 12068, 276, true
6680, 1566721918000, 11792, 1566721918347, 12139, 347, true
6681, 1566721918001, 11793, 1566721918276, 12068, 275, true
6682, 1566721918001, 11793, 1566721918379, 12171, 378, true
6683, 1566721918001, 11793, 1566721918379, 12171, 378, true
6684, 1566721918001, 11793, 1566721918356, 12148, 355, true
6685, 1566721918002, 11794, 1566721918275, 12067, 273, true
6686, 1566721918002, 11794, 1566721918348, 12140, 346, true
6687, 1566721918003, 11795, 1566721918383, 12175, 380, true
6688, 1566721918003, 11795, 1566721918266, 12058, 263, true
6689, 1566721918003, 11795, 1566721918266, 12058, 263, true
6690, 1566721918003, 11795, 1566721918380, 12172, 377, true
6691, 1566721918004, 11796, 1566721918260, 12052, 256, true
6692, 1566721918004, 11796, 1566721918267, 12059, 263, true
6693, 1566721918004, 11796, 1566721918353, 12145, 349, true
6694, 1566721918005, 11797, 1566721918352, 12144, 347, true
6695, 1566721918005, 11797, 1566721918382, 12174, 377, true
6696, 1566721918005, 11797, 1566721918382, 12174, 377, true
6697, 1566721918006, 11798, 1566721918351, 12143, 345, true
6698, 1566721918006, 11798, 1566721918361, 12153, 355, true
6699, 1566721918007, 11799, 1566721918269, 12061, 262, true
6700, 1566721918007, 11799, 1566721918350, 12142, 343, true
6701, 1566721918008, 11800, 1566721918383, 12175, 375, true
6702, 1566721918008, 11800, 1566721918381, 12173, 373, true
6703, 1566721918008, 11800, 1566721918383, 12175, 375, true
6704, 1566721918009, 11801, 1566721918383, 12175, 374, true
6705, 1566721918009, 11801, 1566721918355, 12147, 346, true
6706, 1566721918009, 11801, 1566721918364, 12156, 355, true
6707, 1566721918010, 11802, 1566721918351, 12143, 341, true
6708, 1566721918010, 11802, 1566721918382, 12174, 372, true
6709, 1566721918010, 11802, 1566721918381, 12173, 371, true
6710, 1566721918011, 11803, 1566721918378, 12170, 367, true
6711, 1566721918012, 11804, 1566721918348, 12140, 336, true
6712, 1566721918012, 11804, 1566721918267, 12059, 255, true
6713, 1566721918012, 11804, 1566721918377, 12169, 365, true
6714, 1566721918013, 11805, 1566721918350, 12142, 337, true
6715, 1566721918013, 11805, 1566721918352, 12144, 339, true
6716, 1566721918013, 11805, 1566721918354, 12146, 341, true
6717, 1566721918014, 11806, 1566721918388, 12180, 374, true
6718, 1566721918014, 11806, 1566721918355, 12147, 341, true
6719, 1566721918014, 11806, 1566721918358, 12150, 344, true
6720, 1566721918015, 11807, 1566721918363, 12155, 348, true
6721, 1566721918015, 11807, 1566721918377, 12169, 362, true
6722, 1566721918015, 11807, 1566721918377, 12169, 362, true
6723, 1566721918015, 11807, 1566721918353, 12145, 338, true
6724, 1566721918016, 11808, 1566721918354, 12146, 338, true
6725, 1566721918016, 11808, 1566721918355, 12147, 339, true
6726, 1566721918017, 11809, 1566721918363, 12155, 346, true
6727, 1566721918017, 11809, 1566721918366, 12158, 349, true
6728, 1566721918018, 11810, 1566721918383, 12175, 365, true
6729, 1566721918018, 11810, 1566721918353, 12145, 335, true
6730, 1566721918019, 11811, 1566721918382, 12174, 363, true
6731, 1566721918019, 11811, 1566721918364, 12156, 345, true
6732, 1566721918020, 11812, 1566721918354, 12146, 334, true
6733, 1566721918020, 11812, 1566721918349, 12141, 329, true
6734, 1566721918020, 11812, 1566721918356, 12148, 336, true
6735, 1566721918021, 11813, 1566721918365, 12157, 344, true
6736, 1566721918021, 11813, 1566721918384, 12176, 363, true
6737, 1566721918021, 11813, 1566721918352, 12144, 331, true
6738, 1566721918022, 11814, 1566721918349, 12141, 327, true
6739, 1566721918031, 11823, 1566721918378, 12170, 347, true
6740, 1566721918031, 11823, 1566721918379, 12171, 348, true
6741, 1566721918032, 11824, 1566721918274, 12066, 242, true
6742, 1566721918032, 11824, 1566721918257, 12049, 225, true
6743, 1566721918034, 11826, 1566721918266, 12058, 232, true
6744, 1566721918034, 11826, 1566721918383, 12175, 349, true
6745, 1566721918035, 11827, 1566721918349, 12141, 314, true
6746, 1566721918036, 11828, 1566721918362, 12154, 326, true
6747, 1566721918036, 11828, 1566721918377, 12169, 341, true
6748, 1566721918036, 11828, 1566721918348, 12140, 312, true
6749, 1566721918037, 11829, 1566721918382, 12174, 345, true
6750, 1566721918037, 11829, 1566721918377, 12169, 340, true
6751, 1566721918038, 11830, 1566721918353, 12145, 315, true
6752, 1566721918038, 11830, 1566721918377, 12169, 339, true
6753, 1566721918038, 11830, 1566721918355, 12147, 317, true
6754, 1566721918039, 11831, 1566721918351, 12143, 312, true
6755, 1566721918046, 11838, 1566721918381, 12173, 335, true
6756, 1566721918046, 11838, 1566721918348, 12140, 302, true
6757, 1566721918047, 11839, 1566721918350, 12142, 303, true
6758, 1566721918047, 11839, 1566721918382, 12174, 335, true
6759, 1566721918047, 11839, 1566721918351, 12143, 304, true
6760, 1566721918047, 11839, 1566721918349, 12141, 302, true
6761, 1566721918047, 11839, 1566721918382, 12174, 335, true
6762, 1566721918048, 11840, 1566721918354, 12146, 306, true
6763, 1566721918050, 11842, 1566721918382, 12174, 332, true
6764, 1566721918051, 11843, 1566721918382, 12174, 331, true
6765, 1566721918051, 11843, 1566721918468, 12260, 417, true
6766, 1566721918053, 11845, 1566721918468, 12260, 415, true
6767, 1566721918058, 11850, 1566721918467, 12259, 409, true
6768, 1566721918060, 11852, 1566721918468, 12260, 408, true
6769, 1566721918062, 11854, 1566721918468, 12260, 406, true
6770, 1566721918063, 11855, 1566721918468, 12260, 405, true
6771, 1566721918065, 11857, 1566721918468, 12260, 403, true
6772, 1566721918066, 11858, 1566721918468, 12260, 402, true
6773, 1566721918067, 11859, 1566721918467, 12259, 400, true
6774, 1566721918070, 11862, 1566721918468, 12260, 398, true
6775, 1566721918190, 11982, 1566721918467, 12259, 277, true
6776, 1566721918191, 11983, 1566721918467, 12259, 276, true
6777, 1566721918192, 11984, 1566721918469, 12261, 277, true
6778, 1566721918193, 11985, 1566721918467, 12259, 274, true
6779, 1566721918194, 11986, 1566721918467, 12259, 273, true
6780, 1566721918195, 11987, 1566721918467, 12259, 272, true
6781, 1566721918197, 11989, 1566721918467, 12259, 270, true
6782, 1566721918198, 11990, 1566721918467, 12259, 269, true
6783, 1566721918200, 11992, 1566721918469, 12261, 269, true
6784, 1566721918202, 11994, 1566721918469, 12261, 267, true
6785, 1566721918204, 11996, 1566721918467, 12259, 263, true
6786, 1566721918205, 11997, 1566721918469, 12261, 264, true
6787, 1566721918207, 11999, 1566721918466, 12258, 259, true
6788, 1566721918209, 12001, 1566721918469, 12261, 260, true
6789, 1566721918211, 12003, 1566721918460, 12252, 249, true
6790, 1566721918213, 12005, 1566721918459, 12251, 246, true
6791, 1566721918214, 12006, 1566721918459, 12251, 245, true
6792, 1566721918216, 12008, 1566721918453, 12245, 237, true
6793, 1566721918216, 12008, 1566721918459, 12251, 243, true
6794, 1566721918216, 12008, 1566721918466, 12258, 250, true
6795, 1566721918217, 12009, 1566721918453, 12245, 236, true
6796, 1566721918217, 12009, 1566721918451, 12243, 234, true
6797, 1566721918217, 12009, 1566721918453, 12245, 236, true
6798, 1566721918218, 12010, 1566721918444, 12236, 226, true
6799, 1566721918218, 12010, 1566721918444, 12236, 226, true
6800, 1566721918218, 12010, 1566721918453, 12245, 235, true
6801, 1566721918219, 12011, 1566721918452, 12244, 233, true
6802, 1566721918220, 12012, 1566721918453, 12245, 233, true
6803, 1566721918220, 12012, 1566721918453, 12245, 233, true
6804, 1566721918220, 12012, 1566721918453, 12245, 233, true
6805, 1566721918221, 12013, 1566721918453, 12245, 232, true
6806, 1566721918222, 12014, 1566721918453, 12245, 231, true
6807, 1566721918223, 12015, 1566721918453, 12245, 230, true
6808, 1566721918227, 12019, 1566721918452, 12244, 225, true
6809, 1566721918227, 12019, 1566721918444, 12236, 217, true
6810, 1566721918228, 12020, 1566721918452, 12244, 224, true
6811, 1566721918229, 12021, 1566721918443, 12235, 214, true
6812, 1566721918229, 12021, 1566721918452, 12244, 223, true
6813, 1566721918229, 12021, 1566721918452, 12244, 223, true
6814, 1566721918230, 12022, 1566721918452, 12244, 222, true
6815, 1566721918230, 12022, 1566721918452, 12244, 222, true
6816, 1566721918230, 12022, 1566721918451, 12243, 221, true
6817, 1566721918231, 12023, 1566721918452, 12244, 221, true
6818, 1566721918232, 12024, 1566721918452, 12244, 220, true
6819, 1566721918233, 12025, 1566721918451, 12243, 218, true
6820, 1566721918235, 12027, 1566721918451, 12243, 216, true
6821, 1566721918237, 12029, 1566721918453, 12245, 216, true
6822, 1566721918237, 12029, 1566721918453, 12245, 216, true
6823, 1566721918237, 12029, 1566721918442, 12234, 205, true
6824, 1566721918238, 12030, 1566721918452, 12244, 214, true
6825, 1566721918238, 12030, 1566721918453, 12245, 215, true
6826, 1566721918239, 12031, 1566721918454, 12246, 215, true
6827, 1566721918239, 12031, 1566721918454, 12246, 215, true
6828, 1566721918240, 12032, 1566721918454, 12246, 214, true
6829, 1566721918241, 12033, 1566721918454, 12246, 213, true
6830, 1566721918242, 12034, 1566721918454, 12246, 212, true
6831, 1566721918243, 12035, 1566721918454, 12246, 211, true
6832, 1566721918246, 12038, 1566721918455, 12247, 209, true
6833, 1566721918246, 12038, 1566721918455, 12247, 209, true
6834, 1566721918247, 12039, 1566721918456, 12248, 209, true
6835, 1566721918248, 12040, 1566721918456, 12248, 208, true
6836, 1566721918249, 12041, 1566721918456, 12248, 207, true
6837, 1566721918250, 12042, 1566721918461, 12253, 211, true
6838, 1566721918250, 12042, 1566721918459, 12251, 209, true
6839, 1566721918251, 12043, 1566721918462, 12254, 211, true
6840, 1566721918252, 12044, 1566721918462, 12254, 210, true
6841, 1566721918252, 12044, 1566721918461, 12253, 209, true
6842, 1566721918255, 12047, 1566721918468, 12260, 213, true
6843, 1566721918260, 12052, 1566721918590, 12382, 330, true
6844, 1566721918319, 12111, 1566721918598, 12390, 279, true
6845, 1566721918320, 12112, 1566721918606, 12398, 286, true
6846, 1566721918320, 12112, 1566721918598, 12390, 278, true
6847, 1566721918321, 12113, 1566721918606, 12398, 285, true
6848, 1566721918321, 12113, 1566721918606, 12398, 285, true
6849, 1566721918321, 12113, 1566721918616, 12408, 295, true
6850, 1566721918322, 12114, 1566721918612, 12404, 290, true
6851, 1566721918322, 12114, 1566721918599, 12391, 277, true
6852, 1566721918322, 12114, 1566721918611, 12403, 289, true
6853, 1566721918323, 12115, 1566721918610, 12402, 287, true
6854, 1566721918323, 12115, 1566721918606, 12398, 283, true
6855, 1566721918324, 12116, 1566721918610, 12402, 286, true
6856, 1566721918324, 12116, 1566721918610, 12402, 286, true
6857, 1566721918325, 12117, 1566721918616, 12408, 291, true
6858, 1566721918325, 12117, 1566721918612, 12404, 287, true
6859, 1566721918326, 12118, 1566721918616, 12408, 290, true
6860, 1566721918326, 12118, 1566721918609, 12401, 283, true
6861, 1566721918327, 12119, 1566721918597, 12389, 270, true
6862, 1566721918327, 12119, 1566721918611, 12403, 284, true
6863, 1566721918328, 12120, 1566721918606, 12398, 278, true
6864, 1566721918328, 12120, 1566721918601, 12393, 273, true
6865, 1566721918328, 12120, 1566721918611, 12403, 283, true
6866, 1566721918329, 12121, 1566721918610, 12402, 281, true
6867, 1566721918329, 12121, 1566721918606, 12398, 277, true
6868, 1566721918329, 12121, 1566721918614, 12406, 285, true
6869, 1566721918330, 12122, 1566721918600, 12392, 270, true
6870, 1566721918330, 12122, 1566721918598, 12390, 268, true
6871, 1566721918330, 12122, 1566721918598, 12390, 268, true
6872, 1566721918331, 12123, 1566721918611, 12403, 280, true
6873, 1566721918331, 12123, 1566721918602, 12394, 271, true
6874, 1566721918331, 12123, 1566721918610, 12402, 279, true
6875, 1566721918331, 12123, 1566721918606, 12398, 275, true
6876, 1566721918332, 12124, 1566721918615, 12407, 283, true
6877, 1566721918332, 12124, 1566721918611, 12403, 279, true
6878, 1566721918332, 12124, 1566721918614, 12406, 282, true
6879, 1566721918333, 12125, 1566721918598, 12390, 265, true
6880, 1566721918333, 12125, 1566721918618, 12410, 285, true
6881, 1566721918333, 12125, 1566721918618, 12410, 285, true
6882, 1566721918333, 12125, 1566721918616, 12408, 283, true
6883, 1566721918334, 12126, 1566721918618, 12410, 284, true
6884, 1566721918334, 12126, 1566721918629, 12421, 295, true
6885, 1566721918334, 12126, 1566721918620, 12412, 286, true
6886, 1566721918334, 12126, 1566721918618, 12410, 284, true
6887, 1566721918335, 12127, 1566721918628, 12420, 293, true
6888, 1566721918335, 12127, 1566721918629, 12421, 294, true
6889, 1566721918335, 12127, 1566721918620, 12412, 285, true
6890, 1566721918336, 12128, 1566721918622, 12414, 286, true
6891, 1566721918336, 12128, 1566721918622, 12414, 286, true
6892, 1566721918336, 12128, 1566721918628, 12420, 292, true
6893, 1566721918337, 12129, 1566721918628, 12420, 291, true
6894, 1566721918337, 12129, 1566721918622, 12414, 285, true
6895, 1566721918337, 12129, 1566721918622, 12414, 285, true
6896, 1566721918337, 12129, 1566721918628, 12420, 291, true
6897, 1566721918338, 12130, 1566721918629, 12421, 291, true
6898, 1566721918338, 12130, 1566721918624, 12416, 286, true
6899, 1566721918339, 12131, 1566721918620, 12412, 281, true
6900, 1566721918340, 12132, 1566721918619, 12411, 279, true
6901, 1566721918341, 12133, 1566721918620, 12412, 279, true
6902, 1566721918342, 12134, 1566721918623, 12415, 281, true
6903, 1566721918344, 12136, 1566721918622, 12414, 278, true
6904, 1566721918346, 12138, 1566721918623, 12415, 277, true
6905, 1566721918392, 12184, 1566721918628, 12420, 236, true
6906, 1566721918392, 12184, 1566721918622, 12414, 230, true
6907, 1566721918393, 12185, 1566721918629, 12421, 236, true
6908, 1566721918412, 12204, 1566721918629, 12421, 217, true
6909, 1566721918417, 12209, 1566721918629, 12421, 212, true
6910, 1566721918423, 12215, 1566721918629, 12421, 206, true
6911, 1566721918424, 12216, 1566721918631, 12423, 207, true
6912, 1566721918425, 12217, 1566721918629, 12421, 204, true
6913, 1566721918429, 12221, 1566721918635, 12427, 206, true
6914, 1566721918430, 12222, 1566721918634, 12426, 204, true
6915, 1566721918430, 12222, 1566721918636, 12428, 206, true
6916, 1566721918431, 12223, 1566721918637, 12429, 206, true
6917, 1566721918432, 12224, 1566721918636, 12428, 204, true
6918, 1566721918433, 12225, 1566721918637, 12429, 204, true
6919, 1566721918434, 12226, 1566721918639, 12431, 205, true
6920, 1566721918435, 12227, 1566721918641, 12433, 206, true
6921, 1566721918435, 12227, 1566721918637, 12429, 202, true
6922, 1566721918436, 12228, 1566721918657, 12449, 221, true
6923, 1566721918436, 12228, 1566721918646, 12438, 210, true
6924, 1566721918437, 12229, 1566721918641, 12433, 204, true
6925, 1566721918438, 12230, 1566721918646, 12438, 208, true
6926, 1566721918438, 12230, 1566721918642, 12434, 204, true
6927, 1566721918439, 12231, 1566721918665, 12457, 226, true
6928, 1566721918440, 12232, 1566721918660, 12452, 220, true
6929, 1566721918441, 12233, 1566721918661, 12453, 220, true
6930, 1566721918478, 12270, 1566721918682, 12474, 204, true
6931, 1566721918480, 12272, 1566721918682, 12474, 202, true
6932, 1566721918481, 12273, 1566721918684, 12476, 203, true
6933, 1566721918482, 12274, 1566721918684, 12476, 202, true
6934, 1566721918483, 12275, 1566721918688, 12480, 205, true
6935, 1566721918484, 12276, 1566721918688, 12480, 204, true
6936, 1566721918485, 12277, 1566721918693, 12485, 208, true
6937, 1566721918487, 12279, 1566721918693, 12485, 206, true
6938, 1566721918488, 12280, 1566721918694, 12486, 206, true
6939, 1566721918490, 12282, 1566721918694, 12486, 204, true
6940, 1566721918492, 12284, 1566721918696, 12488, 204, true
6941, 1566721918493, 12285, 1566721918696, 12488, 203, true
6942, 1566721918495, 12287, 1566721918698, 12490, 203, true
6943, 1566721918496, 12288, 1566721918703, 12495, 207, true
6944, 1566721918498, 12290, 1566721918703, 12495, 205, true
6945, 1566721918499, 12291, 1566721918703, 12495, 204, true
6946, 1566721918501, 12293, 1566721918705, 12497, 204, true
6947, 1566721918502, 12294, 1566721918707, 12499, 205, true
6948, 1566721918504, 12296, 1566721918763, 12555, 259, true
6949, 1566721918506, 12298, 1566721918764, 12556, 258, true
6950, 1566721918507, 12299, 1566721918763, 12555, 256, true
6951, 1566721918509, 12301, 1566721918764, 12556, 255, true
6952, 1566721918513, 12305, 1566721918764, 12556, 251, true
6953, 1566721918515, 12307, 1566721918764, 12556, 249, true
6954, 1566721918517, 12309, 1566721918764, 12556, 247, true
6955, 1566721918519, 12311, 1566721918764, 12556, 245, true
6956, 1566721918520, 12312, 1566721918764, 12556, 244, true
6957, 1566721918522, 12314, 1566721918764, 12556, 242, true
6958, 1566721918523, 12315, 1566721918765, 12557, 242, true
6959, 1566721918525, 12317, 1566721918765, 12557, 240, true
6960, 1566721918526, 12318, 1566721918765, 12557, 239, true
6961, 1566721918528, 12320, 1566721918765, 12557, 237, true
6962, 1566721918530, 12322, 1566721918765, 12557, 235, true
6963, 1566721918531, 12323, 1566721918765, 12557, 234, true
6964, 1566721918533, 12325, 1566721918765, 12557, 232, true
6965, 1566721918534, 12326, 1566721918765, 12557, 231, true
6966, 1566721918536, 12328, 1566721918765, 12557, 229, true
6967, 1566721918538, 12330, 1566721918765, 12557, 227, true
6968, 1566721918539, 12331, 1566721918766, 12558, 227, true
6969, 1566721918541, 12333, 1566721918766, 12558, 225, true
6970, 1566721918542, 12334, 1566721918766, 12558, 224, true
6971, 1566721918544, 12336, 1566721918766, 12558, 222, true
6972, 1566721918545, 12337, 1566721918766, 12558, 221, true
6973, 1566721918547, 12339, 1566721918766, 12558, 219, true
6974, 1566721918548, 12340, 1566721918766, 12558, 218, true
6975, 1566721918550, 12342, 1566721918766, 12558, 216, true
6976, 1566721918551, 12343, 1566721918766, 12558, 215, true
6977, 1566721918553, 12345, 1566721918766, 12558, 213, true
6978, 1566721918554, 12346, 1566721918766, 12558, 212, true
6979, 1566721918556, 12348, 1566721918766, 12558, 210, true
6980, 1566721918558, 12350, 1566721918766, 12558, 208, true
6981, 1566721918559, 12351, 1566721918767, 12559, 208, true
6982, 1566721918561, 12353, 1566721918767, 12559, 206, true
6983, 1566721918563, 12355, 1566721918767, 12559, 204, true
6984, 1566721918564, 12356, 1566721918769, 12561, 205, true
6985, 1566721918566, 12358, 1566721918769, 12561, 203, true
6986, 1566721918567, 12359, 1566721918775, 12567, 208, true
6987, 1566721918569, 12361, 1566721918773, 12565, 204, true
6988, 1566721918571, 12363, 1566721918774, 12566, 203, true
6989, 1566721918572, 12364, 1566721918777, 12569, 205, true
6990, 1566721918574, 12366, 1566721918777, 12569, 203, true
6991, 1566721918575, 12367, 1566721918779, 12571, 204, true
6992, 1566721918577, 12369, 1566721918780, 12572, 203, true
6993, 1566721918578, 12370, 1566721918782, 12574, 204, true
6994, 1566721918580, 12372, 1566721918783, 12575, 203, true
6995, 1566721918581, 12373, 1566721918789, 12581, 208, true
6996, 1566721918583, 12375, 1566721918789, 12581, 206, true
6997, 1566721918585, 12377, 1566721918789, 12581, 204, true
6998, 1566721918586, 12378, 1566721918789, 12581, 203, true
6999, 1566721918588, 12380, 1566721918790, 12582, 202, true
7000, 1566721918590, 12382, 1566721918796, 12588, 206, true
7001, 1566721918591, 12383, 1566721918796, 12588, 205, true
7002, 1566721918592, 12384, 1566721918796, 12588, 204, true
7003, 1566721918593, 12385, 1566721918796, 12588, 203, true
7004, 1566721918594, 12386, 1566721918798, 12590, 204, true
7005, 1566721918595, 12387, 1566721918805, 12597, 210, true
7006, 1566721918598, 12390, 1566721918806, 12598, 208, true
7007, 1566721918602, 12394, 1566721918806, 12598, 204, true
7008, 1566721918603, 12395, 1566721918808, 12600, 205, true
7009, 1566721918607, 12399, 1566721918848, 12640, 241, true
7010, 1566721918619, 12411, 1566721918850, 12642, 231, true
7011, 1566721918630, 12422, 1566721918850, 12642, 220, true
7012, 1566721918631, 12423, 1566721918848, 12640, 217, true
7013, 1566721918632, 12424, 1566721918851, 12643, 219, true
7014, 1566721918632, 12424, 1566721918850, 12642, 218, true
7015, 1566721918632, 12424, 1566721918850, 12642, 218, true
7016, 1566721918633, 12425, 1566721918848, 12640, 215, true
7017, 1566721918633, 12425, 1566721918861, 12653, 228, true
7018, 1566721918637, 12429, 1566721918860, 12652, 223, true
7019, 1566721918638, 12430, 1566721918856, 12648, 218, true
7020, 1566721918638, 12430, 1566721918861, 12653, 223, true
7021, 1566721918639, 12431, 1566721918860, 12652, 221, true
7022, 1566721918639, 12431, 1566721918861, 12653, 222, true
7023, 1566721918640, 12432, 1566721918861, 12653, 221, true
7024, 1566721918640, 12432, 1566721918861, 12653, 221, true
7025, 1566721918644, 12436, 1566721918861, 12653, 217, true
7026, 1566721918647, 12439, 1566721918860, 12652, 213, true
7027, 1566721918647, 12439, 1566721918860, 12652, 213, true
7028, 1566721918649, 12441, 1566721918860, 12652, 211, true
7029, 1566721918650, 12442, 1566721918861, 12653, 211, true
7030, 1566721918650, 12442, 1566721918986, 12778, 336, true
7031, 1566721918650, 12442, 1566721918864, 12656, 214, true
7032, 1566721918651, 12443, 1566721918986, 12778, 335, true
7033, 1566721918651, 12443, 1566721918861, 12653, 210, true
7034, 1566721918652, 12444, 1566721918986, 12778, 334, true
7035, 1566721918656, 12448, 1566721918986, 12778, 330, true
7036, 1566721918656, 12448, 1566721918986, 12778, 330, true
7037, 1566721918658, 12450, 1566721918986, 12778, 328, true
7038, 1566721918658, 12450, 1566721918986, 12778, 328, true
7039, 1566721918659, 12451, 1566721918986, 12778, 327, true
7040, 1566721918661, 12453, 1566721918986, 12778, 325, true
7041, 1566721918662, 12454, 1566721918986, 12778, 324, true
7042, 1566721918662, 12454, 1566721918986, 12778, 324, true
7043, 1566721918663, 12455, 1566721918889, 12681, 226, true
7044, 1566721918664, 12456, 1566721918986, 12778, 322, true
7045, 1566721918665, 12457, 1566721918888, 12680, 223, true
7046, 1566721918666, 12458, 1566721918986, 12778, 320, true
7047, 1566721918666, 12458, 1566721918888, 12680, 222, true
7048, 1566721918667, 12459, 1566721918986, 12778, 319, true
7049, 1566721918668, 12460, 1566721918983, 12775, 315, true
7050, 1566721918669, 12461, 1566721918986, 12778, 317, true
7051, 1566721918670, 12462, 1566721918889, 12681, 219, true
7052, 1566721918671, 12463, 1566721918891, 12683, 220, true
7053, 1566721918671, 12463, 1566721918892, 12684, 221, true
7054, 1566721918672, 12464, 1566721918891, 12683, 219, true
7055, 1566721918675, 12467, 1566721918892, 12684, 217, true
7056, 1566721918675, 12467, 1566721918892, 12684, 217, true
7057, 1566721918675, 12467, 1566721918892, 12684, 217, true
7058, 1566721918676, 12468, 1566721918893, 12685, 217, true
7059, 1566721918678, 12470, 1566721918893, 12685, 215, true
7060, 1566721918678, 12470, 1566721918894, 12686, 216, true
7061, 1566721918678, 12470, 1566721918894, 12686, 216, true
7062, 1566721918680, 12472, 1566721918897, 12689, 217, true
7063, 1566721918680, 12472, 1566721918897, 12689, 217, true
7064, 1566721918682, 12474, 1566721918897, 12689, 215, true
7065, 1566721918682, 12474, 1566721918897, 12689, 215, true
7066, 1566721918684, 12476, 1566721918898, 12690, 214, true
7067, 1566721918684, 12476, 1566721918897, 12689, 213, true
7068, 1566721918685, 12477, 1566721918898, 12690, 213, true
7069, 1566721918686, 12478, 1566721918898, 12690, 212, true
7070, 1566721918688, 12480, 1566721918898, 12690, 210, true
7071, 1566721918689, 12481, 1566721918898, 12690, 209, true
7072, 1566721918690, 12482, 1566721918898, 12690, 208, true
7073, 1566721918690, 12482, 1566721918898, 12690, 208, true
7074, 1566721918692, 12484, 1566721918898, 12690, 206, true
7075, 1566721918694, 12486, 1566721918898, 12690, 204, true
7076, 1566721918696, 12488, 1566721918899, 12691, 203, true
7077, 1566721918696, 12488, 1566721918899, 12691, 203, true
7078, 1566721918697, 12489, 1566721918899, 12691, 202, true
7079, 1566721918697, 12489, 1566721918901, 12693, 204, true
7080, 1566721918698, 12490, 1566721918904, 12696, 206, true
7081, 1566721918699, 12491, 1566721918904, 12696, 205, true
7082, 1566721918699, 12491, 1566721918909, 12701, 210, true
7083, 1566721918704, 12496, 1566721918909, 12701, 205, true
7084, 1566721918705, 12497, 1566721918909, 12701, 204, true
7085, 1566721918707, 12499, 1566721918910, 12702, 203, true
7086, 1566721918707, 12499, 1566721918910, 12702, 203, true
7087, 1566721918708, 12500, 1566721918910, 12702, 202, true
7088, 1566721918708, 12500, 1566721918911, 12703, 203, true
7089, 1566721918709, 12501, 1566721918926, 12718, 217, true
7090, 1566721918709, 12501, 1566721918917, 12709, 208, true
7091, 1566721918710, 12502, 1566721918991, 12783, 281, true
7092, 1566721918751, 12543, 1566721918991, 12783, 240, true
7093, 1566721918752, 12544, 1566721918991, 12783, 239, true
7094, 1566721918752, 12544, 1566721918991, 12783, 239, true
7095, 1566721918753, 12545, 1566721918991, 12783, 238, true
7096, 1566721918753, 12545, 1566721919001, 12793, 248, true
7097, 1566721918760, 12552, 1566721918991, 12783, 231, true
7098, 1566721918772, 12564, 1566721919001, 12793, 229, true
7099, 1566721918772, 12564, 1566721919002, 12794, 230, true
7100, 1566721918774, 12566, 1566721919001, 12793, 227, true
7101, 1566721918775, 12567, 1566721919001, 12793, 226, true
7102, 1566721918779, 12571, 1566721919002, 12794, 223, true
7103, 1566721918780, 12572, 1566721919001, 12793, 221, true
7104, 1566721918781, 12573, 1566721919001, 12793, 220, true
7105, 1566721918782, 12574, 1566721919001, 12793, 219, true
7106, 1566721918782, 12574, 1566721919001, 12793, 219, true
7107, 1566721918783, 12575, 1566721919001, 12793, 218, true
7108, 1566721918784, 12576, 1566721919002, 12794, 218, true
7109, 1566721918785, 12577, 1566721919002, 12794, 217, true
7110, 1566721918787, 12579, 1566721919002, 12794, 215, true
7111, 1566721918791, 12583, 1566721919002, 12794, 211, true
7112, 1566721918792, 12584, 1566721919002, 12794, 210, true
7113, 1566721918792, 12584, 1566721919002, 12794, 210, true
7114, 1566721918792, 12584, 1566721919002, 12794, 210, true
7115, 1566721918793, 12585, 1566721919002, 12794, 209, true
7116, 1566721918793, 12585, 1566721919006, 12798, 213, true
7117, 1566721918794, 12586, 1566721919006, 12798, 212, true
7118, 1566721918796, 12588, 1566721919002, 12794, 206, true
7119, 1566721918797, 12589, 1566721919002, 12794, 205, true
7120, 1566721918799, 12591, 1566721919006, 12798, 207, true
7121, 1566721918800, 12592, 1566721919006, 12798, 206, true
7122, 1566721918800, 12592, 1566721919006, 12798, 206, true
7123, 1566721918800, 12592, 1566721919019, 12811, 219, true
7124, 1566721918801, 12593, 1566721919019, 12811, 218, true
7125, 1566721918802, 12594, 1566721919012, 12804, 210, true
7126, 1566721918803, 12595, 1566721919019, 12811, 216, true
7127, 1566721918803, 12595, 1566721919020, 12812, 217, true
7128, 1566721918804, 12596, 1566721919020, 12812, 216, true
7129, 1566721918804, 12596, 1566721919020, 12812, 216, true
7130, 1566721918804, 12596, 1566721919020, 12812, 216, true
7131, 1566721918809, 12601, 1566721919020, 12812, 211, true
7132, 1566721918810, 12602, 1566721919020, 12812, 210, true
7133, 1566721918810, 12602, 1566721919020, 12812, 210, true
7134, 1566721918812, 12604, 1566721919020, 12812, 208, true
7135, 1566721918812, 12604, 1566721919020, 12812, 208, true
7136, 1566721918813, 12605, 1566721919020, 12812, 207, true
7137, 1566721918814, 12606, 1566721919020, 12812, 206, true
7138, 1566721918815, 12607, 1566721919020, 12812, 205, true
7139, 1566721918815, 12607, 1566721919020, 12812, 205, true
7140, 1566721918817, 12609, 1566721919029, 12821, 212, true
7141, 1566721918817, 12609, 1566721919029, 12821, 212, true
7142, 1566721918819, 12611, 1566721919025, 12817, 206, true
7143, 1566721918819, 12611, 1566721919029, 12821, 210, true
7144, 1566721918820, 12612, 1566721919028, 12820, 208, true
7145, 1566721918820, 12612, 1566721919029, 12821, 209, true
7146, 1566721918821, 12613, 1566721919029, 12821, 208, true
7147, 1566721918822, 12614, 1566721919029, 12821, 207, true
7148, 1566721918823, 12615, 1566721919029, 12821, 206, true
7149, 1566721918824, 12616, 1566721919029, 12821, 205, true
7150, 1566721918825, 12617, 1566721919029, 12821, 204, true
7151, 1566721918826, 12618, 1566721919030, 12822, 204, true
7152, 1566721918827, 12619, 1566721919030, 12822, 203, true
7153, 1566721918828, 12620, 1566721919031, 12823, 203, true
7154, 1566721918829, 12621, 1566721919031, 12823, 202, true
7155, 1566721918829, 12621, 1566721919035, 12827, 206, true
7156, 1566721918830, 12622, 1566721919033, 12825, 203, true
7157, 1566721918831, 12623, 1566721919035, 12827, 204, true
7158, 1566721918832, 12624, 1566721919035, 12827, 203, true
7159, 1566721918833, 12625, 1566721919038, 12830, 205, true
7160, 1566721918834, 12626, 1566721919037, 12829, 203, true
7161, 1566721918834, 12626, 1566721919040, 12832, 206, true
7162, 1566721918835, 12627, 1566721919040, 12832, 205, true
7163, 1566721918836, 12628, 1566721919039, 12831, 203, true
7164, 1566721918837, 12629, 1566721919053, 12845, 216, true
7165, 1566721918838, 12630, 1566721919050, 12842, 212, true
7166, 1566721918838, 12630, 1566721919053, 12845, 215, true
7167, 1566721918839, 12631, 1566721919050, 12842, 211, true
7168, 1566721918839, 12631, 1566721919050, 12842, 211, true
7169, 1566721918840, 12632, 1566721919047, 12839, 207, true
7170, 1566721918840, 12632, 1566721919050, 12842, 210, true
7171, 1566721918841, 12633, 1566721919053, 12845, 212, true
7172, 1566721918841, 12633, 1566721919053, 12845, 212, true
7173, 1566721918842, 12634, 1566721919050, 12842, 208, true
7174, 1566721918843, 12635, 1566721919053, 12845, 210, true
7175, 1566721918843, 12635, 1566721919055, 12847, 212, true
7176, 1566721918843, 12635, 1566721919055, 12847, 212, true
7177, 1566721918844, 12636, 1566721919055, 12847, 211, true
7178, 1566721918845, 12637, 1566721919055, 12847, 210, true
7179, 1566721918853, 12645, 1566721919057, 12849, 204, true
7180, 1566721918854, 12646, 1566721919060, 12852, 206, true
7181, 1566721918854, 12646, 1566721919066, 12858, 212, true
7182, 1566721918854, 12646, 1566721919064, 12856, 210, true
7183, 1566721918855, 12647, 1566721919070, 12862, 215, true
7184, 1566721918855, 12647, 1566721919067, 12859, 212, true
7185, 1566721918857, 12649, 1566721919066, 12858, 209, true
7186, 1566721918902, 12694, 1566721919110, 12902, 208, true
7187, 1566721918904, 12696, 1566721919111, 12903, 207, true
7188, 1566721918912, 12704, 1566721919115, 12907, 203, true
7189, 1566721918912, 12704, 1566721919115, 12907, 203, true
7190, 1566721918913, 12705, 1566721919120, 12912, 207, true
7191, 1566721918913, 12705, 1566721919121, 12913, 208, true
7192, 1566721918913, 12705, 1566721919121, 12913, 208, true
7193, 1566721918914, 12706, 1566721919120, 12912, 206, true
7194, 1566721918914, 12706, 1566721919120, 12912, 206, true
7195, 1566721918915, 12707, 1566721919121, 12913, 206, true
7196, 1566721918916, 12708, 1566721919121, 12913, 205, true
7197, 1566721918918, 12710, 1566721919121, 12913, 203, true
7198, 1566721918918, 12710, 1566721919126, 12918, 208, true
7199, 1566721918919, 12711, 1566721919128, 12920, 209, true
7200, 1566721918919, 12711, 1566721919128, 12920, 209, true
7201, 1566721918919, 12711, 1566721919128, 12920, 209, true
7202, 1566721918920, 12712, 1566721919128, 12920, 208, true
7203, 1566721918920, 12712, 1566721919127, 12919, 207, true
7204, 1566721918921, 12713, 1566721919127, 12919, 206, true
7205, 1566721918922, 12714, 1566721919128, 12920, 206, true
7206, 1566721918923, 12715, 1566721919129, 12921, 206, true
7207, 1566721918926, 12718, 1566721919129, 12921, 203, true
7208, 1566721918927, 12719, 1566721919135, 12927, 208, true
7209, 1566721918927, 12719, 1566721919131, 12923, 204, true
7210, 1566721918928, 12720, 1566721919135, 12927, 207, true
7211, 1566721918929, 12721, 1566721919135, 12927, 206, true
7212, 1566721918930, 12722, 1566721919135, 12927, 205, true
7213, 1566721918931, 12723, 1566721919138, 12930, 207, true
7214, 1566721918931, 12723, 1566721919138, 12930, 207, true
7215, 1566721918932, 12724, 1566721919138, 12930, 206, true
7216, 1566721918932, 12724, 1566721919138, 12930, 206, true
7217, 1566721918932, 12724, 1566721919138, 12930, 206, true
7218, 1566721918933, 12725, 1566721919138, 12930, 205, true
7219, 1566721918934, 12726, 1566721919138, 12930, 204, true
7220, 1566721918936, 12728, 1566721919140, 12932, 204, true
7221, 1566721918937, 12729, 1566721919139, 12931, 202, true
7222, 1566721918937, 12729, 1566721919147, 12939, 210, true
7223, 1566721918938, 12730, 1566721919142, 12934, 204, true
7224, 1566721918939, 12731, 1566721919144, 12936, 205, true
7225, 1566721918940, 12732, 1566721919145, 12937, 205, true
7226, 1566721918941, 12733, 1566721919147, 12939, 206, true
7227, 1566721918942, 12734, 1566721919150, 12942, 208, true
7228, 1566721918943, 12735, 1566721919153, 12945, 210, true
7229, 1566721918943, 12735, 1566721919153, 12945, 210, true
7230, 1566721918944, 12736, 1566721919153, 12945, 209, true
7231, 1566721918945, 12737, 1566721919157, 12949, 212, true
7232, 1566721918946, 12738, 1566721919156, 12948, 210, true
7233, 1566721918947, 12739, 1566721919156, 12948, 209, true
7234, 1566721918948, 12740, 1566721919156, 12948, 208, true
7235, 1566721918949, 12741, 1566721919156, 12948, 207, true
7236, 1566721918951, 12743, 1566721919159, 12951, 208, true
7237, 1566721918952, 12744, 1566721919159, 12951, 207, true
7238, 1566721918952, 12744, 1566721919159, 12951, 207, true
7239, 1566721918953, 12745, 1566721919159, 12951, 206, true
7240, 1566721918955, 12747, 1566721919160, 12952, 205, true
7241, 1566721918955, 12747, 1566721919164, 12956, 209, true
7242, 1566721918955, 12747, 1566721919160, 12952, 205, true
7243, 1566721918956, 12748, 1566721919160, 12952, 204, true
7244, 1566721918957, 12749, 1566721919164, 12956, 207, true
7245, 1566721918958, 12750, 1566721919164, 12956, 206, true
7246, 1566721918958, 12750, 1566721919164, 12956, 206, true
7247, 1566721918959, 12751, 1566721919164, 12956, 205, true
7248, 1566721918959, 12751, 1566721919165, 12957, 206, true
7249, 1566721918959, 12751, 1566721919166, 12958, 207, true
7250, 1566721918960, 12752, 1566721919168, 12960, 208, true
7251, 1566721918961, 12753, 1566721919167, 12959, 206, true
7252, 1566721918962, 12754, 1566721919168, 12960, 206, true
7253, 1566721918963, 12755, 1566721919168, 12960, 205, true
7254, 1566721918964, 12756, 1566721919171, 12963, 207, true
7255, 1566721918965, 12757, 1566721919171, 12963, 206, true
7256, 1566721918966, 12758, 1566721919171, 12963, 205, true
7257, 1566721918967, 12759, 1566721919174, 12966, 207, true
7258, 1566721918968, 12760, 1566721919173, 12965, 205, true
7259, 1566721918969, 12761, 1566721919174, 12966, 205, true
7260, 1566721918970, 12762, 1566721919175, 12967, 205, true
7261, 1566721918971, 12763, 1566721919194, 12986, 223, true
7262, 1566721918972, 12764, 1566721919192, 12984, 220, true
7263, 1566721918973, 12765, 1566721919206, 12998, 233, true
7264, 1566721918973, 12765, 1566721919229, 13021, 256, true
7265, 1566721918974, 12766, 1566721919209, 13001, 235, true
7266, 1566721918974, 12766, 1566721919230, 13022, 256, true
7267, 1566721918974, 12766, 1566721919230, 13022, 256, true
7268, 1566721918975, 12767, 1566721919206, 12998, 231, true
7269, 1566721918975, 12767, 1566721919209, 13001, 234, true
7270, 1566721918975, 12767, 1566721919230, 13022, 255, true
7271, 1566721918976, 12768, 1566721919225, 13017, 249, true
7272, 1566721918976, 12768, 1566721919220, 13012, 244, true
7273, 1566721918976, 12768, 1566721919206, 12998, 230, true
7274, 1566721918976, 12768, 1566721919226, 13018, 250, true
7275, 1566721918977, 12769, 1566721919227, 13019, 250, true
7276, 1566721918977, 12769, 1566721919206, 12998, 229, true
7277, 1566721918977, 12769, 1566721919196, 12988, 219, true
7278, 1566721918977, 12769, 1566721919230, 13022, 253, true
7279, 1566721918978, 12770, 1566721919197, 12989, 219, true
7280, 1566721918978, 12770, 1566721919197, 12989, 219, true
7281, 1566721918978, 12770, 1566721919211, 13003, 233, true
7282, 1566721918979, 12771, 1566721919206, 12998, 227, true
7283, 1566721918979, 12771, 1566721919197, 12989, 218, true
7284, 1566721918979, 12771, 1566721919220, 13012, 241, true
7285, 1566721918980, 12772, 1566721919230, 13022, 250, true
7286, 1566721918980, 12772, 1566721919209, 13001, 229, true
7287, 1566721918980, 12772, 1566721919222, 13014, 242, true
7288, 1566721918980, 12772, 1566721919230, 13022, 250, true
7289, 1566721918981, 12773, 1566721919212, 13004, 231, true
7290, 1566721918981, 12773, 1566721919216, 13008, 235, true
7291, 1566721918981, 12773, 1566721919206, 12998, 225, true
7292, 1566721918981, 12773, 1566721919213, 13005, 232, true
7293, 1566721918982, 12774, 1566721919230, 13022, 248, true
7294, 1566721918982, 12774, 1566721919215, 13007, 233, true
7295, 1566721918983, 12775, 1566721919227, 13019, 244, true
7296, 1566721918983, 12775, 1566721919209, 13001, 226, true
7297, 1566721918983, 12775, 1566721919209, 13001, 226, true
7298, 1566721918983, 12775, 1566721919218, 13010, 235, true
7299, 1566721918984, 12776, 1566721919206, 12998, 222, true
7300, 1566721918984, 12776, 1566721919230, 13022, 246, true
7301, 1566721918984, 12776, 1566721919215, 13007, 231, true
7302, 1566721918985, 12777, 1566721919206, 12998, 221, true
7303, 1566721918985, 12777, 1566721919212, 13004, 227, true
7304, 1566721918987, 12779, 1566721919209, 13001, 222, true
7305, 1566721918988, 12780, 1566721919225, 13017, 237, true
7306, 1566721918988, 12780, 1566721919230, 13022, 242, true
7307, 1566721918988, 12780, 1566721919230, 13022, 242, true
7308, 1566721918988, 12780, 1566721919212, 13004, 224, true
7309, 1566721918991, 12783, 1566721919214, 13006, 223, true
7310, 1566721919032, 12824, 1566721919235, 13027, 203, true
7311, 1566721919041, 12833, 1566721919248, 13040, 207, true
7312, 1566721919042, 12834, 1566721919248, 13040, 206, true
7313, 1566721919043, 12835, 1566721919245, 13037, 202, true
7314, 1566721919043, 12835, 1566721919248, 13040, 205, true
7315, 1566721919044, 12836, 1566721919248, 13040, 204, true
7316, 1566721919044, 12836, 1566721919251, 13043, 207, true
7317, 1566721919045, 12837, 1566721919251, 13043, 206, true
7318, 1566721919046, 12838, 1566721919256, 13048, 210, true
7319, 1566721919050, 12842, 1566721919255, 13047, 205, true
7320, 1566721919057, 12849, 1566721919266, 13058, 209, true
7321, 1566721919059, 12851, 1566721919264, 13056, 205, true
7322, 1566721919059, 12851, 1566721919264, 13056, 205, true
7323, 1566721919061, 12853, 1566721919263, 13055, 202, true
7324, 1566721919062, 12854, 1566721919267, 13059, 205, true
7325, 1566721919063, 12855, 1566721919267, 13059, 204, true
7326, 1566721919065, 12857, 1566721919269, 13061, 204, true
7327, 1566721919068, 12860, 1566721919270, 13062, 202, true
7328, 1566721919069, 12861, 1566721919271, 13063, 202, true
7329, 1566721919070, 12862, 1566721919276, 13068, 206, true
7330, 1566721919071, 12863, 1566721919275, 13067, 204, true
7331, 1566721919073, 12865, 1566721919276, 13068, 203, true
7332, 1566721919075, 12867, 1566721919279, 13071, 204, true
7333, 1566721919076, 12868, 1566721919280, 13072, 204, true
7334, 1566721919078, 12870, 1566721919285, 13077, 207, true
7335, 1566721919080, 12872, 1566721919285, 13077, 205, true
7336, 1566721919081, 12873, 1566721919285, 13077, 204, true
7337, 1566721919083, 12875, 1566721919287, 13079, 204, true
7338, 1566721919085, 12877, 1566721919288, 13080, 203, true
7339, 1566721919087, 12879, 1566721919291, 13083, 204, true
7340, 1566721919088, 12880, 1566721919295, 13087, 207, true
7341, 1566721919090, 12882, 1566721919295, 13087, 205, true
7342, 1566721919091, 12883, 1566721919295, 13087, 204, true
7343, 1566721919092, 12884, 1566721919296, 13088, 204, true
7344, 1566721919093, 12885, 1566721919296, 13088, 203, true
7345, 1566721919094, 12886, 1566721919298, 13090, 204, true
7346, 1566721919095, 12887, 1566721919298, 13090, 203, true
7347, 1566721919096, 12888, 1566721919301, 13093, 205, true
7348, 1566721919096, 12888, 1566721919301, 13093, 205, true
7349, 1566721919097, 12889, 1566721919301, 13093, 204, true
7350, 1566721919098, 12890, 1566721919304, 13096, 206, true
7351, 1566721919099, 12891, 1566721919304, 13096, 205, true
7352, 1566721919100, 12892, 1566721919304, 13096, 204, true
7353, 1566721919101, 12893, 1566721919304, 13096, 203, true
7354, 1566721919102, 12894, 1566721919306, 13098, 204, true
7355, 1566721919103, 12895, 1566721919310, 13102, 207, true
7356, 1566721919104, 12896, 1566721919310, 13102, 206, true
7357, 1566721919104, 12896, 1566721919307, 13099, 203, true
7358, 1566721919104, 12896, 1566721919311, 13103, 207, true
7359, 1566721919105, 12897, 1566721919310, 13102, 205, true
7360, 1566721919106, 12898, 1566721919309, 13101, 203, true
7361, 1566721919107, 12899, 1566721919317, 13109, 210, true
7362, 1566721919108, 12900, 1566721919313, 13105, 205, true
7363, 1566721919110, 12902, 1566721919317, 13109, 207, true
7364, 1566721919112, 12904, 1566721919317, 13109, 205, true
7365, 1566721919112, 12904, 1566721919317, 13109, 205, true
7366, 1566721919113, 12905, 1566721919319, 13111, 206, true
7367, 1566721919115, 12907, 1566721919318, 13110, 203, true
7368, 1566721919116, 12908, 1566721919319, 13111, 203, true
7369, 1566721919116, 12908, 1566721919319, 13111, 203, true
7370, 1566721919117, 12909, 1566721919328, 13120, 211, true
7371, 1566721919121, 12913, 1566721919328, 13120, 207, true
7372, 1566721919122, 12914, 1566721919330, 13122, 208, true
7373, 1566721919122, 12914, 1566721919330, 13122, 208, true
7374, 1566721919123, 12915, 1566721919331, 13123, 208, true
7375, 1566721919123, 12915, 1566721919334, 13126, 211, true
7376, 1566721919124, 12916, 1566721919332, 13124, 208, true
7377, 1566721919130, 12922, 1566721919335, 13127, 205, true
7378, 1566721919130, 12922, 1566721919334, 13126, 204, true
7379, 1566721919132, 12924, 1566721919355, 13147, 223, true
7380, 1566721919133, 12925, 1566721919348, 13140, 215, true
7381, 1566721919133, 12925, 1566721919355, 13147, 222, true
7382, 1566721919140, 12932, 1566721919355, 13147, 215, true
7383, 1566721919140, 12932, 1566721919349, 13141, 209, true
7384, 1566721919141, 12933, 1566721919349, 13141, 208, true
7385, 1566721919141, 12933, 1566721919352, 13144, 211, true
7386, 1566721919141, 12933, 1566721919349, 13141, 208, true
7387, 1566721919141, 12933, 1566721919364, 13156, 223, true
7388, 1566721919141, 12933, 1566721919364, 13156, 223, true
7389, 1566721919142, 12934, 1566721919364, 13156, 222, true
7390, 1566721919147, 12939, 1566721919364, 13156, 217, true
7391, 1566721919147, 12939, 1566721919357, 13149, 210, true
7392, 1566721919169, 12961, 1566721919377, 13169, 208, true
7393, 1566721919170, 12962, 1566721919386, 13178, 216, true
7394, 1566721919171, 12963, 1566721919382, 13174, 211, true
7395, 1566721919176, 12968, 1566721919386, 13178, 210, true
7396, 1566721919177, 12969, 1566721919387, 13179, 210, true
7397, 1566721919177, 12969, 1566721919386, 13178, 209, true
7398, 1566721919177, 12969, 1566721919387, 13179, 210, true
7399, 1566721919178, 12970, 1566721919388, 13180, 210, true
7400, 1566721919178, 12970, 1566721919386, 13178, 208, true
7401, 1566721919178, 12970, 1566721919387, 13179, 209, true
7402, 1566721919179, 12971, 1566721919387, 13179, 208, true
7403, 1566721919180, 12972, 1566721919390, 13182, 210, true
7404, 1566721919181, 12973, 1566721919389, 13181, 208, true
7405, 1566721919183, 12975, 1566721919391, 13183, 208, true
7406, 1566721919184, 12976, 1566721919389, 13181, 205, true
7407, 1566721919185, 12977, 1566721919395, 13187, 210, true
7408, 1566721919186, 12978, 1566721919395, 13187, 209, true
7409, 1566721919187, 12979, 1566721919391, 13183, 204, true
7410, 1566721919188, 12980, 1566721919395, 13187, 207, true
7411, 1566721919188, 12980, 1566721919395, 13187, 207, true
7412, 1566721919191, 12983, 1566721919406, 13198, 215, true
7413, 1566721919192, 12984, 1566721919397, 13189, 205, true
7414, 1566721919192, 12984, 1566721919399, 13191, 207, true
7415, 1566721919194, 12986, 1566721919399, 13191, 205, true
7416, 1566721919198, 12990, 1566721919406, 13198, 208, true
7417, 1566721919198, 12990, 1566721919406, 13198, 208, true
7418, 1566721919199, 12991, 1566721919402, 13194, 203, true
7419, 1566721919199, 12991, 1566721919406, 13198, 207, true
7420, 1566721919199, 12991, 1566721919406, 13198, 207, true
7421, 1566721919200, 12992, 1566721919412, 13204, 212, true
7422, 1566721919201, 12993, 1566721919415, 13207, 214, true
7423, 1566721919202, 12994, 1566721919423, 13215, 221, true
7424, 1566721919209, 13001, 1566721919418, 13210, 209, true
7425, 1566721919216, 13008, 1566721919430, 13222, 214, true
7426, 1566721919216, 13008, 1566721919430, 13222, 214, true
7427, 1566721919217, 13009, 1566721919430, 13222, 213, true
7428, 1566721919223, 13015, 1566721919432, 13224, 209, true
7429, 1566721919223, 13015, 1566721919432, 13224, 209, true
7430, 1566721919224, 13016, 1566721919434, 13226, 210, true
7431, 1566721919232, 13024, 1566721919443, 13235, 211, true
7432, 1566721919233, 13025, 1566721919435, 13227, 202, true
7433, 1566721919233, 13025, 1566721919437, 13229, 204, true
7434, 1566721919236, 13028, 1566721919440, 13232, 204, true
7435, 1566721919236, 13028, 1566721919450, 13242, 214, true
7436, 1566721919236, 13028, 1566721919450, 13242, 214, true
7437, 1566721919236, 13028, 1566721919450, 13242, 214, true
7438, 1566721919237, 13029, 1566721919450, 13242, 213, true
7439, 1566721919238, 13030, 1566721919444, 13236, 206, true
7440, 1566721919239, 13031, 1566721919443, 13235, 204, true
7441, 1566721919239, 13031, 1566721919450, 13242, 211, true
7442, 1566721919241, 13033, 1566721919449, 13241, 208, true
7443, 1566721919243, 13035, 1566721919447, 13239, 204, true
7444, 1566721919244, 13036, 1566721919450, 13242, 206, true
7445, 1566721919246, 13038, 1566721919452, 13244, 206, true
7446, 1566721919250, 13042, 1566721919458, 13250, 208, true
7447, 1566721919252, 13044, 1566721919461, 13253, 209, true
7448, 1566721919253, 13045, 1566721919461, 13253, 208, true
7449, 1566721919253, 13045, 1566721919458, 13250, 205, true
7450, 1566721919253, 13045, 1566721919466, 13258, 213, true
7451, 1566721919254, 13046, 1566721919461, 13253, 207, true
7452, 1566721919257, 13049, 1566721919466, 13258, 209, true
7453, 1566721919258, 13050, 1566721919466, 13258, 208, true
7454, 1566721919258, 13050, 1566721919466, 13258, 208, true
7455, 1566721919260, 13052, 1566721919466, 13258, 206, true
7456, 1566721919263, 13055, 1566721919468, 13260, 205, true
7457, 1566721919265, 13057, 1566721919470, 13262, 205, true
7458, 1566721919267, 13059, 1566721919475, 13267, 208, true
7459, 1566721919268, 13060, 1566721919475, 13267, 207, true
7460, 1566721919268, 13060, 1566721919471, 13263, 203, true
7461, 1566721919269, 13061, 1566721919475, 13267, 206, true
7462, 1566721919271, 13063, 1566721919475, 13267, 204, true
7463, 1566721919272, 13064, 1566721919475, 13267, 203, true
7464, 1566721919272, 13064, 1566721919476, 13268, 204, true
7465, 1566721919273, 13065, 1566721919480, 13272, 207, true
7466, 1566721919273, 13065, 1566721919480, 13272, 207, true
7467, 1566721919274, 13066, 1566721919481, 13273, 207, true
7468, 1566721919276, 13068, 1566721919483, 13275, 207, true
7469, 1566721919277, 13069, 1566721919483, 13275, 206, true
7470, 1566721919277, 13069, 1566721919483, 13275, 206, true
7471, 1566721919278, 13070, 1566721919481, 13273, 203, true
7472, 1566721919281, 13073, 1566721919483, 13275, 202, true
7473, 1566721919281, 13073, 1566721919485, 13277, 204, true
7474, 1566721919282, 13074, 1566721919487, 13279, 205, true
7475, 1566721919282, 13074, 1566721919488, 13280, 206, true
7476, 1566721919286, 13078, 1566721919489, 13281, 203, true
7477, 1566721919287, 13079, 1566721919495, 13287, 208, true
7478, 1566721919288, 13080, 1566721919495, 13287, 207, true
7479, 1566721919289, 13081, 1566721919495, 13287, 206, true
7480, 1566721919291, 13083, 1566721919495, 13287, 204, true
7481, 1566721919292, 13084, 1566721919499, 13291, 207, true
7482, 1566721919293, 13085, 1566721919500, 13292, 207, true
7483, 1566721919296, 13088, 1566721919506, 13298, 210, true
7484, 1566721919297, 13089, 1566721919505, 13297, 208, true
7485, 1566721919297, 13089, 1566721919506, 13298, 209, true
7486, 1566721919299, 13091, 1566721919502, 13294, 203, true
7487, 1566721919302, 13094, 1566721919508, 13300, 206, true
7488, 1566721919305, 13097, 1566721919510, 13302, 205, true
7489, 1566721919312, 13104, 1566721919520, 13312, 208, true
7490, 1566721919321, 13113, 1566721919527, 13319, 206, true
7491, 1566721919321, 13113, 1566721919527, 13319, 206, true
7492, 1566721919323, 13115, 1566721919530, 13322, 207, true
7493, 1566721919323, 13115, 1566721919530, 13322, 207, true
7494, 1566721919323, 13115, 1566721919529, 13321, 206, true
7495, 1566721919324, 13116, 1566721919528, 13320, 204, true
7496, 1566721919326, 13118, 1566721919535, 13327, 209, true
7497, 1566721919329, 13121, 1566721919535, 13327, 206, true
7498, 1566721919331, 13123, 1566721919541, 13333, 210, true
7499, 1566721919332, 13124, 1566721919535, 13327, 203, true
7500, 1566721919333, 13125, 1566721919537, 13329, 204, true
7501, 1566721919336, 13128, 1566721919543, 13335, 207, true
7502, 1566721919336, 13128, 1566721919543, 13335, 207, true
7503, 1566721919336, 13128, 1566721919541, 13333, 205, true
7504, 1566721919336, 13128, 1566721919543, 13335, 207, true
7505, 1566721919338, 13130, 1566721919541, 13333, 203, true
7506, 1566721919338, 13130, 1566721919543, 13335, 205, true
7507, 1566721919339, 13131, 1566721919544, 13336, 205, true
7508, 1566721919340, 13132, 1566721919544, 13336, 204, true
7509, 1566721919340, 13132, 1566721919550, 13342, 210, true
7510, 1566721919341, 13133, 1566721919544, 13336, 203, true
7511, 1566721919342, 13134, 1566721919550, 13342, 208, true
7512, 1566721919343, 13135, 1566721919551, 13343, 208, true
7513, 1566721919345, 13137, 1566721919550, 13342, 205, true
7514, 1566721919345, 13137, 1566721919553, 13345, 208, true
7515, 1566721919346, 13138, 1566721919558, 13350, 212, true
7516, 1566721919347, 13139, 1566721919553, 13345, 206, true
7517, 1566721919349, 13141, 1566721919553, 13345, 204, true
7518, 1566721919350, 13142, 1566721919557, 13349, 207, true
7519, 1566721919350, 13142, 1566721919556, 13348, 206, true
7520, 1566721919350, 13142, 1566721919557, 13349, 207, true
7521, 1566721919351, 13143, 1566721919558, 13350, 207, true
7522, 1566721919355, 13147, 1566721919561, 13353, 206, true
7523, 1566721919355, 13147, 1566721919560, 13352, 205, true
7524, 1566721919355, 13147, 1566721919561, 13353, 206, true
7525, 1566721919356, 13148, 1566721919561, 13353, 205, true
7526, 1566721919357, 13149, 1566721919563, 13355, 206, true
7527, 1566721919358, 13150, 1566721919566, 13358, 208, true
7528, 1566721919359, 13151, 1566721919565, 13357, 206, true
7529, 1566721919359, 13151, 1566721919566, 13358, 207, true
7530, 1566721919360, 13152, 1566721919566, 13358, 206, true
7531, 1566721919361, 13153, 1566721919570, 13362, 209, true
7532, 1566721919362, 13154, 1566721919573, 13365, 211, true
7533, 1566721919364, 13156, 1566721919573, 13365, 209, true
7534, 1566721919365, 13157, 1566721919574, 13366, 209, true
7535, 1566721919365, 13157, 1566721919574, 13366, 209, true
7536, 1566721919365, 13157, 1566721919573, 13365, 208, true
7537, 1566721919365, 13157, 1566721919570, 13362, 205, true
7538, 1566721919365, 13157, 1566721919574, 13366, 209, true
7539, 1566721919366, 13158, 1566721919573, 13365, 207, true
7540, 1566721919367, 13159, 1566721919574, 13366, 207, true
7541, 1566721919368, 13160, 1566721919574, 13366, 206, true
7542, 1566721919369, 13161, 1566721919576, 13368, 207, true
7543, 1566721919370, 13162, 1566721919579, 13371, 209, true
7544, 1566721919371, 13163, 1566721919579, 13371, 208, true
7545, 1566721919372, 13164, 1566721919578, 13370, 206, true
7546, 1566721919377, 13169, 1566721919587, 13379, 210, true
7547, 1566721919377, 13169, 1566721919587, 13379, 210, true
7548, 1566721919378, 13170, 1566721919582, 13374, 204, true
7549, 1566721919378, 13170, 1566721919588, 13380, 210, true
7550, 1566721919378, 13170, 1566721919588, 13380, 210, true
7551, 1566721919379, 13171, 1566721919588, 13380, 209, true
7552, 1566721919382, 13174, 1566721919588, 13380, 206, true
7553, 1566721919382, 13174, 1566721919588, 13380, 206, true
7554, 1566721919383, 13175, 1566721919592, 13384, 209, true
7555, 1566721919387, 13179, 1566721919592, 13384, 205, true
7556, 1566721919392, 13184, 1566721919597, 13389, 205, true
7557, 1566721919396, 13188, 1566721919603, 13395, 207, true
7558, 1566721919396, 13188, 1566721919603, 13395, 207, true
7559, 1566721919398, 13190, 1566721919601, 13393, 203, true
7560, 1566721919399, 13191, 1566721919603, 13395, 204, true
7561, 1566721919399, 13191, 1566721919601, 13393, 202, true
7562, 1566721919400, 13192, 1566721919603, 13395, 203, true
7563, 1566721919400, 13192, 1566721919603, 13395, 203, true
7564, 1566721919402, 13194, 1566721919607, 13399, 205, true
7565, 1566721919402, 13194, 1566721919604, 13396, 202, true
7566, 1566721919402, 13194, 1566721919607, 13399, 205, true
7567, 1566721919406, 13198, 1566721919609, 13401, 203, true
7568, 1566721919406, 13198, 1566721919609, 13401, 203, true
7569, 1566721919407, 13199, 1566721919614, 13406, 207, true
7570, 1566721919408, 13200, 1566721919610, 13402, 202, true
7571, 1566721919408, 13200, 1566721919614, 13406, 206, true
7572, 1566721919409, 13201, 1566721919615, 13407, 206, true
7573, 1566721919409, 13201, 1566721919615, 13407, 206, true
7574, 1566721919410, 13202, 1566721919615, 13407, 205, true
7575, 1566721919412, 13204, 1566721919616, 13408, 204, true
7576, 1566721919412, 13204, 1566721919616, 13408, 204, true
7577, 1566721919413, 13205, 1566721919616, 13408, 203, true
7578, 1566721919415, 13207, 1566721919618, 13410, 203, true
7579, 1566721919415, 13207, 1566721919621, 13413, 206, true
7580, 1566721919416, 13208, 1566721919621, 13413, 205, true
7581, 1566721919418, 13210, 1566721919621, 13413, 203, true
7582, 1566721919418, 13210, 1566721919624, 13416, 206, true
7583, 1566721919419, 13211, 1566721919624, 13416, 205, true
7584, 1566721919420, 13212, 1566721919624, 13416, 204, true
7585, 1566721919421, 13213, 1566721919629, 13421, 208, true
7586, 1566721919424, 13216, 1566721919629, 13421, 205, true
7587, 1566721919425, 13217, 1566721919637, 13429, 212, true
7588, 1566721919430, 13222, 1566721919637, 13429, 207, true
7589, 1566721919432, 13224, 1566721919637, 13429, 205, true
7590, 1566721919433, 13225, 1566721919637, 13429, 204, true
7591, 1566721919434, 13226, 1566721919642, 13434, 208, true
7592, 1566721919434, 13226, 1566721919637, 13429, 203, true
7593, 1566721919436, 13228, 1566721919646, 13438, 210, true
7594, 1566721919436, 13228, 1566721919642, 13434, 206, true
7595, 1566721919437, 13229, 1566721919646, 13438, 209, true
7596, 1566721919437, 13229, 1566721919641, 13433, 204, true
7597, 1566721919438, 13230, 1566721919646, 13438, 208, true
7598, 1566721919440, 13232, 1566721919645, 13437, 205, true
7599, 1566721919440, 13232, 1566721919649, 13441, 209, true
7600, 1566721919444, 13236, 1566721919647, 13439, 203, true
7601, 1566721919445, 13237, 1566721919652, 13444, 207, true
7602, 1566721919445, 13237, 1566721919651, 13443, 206, true
7603, 1566721919446, 13238, 1566721919652, 13444, 206, true
7604, 1566721919452, 13244, 1566721919655, 13447, 203, true
7605, 1566721919453, 13245, 1566721919655, 13447, 202, true
7606, 1566721919453, 13245, 1566721919655, 13447, 202, true
7607, 1566721919454, 13246, 1566721919657, 13449, 203, true
7608, 1566721919454, 13246, 1566721919656, 13448, 202, true
7609, 1566721919455, 13247, 1566721919657, 13449, 202, true
7610, 1566721919455, 13247, 1566721919659, 13451, 204, true
7611, 1566721919456, 13248, 1566721919659, 13451, 203, true
7612, 1566721919458, 13250, 1566721919661, 13453, 203, true
7613, 1566721919458, 13250, 1566721919661, 13453, 203, true
7614, 1566721919459, 13251, 1566721919662, 13454, 203, true
7615, 1566721919461, 13253, 1566721919665, 13457, 204, true
7616, 1566721919462, 13254, 1566721919664, 13456, 202, true
7617, 1566721919462, 13254, 1566721919665, 13457, 203, true
7618, 1566721919463, 13255, 1566721919667, 13459, 204, true
7619, 1566721919465, 13257, 1566721919668, 13460, 203, true
7620, 1566721919468, 13260, 1566721919672, 13464, 204, true
7621, 1566721919472, 13264, 1566721919680, 13472, 208, true
7622, 1566721919472, 13264, 1566721919675, 13467, 203, true
7623, 1566721919472, 13264, 1566721919676, 13468, 204, true
7624, 1566721919477, 13269, 1566721919680, 13472, 203, true
7625, 1566721919478, 13270, 1566721919688, 13480, 210, true
7626, 1566721919485, 13277, 1566721919694, 13486, 209, true
7627, 1566721919487, 13279, 1566721919694, 13486, 207, true
7628, 1566721919490, 13282, 1566721919694, 13486, 204, true
7629, 1566721919491, 13283, 1566721919694, 13486, 203, true
7630, 1566721919492, 13284, 1566721919696, 13488, 204, true
7631, 1566721919500, 13292, 1566721919705, 13497, 205, true
7632, 1566721919500, 13292, 1566721919706, 13498, 206, true
7633, 1566721919501, 13293, 1566721919705, 13497, 204, true
7634, 1566721919502, 13294, 1566721919706, 13498, 204, true
7635, 1566721919503, 13295, 1566721919707, 13499, 204, true
7636, 1566721919503, 13295, 1566721919707, 13499, 204, true
7637, 1566721919504, 13296, 1566721919708, 13500, 204, true
7638, 1566721919506, 13298, 1566721919710, 13502, 204, true
7639, 1566721919507, 13299, 1566721919716, 13508, 209, true
7640, 1566721919508, 13300, 1566721919716, 13508, 208, true
7641, 1566721919509, 13301, 1566721919716, 13508, 207, true
7642, 1566721919509, 13301, 1566721919716, 13508, 207, true
7643, 1566721919511, 13303, 1566721919724, 13516, 213, true
7644, 1566721919511, 13303, 1566721919726, 13518, 215, true
7645, 1566721919511, 13303, 1566721919727, 13519, 216, true
7646, 1566721919512, 13304, 1566721919723, 13515, 211, true
7647, 1566721919512, 13304, 1566721919727, 13519, 215, true
7648, 1566721919512, 13304, 1566721919723, 13515, 211, true
7649, 1566721919513, 13305, 1566721919739, 13531, 226, true
7650, 1566721919513, 13305, 1566721919741, 13533, 228, true
7651, 1566721919514, 13306, 1566721919738, 13530, 224, true
7652, 1566721919514, 13306, 1566721919741, 13533, 227, true
7653, 1566721919514, 13306, 1566721919741, 13533, 227, true
7654, 1566721919515, 13307, 1566721919741, 13533, 226, true
7655, 1566721919515, 13307, 1566721919734, 13526, 219, true
7656, 1566721919515, 13307, 1566721919738, 13530, 223, true
7657, 1566721919516, 13308, 1566721919738, 13530, 222, true
7658, 1566721919516, 13308, 1566721919741, 13533, 225, true
7659, 1566721919516, 13308, 1566721919738, 13530, 222, true
7660, 1566721919517, 13309, 1566721919739, 13531, 222, true
7661, 1566721919517, 13309, 1566721919738, 13530, 221, true
7662, 1566721919517, 13309, 1566721919738, 13530, 221, true
7663, 1566721919518, 13310, 1566721919738, 13530, 220, true
7664, 1566721919518, 13310, 1566721919741, 13533, 223, true
7665, 1566721919518, 13310, 1566721919741, 13533, 223, true
7666, 1566721919519, 13311, 1566721919741, 13533, 222, true
7667, 1566721919519, 13311, 1566721919741, 13533, 222, true
7668, 1566721919522, 13314, 1566721919738, 13530, 216, true
7669, 1566721919525, 13317, 1566721919739, 13531, 214, true
7670, 1566721919530, 13322, 1566721919739, 13531, 209, true
7671, 1566721919531, 13323, 1566721919739, 13531, 208, true
7672, 1566721919531, 13323, 1566721919739, 13531, 208, true
7673, 1566721919532, 13324, 1566721919745, 13537, 213, true
7674, 1566721919532, 13324, 1566721919741, 13533, 209, true
7675, 1566721919533, 13325, 1566721919741, 13533, 208, true
7676, 1566721919535, 13327, 1566721919741, 13533, 206, true
7677, 1566721919536, 13328, 1566721919741, 13533, 205, true
7678, 1566721919539, 13331, 1566721919750, 13542, 211, true
7679, 1566721919545, 13337, 1566721919750, 13542, 205, true
7680, 1566721919546, 13338, 1566721919749, 13541, 203, true
7681, 1566721919546, 13338, 1566721919751, 13543, 205, true
7682, 1566721919547, 13339, 1566721919752, 13544, 205, true
7683, 1566721919547, 13339, 1566721919751, 13543, 204, true
7684, 1566721919548, 13340, 1566721919753, 13545, 205, true
7685, 1566721919551, 13343, 1566721919755, 13547, 204, true
7686, 1566721919551, 13343, 1566721919756, 13548, 205, true
7687, 1566721919554, 13346, 1566721919757, 13549, 203, true
7688, 1566721919554, 13346, 1566721919757, 13549, 203, true
7689, 1566721919555, 13347, 1566721919761, 13553, 206, true
7690, 1566721919558, 13350, 1566721919816, 13608, 258, true
7691, 1566721919559, 13351, 1566721919816, 13608, 257, true
7692, 1566721919559, 13351, 1566721919816, 13608, 257, true
7693, 1566721919559, 13351, 1566721919816, 13608, 257, true
7694, 1566721919567, 13359, 1566721919816, 13608, 249, true
7695, 1566721919567, 13359, 1566721919816, 13608, 249, true
7696, 1566721919567, 13359, 1566721919816, 13608, 249, true
7697, 1566721919568, 13360, 1566721919816, 13608, 248, true
7698, 1566721919568, 13360, 1566721919816, 13608, 248, true
7699, 1566721919575, 13367, 1566721919817, 13609, 242, true
7700, 1566721919575, 13367, 1566721919817, 13609, 242, true
7701, 1566721919576, 13368, 1566721919817, 13609, 241, true
7702, 1566721919577, 13369, 1566721919816, 13608, 239, true
7703, 1566721919577, 13369, 1566721919817, 13609, 240, true
7704, 1566721919579, 13371, 1566721919817, 13609, 238, true
7705, 1566721919580, 13372, 1566721919817, 13609, 237, true
7706, 1566721919581, 13373, 1566721919817, 13609, 236, true
7707, 1566721919582, 13374, 1566721919817, 13609, 235, true
7708, 1566721919589, 13381, 1566721919817, 13609, 228, true
7709, 1566721919589, 13381, 1566721919817, 13609, 228, true
7710, 1566721919589, 13381, 1566721919817, 13609, 228, true
7711, 1566721919590, 13382, 1566721919817, 13609, 227, true
7712, 1566721919590, 13382, 1566721919817, 13609, 227, true
7713, 1566721919592, 13384, 1566721919817, 13609, 225, true
7714, 1566721919593, 13385, 1566721919818, 13610, 225, true
7715, 1566721919593, 13385, 1566721919818, 13610, 225, true
7716, 1566721919594, 13386, 1566721919818, 13610, 224, true
7717, 1566721919594, 13386, 1566721919818, 13610, 224, true
7718, 1566721919595, 13387, 1566721919818, 13610, 223, true
7719, 1566721919596, 13388, 1566721919818, 13610, 222, true
7720, 1566721919597, 13389, 1566721919818, 13610, 221, true
7721, 1566721919599, 13391, 1566721919818, 13610, 219, true
7722, 1566721919603, 13395, 1566721919818, 13610, 215, true
7723, 1566721919605, 13397, 1566721919819, 13611, 214, true
7724, 1566721919606, 13398, 1566721919818, 13610, 212, true
7725, 1566721919608, 13400, 1566721919819, 13611, 211, true
7726, 1566721919611, 13403, 1566721919821, 13613, 210, true
7727, 1566721919611, 13403, 1566721919821, 13613, 210, true
7728, 1566721919612, 13404, 1566721919825, 13617, 213, true
7729, 1566721919612, 13404, 1566721919825, 13617, 213, true
7730, 1566721919617, 13409, 1566721919824, 13616, 207, true
7731, 1566721919622, 13414, 1566721919830, 13622, 208, true
7732, 1566721919622, 13414, 1566721919830, 13622, 208, true
7733, 1566721919624, 13416, 1566721919839, 13631, 215, true
7734, 1566721919624, 13416, 1566721919838, 13630, 214, true
7735, 1566721919625, 13417, 1566721919839, 13631, 214, true
7736, 1566721919625, 13417, 1566721919830, 13622, 205, true
7737, 1566721919626, 13418, 1566721919839, 13631, 213, true
7738, 1566721919626, 13418, 1566721919838, 13630, 212, true
7739, 1566721919627, 13419, 1566721919840, 13632, 213, true
7740, 1566721919630, 13422, 1566721919840, 13632, 210, true
7741, 1566721919630, 13422, 1566721919840, 13632, 210, true
7742, 1566721919631, 13423, 1566721919842, 13634, 211, true
7743, 1566721919632, 13424, 1566721919842, 13634, 210, true
7744, 1566721919632, 13424, 1566721919842, 13634, 210, true
7745, 1566721919632, 13424, 1566721919840, 13632, 208, true
7746, 1566721919633, 13425, 1566721919841, 13633, 208, true
7747, 1566721919634, 13426, 1566721919843, 13635, 209, true
7748, 1566721919637, 13429, 1566721919843, 13635, 206, true
7749, 1566721919638, 13430, 1566721919843, 13635, 205, true
7750, 1566721919638, 13430, 1566721919851, 13643, 213, true
7751, 1566721919639, 13431, 1566721919851, 13643, 212, true
7752, 1566721919639, 13431, 1566721919851, 13643, 212, true
7753, 1566721919640, 13432, 1566721919855, 13647, 215, true
7754, 1566721919641, 13433, 1566721919851, 13643, 210, true
7755, 1566721919642, 13434, 1566721919855, 13647, 213, true
7756, 1566721919643, 13435, 1566721919855, 13647, 212, true
7757, 1566721919644, 13436, 1566721919855, 13647, 211, true
7758, 1566721919646, 13438, 1566721919851, 13643, 205, true
7759, 1566721919649, 13441, 1566721919855, 13647, 206, true
7760, 1566721919651, 13443, 1566721919857, 13649, 206, true
7761, 1566721919653, 13445, 1566721919857, 13649, 204, true
7762, 1566721919653, 13445, 1566721919857, 13649, 204, true
7763, 1566721919660, 13452, 1566721919862, 13654, 202, true
7764, 1566721919663, 13455, 1566721919868, 13660, 205, true
7765, 1566721919665, 13457, 1566721919870, 13662, 205, true
7766, 1566721919665, 13457, 1566721919872, 13664, 207, true
7767, 1566721919667, 13459, 1566721919871, 13663, 204, true
7768, 1566721919667, 13459, 1566721919873, 13665, 206, true
7769, 1566721919668, 13460, 1566721919874, 13666, 206, true
7770, 1566721919669, 13461, 1566721919872, 13664, 203, true
7771, 1566721919670, 13462, 1566721919874, 13666, 204, true
7772, 1566721919670, 13462, 1566721919874, 13666, 204, true
7773, 1566721919670, 13462, 1566721919877, 13669, 207, true
7774, 1566721919671, 13463, 1566721919876, 13668, 205, true
7775, 1566721919673, 13465, 1566721919876, 13668, 203, true
7776, 1566721919674, 13466, 1566721919884, 13676, 210, true
7777, 1566721919675, 13467, 1566721919877, 13669, 202, true
7778, 1566721919676, 13468, 1566721919879, 13671, 203, true
7779, 1566721919677, 13469, 1566721919881, 13673, 204, true
7780, 1566721919677, 13469, 1566721919882, 13674, 205, true
7781, 1566721919678, 13470, 1566721919886, 13678, 208, true
7782, 1566721919680, 13472, 1566721919884, 13676, 204, true
7783, 1566721919681, 13473, 1566721919887, 13679, 206, true
7784, 1566721919682, 13474, 1566721919887, 13679, 205, true
7785, 1566721919682, 13474, 1566721919888, 13680, 206, true
7786, 1566721919683, 13475, 1566721919888, 13680, 205, true
7787, 1566721919684, 13476, 1566721919892, 13684, 208, true
7788, 1566721919684, 13476, 1566721919892, 13684, 208, true
7789, 1566721919685, 13477, 1566721919899, 13691, 214, true
7790, 1566721919686, 13478, 1566721919900, 13692, 214, true
7791, 1566721919686, 13478, 1566721919900, 13692, 214, true
7792, 1566721919687, 13479, 1566721919900, 13692, 213, true
7793, 1566721919690, 13482, 1566721919899, 13691, 209, true
7794, 1566721919696, 13488, 1566721919900, 13692, 204, true
7795, 1566721919696, 13488, 1566721919900, 13692, 204, true
7796, 1566721919698, 13490, 1566721919906, 13698, 208, true
7797, 1566721919699, 13491, 1566721919906, 13698, 207, true
7798, 1566721919700, 13492, 1566721919906, 13698, 206, true
7799, 1566721919707, 13499, 1566721919913, 13705, 206, true
7800, 1566721919708, 13500, 1566721919913, 13705, 205, true
7801, 1566721919710, 13502, 1566721919915, 13707, 205, true
7802, 1566721919710, 13502, 1566721919915, 13707, 205, true
7803, 1566721919711, 13503, 1566721919916, 13708, 205, true
7804, 1566721919712, 13504, 1566721919916, 13708, 204, true
7805, 1566721919712, 13504, 1566721919916, 13708, 204, true
7806, 1566721919712, 13504, 1566721919918, 13710, 206, true
7807, 1566721919713, 13505, 1566721919921, 13713, 208, true
7808, 1566721919713, 13505, 1566721919919, 13711, 206, true
7809, 1566721919716, 13508, 1566721919921, 13713, 205, true
7810, 1566721919717, 13509, 1566721919924, 13716, 207, true
7811, 1566721919717, 13509, 1566721919923, 13715, 206, true
7812, 1566721919718, 13510, 1566721919925, 13717, 207, true
7813, 1566721919718, 13510, 1566721919932, 13724, 214, true
7814, 1566721919719, 13511, 1566721919932, 13724, 213, true
7815, 1566721919720, 13512, 1566721919932, 13724, 212, true
7816, 1566721919742, 13534, 1566721919951, 13743, 209, true
7817, 1566721919743, 13535, 1566721919958, 13750, 215, true
7818, 1566721919743, 13535, 1566721919951, 13743, 208, true
7819, 1566721919743, 13535, 1566721919966, 13758, 223, true
7820, 1566721919744, 13536, 1566721919966, 13758, 222, true
7821, 1566721919745, 13537, 1566721920037, 13829, 292, true
7822, 1566721919745, 13537, 1566721919990, 13782, 245, true
7823, 1566721919746, 13538, 1566721920027, 13819, 281, true
7824, 1566721919747, 13539, 1566721919991, 13783, 244, true
7825, 1566721919751, 13543, 1566721919983, 13775, 232, true
7826, 1566721919752, 13544, 1566721919990, 13782, 238, true
7827, 1566721919752, 13544, 1566721919991, 13783, 239, true
7828, 1566721919753, 13545, 1566721920012, 13804, 259, true
7829, 1566721919753, 13545, 1566721919980, 13772, 227, true
7830, 1566721919754, 13546, 1566721920025, 13817, 271, true
7831, 1566721919847, 13639, 1566721920067, 13859, 220, true
7832, 1566721919848, 13640, 1566721920067, 13859, 219, true
7833, 1566721919849, 13641, 1566721920062, 13854, 213, true
7834, 1566721919864, 13656, 1566721920074, 13866, 210, true
7835, 1566721919865, 13657, 1566721920072, 13864, 207, true
7836, 1566721919865, 13657, 1566721920070, 13862, 205, true
7837, 1566721919865, 13657, 1566721920070, 13862, 205, true
7838, 1566721919866, 13658, 1566721920070, 13862, 204, true
7839, 1566721919866, 13658, 1566721920072, 13864, 206, true
7840, 1566721919880, 13672, 1566721920091, 13883, 211, true
7841, 1566721919880, 13672, 1566721920091, 13883, 211, true
7842, 1566721919889, 13681, 1566721920100, 13892, 211, true
7843, 1566721919890, 13682, 1566721920104, 13896, 214, true
7844, 1566721919890, 13682, 1566721920101, 13893, 211, true
7845, 1566721919890, 13682, 1566721920102, 13894, 212, true
7846, 1566721919890, 13682, 1566721920103, 13895, 213, true
7847, 1566721919894, 13686, 1566721920103, 13895, 209, true
7848, 1566721919894, 13686, 1566721920105, 13897, 211, true
7849, 1566721919894, 13686, 1566721920103, 13895, 209, true
7850, 1566721919901, 13693, 1566721920118, 13910, 217, true
7851, 1566721919901, 13693, 1566721920118, 13910, 217, true
7852, 1566721919901, 13693, 1566721920117, 13909, 216, true
7853, 1566721919902, 13694, 1566721920118, 13910, 216, true
7854, 1566721919902, 13694, 1566721920118, 13910, 216, true
7855, 1566721919902, 13694, 1566721920118, 13910, 216, true
7856, 1566721919909, 13701, 1566721920118, 13910, 209, true
7857, 1566721919909, 13701, 1566721920118, 13910, 209, true
7858, 1566721919909, 13701, 1566721920119, 13911, 210, true
7859, 1566721919910, 13702, 1566721920118, 13910, 208, true
7860, 1566721919913, 13705, 1566721920120, 13912, 207, true
7861, 1566721919918, 13710, 1566721920132, 13924, 214, true
7862, 1566721919921, 13713, 1566721920133, 13925, 212, true
7863, 1566721919922, 13714, 1566721920132, 13924, 210, true
7864, 1566721919926, 13718, 1566721920146, 13938, 220, true
7865, 1566721919927, 13719, 1566721920146, 13938, 219, true
7866, 1566721919927, 13719, 1566721920145, 13937, 218, true
7867, 1566721919927, 13719, 1566721920148, 13940, 221, true
7868, 1566721919928, 13720, 1566721920145, 13937, 217, true
7869, 1566721919928, 13720, 1566721920149, 13941, 221, true
7870, 1566721919934, 13726, 1566721920151, 13943, 217, true
7871, 1566721919935, 13727, 1566721920155, 13947, 220, true
7872, 1566721919935, 13727, 1566721920150, 13942, 215, true
7873, 1566721919935, 13727, 1566721920155, 13947, 220, true
7874, 1566721919940, 13732, 1566721920155, 13947, 215, true
7875, 1566721919942, 13734, 1566721920156, 13948, 214, true
7876, 1566721919944, 13736, 1566721920157, 13949, 213, true
7877, 1566721919945, 13737, 1566721920157, 13949, 212, true
7878, 1566721919947, 13739, 1566721920157, 13949, 210, true
7879, 1566721919951, 13743, 1566721920159, 13951, 208, true
7880, 1566721919952, 13744, 1566721920159, 13951, 207, true
7881, 1566721919952, 13744, 1566721920159, 13951, 207, true
7882, 1566721919954, 13746, 1566721920162, 13954, 208, true
7883, 1566721919956, 13748, 1566721920162, 13954, 206, true
7884, 1566721919958, 13750, 1566721920164, 13956, 206, true
7885, 1566721919959, 13751, 1566721920164, 13956, 205, true
7886, 1566721919960, 13752, 1566721920165, 13957, 205, true
7887, 1566721919962, 13754, 1566721920165, 13957, 203, true
7888, 1566721919964, 13756, 1566721920170, 13962, 206, true
7889, 1566721919966, 13758, 1566721920170, 13962, 204, true
7890, 1566721919967, 13759, 1566721920170, 13962, 203, true
7891, 1566721919967, 13759, 1566721920171, 13963, 204, true
7892, 1566721919968, 13760, 1566721920171, 13963, 203, true
7893, 1566721919969, 13761, 1566721920172, 13964, 203, true
7894, 1566721919970, 13762, 1566721920174, 13966, 204, true
7895, 1566721919971, 13763, 1566721920174, 13966, 203, true
7896, 1566721919972, 13764, 1566721920175, 13967, 203, true
7897, 1566721919973, 13765, 1566721920188, 13980, 215, true
7898, 1566721919974, 13766, 1566721920188, 13980, 214, true
7899, 1566721919974, 13766, 1566721920189, 13981, 215, true
7900, 1566721919975, 13767, 1566721920188, 13980, 213, true
7901, 1566721919976, 13768, 1566721920189, 13981, 213, true
7902, 1566721919977, 13769, 1566721920188, 13980, 211, true
7903, 1566721919978, 13770, 1566721920189, 13981, 211, true
7904, 1566721919979, 13771, 1566721920188, 13980, 209, true
7905, 1566721919980, 13772, 1566721920189, 13981, 209, true
7906, 1566721919981, 13773, 1566721920191, 13983, 210, true
7907, 1566721919981, 13773, 1566721920195, 13987, 214, true
7908, 1566721919984, 13776, 1566721920193, 13985, 209, true
7909, 1566721919986, 13778, 1566721920195, 13987, 209, true
7910, 1566721919991, 13783, 1566721920195, 13987, 204, true
7911, 1566721919992, 13784, 1566721920201, 13993, 209, true
7912, 1566721919993, 13785, 1566721920206, 13998, 213, true
7913, 1566721919993, 13785, 1566721920201, 13993, 208, true
7914, 1566721919993, 13785, 1566721920252, 14044, 259, true
7915, 1566721919994, 13786, 1566721920255, 14047, 261, true
7916, 1566721919994, 13786, 1566721920217, 14009, 223, true
7917, 1566721919995, 13787, 1566721920236, 14028, 241, true
7918, 1566721919995, 13787, 1566721920228, 14020, 233, true
7919, 1566721919995, 13787, 1566721920255, 14047, 260, true
7920, 1566721919996, 13788, 1566721920249, 14041, 253, true
7921, 1566721919996, 13788, 1566721920255, 14047, 259, true
7922, 1566721919996, 13788, 1566721920217, 14009, 221, true
7923, 1566721919996, 13788, 1566721920251, 14043, 255, true
7924, 1566721919997, 13789, 1566721920222, 14014, 225, true
7925, 1566721919998, 13790, 1566721920265, 14057, 267, true
7926, 1566721919998, 13790, 1566721920272, 14064, 274, true
7927, 1566721919998, 13790, 1566721920250, 14042, 252, true
7928, 1566721920000, 13792, 1566721920264, 14056, 264, true
7929, 1566721920001, 13793, 1566721920266, 14058, 265, true
7930, 1566721920002, 13794, 1566721920256, 14048, 254, true
7931, 1566721920002, 13794, 1566721920272, 14064, 270, true
7932, 1566721920004, 13796, 1566721920260, 14052, 256, true
7933, 1566721920009, 13801, 1566721920280, 14072, 271, true
7934, 1566721920010, 13802, 1566721920261, 14053, 251, true
7935, 1566721920011, 13803, 1566721920282, 14074, 271, true
7936, 1566721920012, 13804, 1566721920259, 14051, 247, true
7937, 1566721920012, 13804, 1566721920270, 14062, 258, true
7938, 1566721920013, 13805, 1566721920261, 14053, 248, true
7939, 1566721920013, 13805, 1566721920272, 14064, 259, true
7940, 1566721920013, 13805, 1566721920256, 14048, 243, true
7941, 1566721920014, 13806, 1566721920281, 14073, 267, true
7942, 1566721920015, 13807, 1566721920279, 14071, 264, true
7943, 1566721920015, 13807, 1566721920278, 14070, 263, true
7944, 1566721920015, 13807, 1566721920279, 14071, 264, true
7945, 1566721920016, 13808, 1566721920260, 14052, 244, true
7946, 1566721920016, 13808, 1566721920265, 14057, 249, true
7947, 1566721920017, 13809, 1566721920272, 14064, 255, true
7948, 1566721920017, 13809, 1566721920278, 14070, 261, true
7949, 1566721920017, 13809, 1566721920281, 14073, 264, true
7950, 1566721920017, 13809, 1566721920279, 14071, 262, true
7951, 1566721920018, 13810, 1566721920271, 14063, 253, true
7952, 1566721920018, 13810, 1566721920268, 14060, 250, true
7953, 1566721920019, 13811, 1566721920266, 14058, 247, true
7954, 1566721920019, 13811, 1566721920278, 14070, 259, true
7955, 1566721920020, 13812, 1566721920281, 14073, 261, true
7956, 1566721920020, 13812, 1566721920261, 14053, 241, true
7957, 1566721920020, 13812, 1566721920260, 14052, 240, true
7958, 1566721920021, 13813, 1566721920260, 14052, 239, true
7959, 1566721920021, 13813, 1566721920279, 14071, 258, true
7960, 1566721920022, 13814, 1566721920280, 14072, 258, true
7961, 1566721920023, 13815, 1566721920280, 14072, 257, true
7962, 1566721920024, 13816, 1566721920271, 14063, 247, true
7963, 1566721920025, 13817, 1566721920272, 14064, 247, true
7964, 1566721920026, 13818, 1566721920271, 14063, 245, true
7965, 1566721920027, 13819, 1566721920271, 14063, 244, true
7966, 1566721920027, 13819, 1566721920278, 14070, 251, true
7967, 1566721920027, 13819, 1566721920278, 14070, 251, true
7968, 1566721920028, 13820, 1566721920259, 14051, 231, true
7969, 1566721920028, 13820, 1566721920281, 14073, 253, true
7970, 1566721920028, 13820, 1566721920260, 14052, 232, true
7971, 1566721920028, 13820, 1566721920255, 14047, 227, true
7972, 1566721920029, 13821, 1566721920266, 14058, 237, true
7973, 1566721920029, 13821, 1566721920260, 14052, 231, true
7974, 1566721920029, 13821, 1566721920281, 14073, 252, true
7975, 1566721920030, 13822, 1566721920256, 14048, 226, true
7976, 1566721920030, 13822, 1566721920280, 14072, 250, true
7977, 1566721920031, 13823, 1566721920264, 14056, 233, true
7978, 1566721920031, 13823, 1566721920280, 14072, 249, true
7979, 1566721920031, 13823, 1566721920265, 14057, 234, true
7980, 1566721920032, 13824, 1566721920267, 14059, 235, true
7981, 1566721920032, 13824, 1566721920265, 14057, 233, true
7982, 1566721920033, 13825, 1566721920278, 14070, 245, true
7983, 1566721920034, 13826, 1566721920271, 14063, 237, true
7984, 1566721920034, 13826, 1566721920280, 14072, 246, true
7985, 1566721920035, 13827, 1566721920281, 14073, 246, true
7986, 1566721920035, 13827, 1566721920271, 14063, 236, true
7987, 1566721920035, 13827, 1566721920265, 14057, 230, true
7988, 1566721920035, 13827, 1566721920264, 14056, 229, true
7989, 1566721920036, 13828, 1566721920273, 14065, 237, true
7990, 1566721920036, 13828, 1566721920281, 14073, 245, true
7991, 1566721920037, 13829, 1566721920256, 14048, 219, true
7992, 1566721920038, 13830, 1566721920281, 14073, 243, true
7993, 1566721920038, 13830, 1566721920268, 14060, 230, true
7994, 1566721920039, 13831, 1566721920255, 14047, 216, true
7995, 1566721920039, 13831, 1566721920265, 14057, 226, true
7996, 1566721920040, 13832, 1566721920270, 14062, 230, true
7997, 1566721920040, 13832, 1566721920279, 14071, 239, true
7998, 1566721920040, 13832, 1566721920261, 14053, 221, true
7999, 1566721920040, 13832, 1566721920266, 14058, 226, true
8000, 1566721920041, 13833, 1566721920264, 14056, 223, true
